"image_name","c1","c2","c3","c4","c5","c_total","MOS","SD","MOS_zscore"
"10004473376.jpg",0,0,25,73,7,105,3.82857142857143,0.527277894493955,77.3836206896552
"10007357496.jpg",0,3,45,47,1,96,3.47916666666667,0.5800030247955,68.7285714285714
"10007903636.jpg",1,0,20,73,2,96,3.78125,0.527219618674978,78.6285714285714
"10009096245.jpg",0,0,21,75,13,109,3.92660550458716,0.556217750098803,77.24375
"100117038.jpg",0,1,21,72,6,100,3.83,0.532859638121892,75.1125
"10012398043.jpg",0,7,55,40,1,103,3.33980582524272,0.619192992472071,65.1495327102804
"10013822223.jpg",0,0,48,60,2,110,3.58181818181818,0.531258125581778,68.30625
"10014002683.jpg",0,6,46,51,3,106,3.4811320754717,0.650730462458067,64.7627118644068
"10017119924.jpg",0,3,58,50,0,111,3.42342342342342,0.548544347250886,66.224358974359
"10020766793.jpg",0,0,11,78,20,109,4.08256880733945,0.529297934146812,81.50625
"10020891105.jpg",0,4,80,18,0,102,3.13725490196078,0.445865843301836,56.8297413793103
"10022757465.jpg",0,3,32,66,4,105,3.67619047619048,0.596387169276516,71.0154867256637
"10022844623.jpg",1,5,60,36,0,102,3.2843137254902,0.603249467802339,60.925
"10027545463.jpg",0,0,31,66,5,102,3.74509803921569,0.53927480659291,72.8279816513761
"10027582235.jpg",0,0,24,78,5,107,3.82242990654206,0.491687201381957,77.1377118644068
"10029841663.jpg",0,4,65,64,1,134,3.46268656716418,0.570670577951945,70.125
"10031298826.jpg",1,22,90,9,0,122,2.87704918032787,0.52346381078129,50.5681818181818
"10031913154.jpg",0,4,63,65,2,134,3.48507462686567,0.584705756305363,70.5
"10039534103.jpg",0,0,34,72,1,107,3.69158878504673,0.483915144465277,76.075
"10041870415.jpg",0,2,53,49,0,104,3.45192307692308,0.537520515613129,66.4210526315789
"10043785683.jpg",0,0,46,60,0,106,3.56603773584906,0.497974333332233,71.2043269230769
"10047832035.jpg",0,0,38,60,3,101,3.65346534653465,0.537320082713394,71.8
"10048365153.jpg",1,12,66,22,0,101,3.07920792079208,0.611280104646498,58.0929203539823
"10050349236.jpg",6,69,27,0,0,102,2.20588235294118,0.532846555181383,30.9418103448276
"10058760545.jpg",45,48,7,0,0,100,1.62,0.615949624071595,15.2293577981651
"10059344614.jpg",0,3,46,49,2,100,3.5,0.594588390010563,68.6651376146789
"10061596254.jpg",0,8,74,25,0,107,3.1588785046729,0.534640290117207,59.6418918918919
"10067457634.jpg",0,0,15,87,7,109,3.92660550458716,0.445271910649957,78.4390756302521
"10068507976.jpg",0,11,77,22,0,110,3.1,0.540981099908967,57.6548672566372
"10068778516.jpg",0,1,38,71,4,114,3.68421052631579,0.55360107476116,71.8782608695652
"10069534975.jpg",0,1,34,72,1,108,3.67592592592593,0.508409719674872,73.7222222222222
"10071864114.jpg",0,1,31,76,4,112,3.74107142857143,0.532638100593026,71.9090909090909
"10075168775.jpg",0,1,30,66,4,101,3.72277227722772,0.549887477238537,74.7785714285714
"10077468576.jpg",0,0,38,66,2,106,3.66037735849057,0.514305679955861,73.8152173913043
"10077880165.jpg",9,70,28,1,0,108,2.19444444444444,0.587380265521398,31.2256637168142
"10079711433.jpg",0,11,93,28,0,132,3.12878787878788,0.530091494771472,59.0625
"10082923485.jpg",0,16,77,11,0,104,2.95192307692308,0.509707848784743,53.2260869565217
"10086300493.jpg",0,2,49,49,3,103,3.51456310679612,0.591841222578484,68.3026315789474
"100882570.jpg",0,6,49,41,3,99,3.41414141414141,0.654811096145075,65.4747899159664
"10089027076.jpg",29,66,11,2,0,108,1.87037037037037,0.656991053760519,23.0785714285714
"10089177336.jpg",0,1,31,63,6,101,3.73267326732673,0.581224381954351,72.945945945946
"10091520555.jpg",4,66,36,0,0,106,2.30188679245283,0.537539567903605,33.6443965517241
"10093057603.jpg",0,4,55,43,0,102,3.38235294117647,0.563653528279349,63.4955752212389
"10094235786.jpg",0,2,69,29,0,100,3.27,0.489382212074519,62.1559633027523
"10110458216.jpg",0,4,56,39,1,100,3.37,0.580055727033745,64.7293577981651
"10111411235.jpg",41,65,7,0,0,113,1.69911504424779,0.580716241135099,18.4705882352941
"10113730664.jpg",0,1,66,62,0,129,3.47286821705426,0.51656194237485,68.8125
"10115071674.jpg",0,2,34,64,9,109,3.73394495412844,0.633073072765233,72.775
"10118773964.jpg",0,12,74,14,1,101,3.03960396039604,0.546274511197583,53.0733944954128
"10121813934.jpg",0,11,48,44,2,105,3.35238095238095,0.693111051998834,65.3980582524272
"10125013364.jpg",13,80,38,0,0,131,2.19083969465649,0.596328559627659,31.2711538461538
"10126177964.jpg",0,1,48,54,6,109,3.59633027522936,0.610392497512353,70.9078947368421
"10126857344.jpg",0,6,44,63,1,114,3.51754385964912,0.613021764621792,68.7331932773109
"10130566006.jpg",0,1,38,60,7,106,3.68867924528302,0.607307995088549,71.95
"10131980434.jpg",1,8,90,36,0,135,3.19259259259259,0.566427615170997,61.0279850746269
"10133867305.jpg",0,6,73,26,0,105,3.19047619047619,0.520636409658671,58.1607142857143
"10134737015.jpg",1,19,65,22,0,107,3.00934579439252,0.651490701403454,54.5903361344538
"10140071304.jpg",0,7,63,31,2,103,3.27184466019417,0.613478905741538,62.5576923076923
"10147970884.jpg",0,0,25,82,4,111,3.81081081081081,0.476988917605459,76.8561946902655
"10153847086.jpg",0,9,74,25,1,109,3.1651376146789,0.569498828859231,59.23125
"10154367094.jpg",0,2,46,68,1,117,3.58119658119658,0.545187665242931,74.1120689655172
"10154991453.jpg",0,4,48,72,2,126,3.57142857142857,0.58554004376912,74.1854838709677
"10155925686.jpg",0,21,65,16,1,103,2.97087378640777,0.633327822673833,52.8798076923077
"101601008.jpg",0,10,50,38,2,100,3.32,0.679869268479038,61.0875
"10164654253.jpg",0,16,71,13,0,100,2.97,0.540388935878782,52.9220183486239
"10164842933.jpg",0,1,24,81,7,113,3.83185840707965,0.532893966725502,76.69375
"10169304416.jpg",0,1,13,79,12,105,3.97142857142857,0.527277894493955,80.8716814159292
"10173544123.jpg",0,5,77,48,1,131,3.34351145038168,0.565290835512158,65.1055555555556
"10177270623.jpg",2,11,44,44,1,102,3.30392156862745,0.75503872677905,59.4800884955752
"10177793964.jpg",0,2,54,41,0,97,3.4020618556701,0.533459499681735,68.5218446601942
"10178112894.jpg",2,49,51,4,0,106,2.5377358490566,0.604341882142988,40.2586206896552
"10178183416.jpg",0,0,33,68,6,107,3.74766355140187,0.551044598816994,75.6842105263158
"10178914656.jpg",0,0,53,52,1,106,3.50943396226415,0.520901837363733,69.7991071428571
"10183769356.jpg",0,2,43,55,5,105,3.6,0.61394061351492,70.0472972972973
"10186643874.jpg",1,24,90,11,0,126,2.88095238095238,0.54563200576422,51.5731707317073
"10186680555.jpg",0,14,70,19,1,104,3.06730769230769,0.595524131992075,55.3362068965517
"10186832194.jpg",1,14,54,28,4,101,3.1980198019802,0.761837278953951,57.5818584070796
"10187102065.jpg",2,63,35,7,0,107,2.4392523364486,0.646873031393711,38.7142857142857
"10187522803.jpg",0,0,55,52,1,108,3.5,0.520603531858148,68.4601769911504
"10191607755.jpg",0,2,16,64,20,102,4,0.660033002475206,79.4115044247788
"10196228605.jpg",0,5,62,41,0,108,3.33333333333333,0.563699396261691,63.8040540540541
"10203647273.jpg",0,2,31,69,5,107,3.7196261682243,0.579433564058746,73.5021186440678
"10205220286.jpg",9,77,20,0,0,106,2.10377358490566,0.515091213060161,29.2638888888889
"10206674394.jpg",0,0,18,76,6,100,3.88,0.477366513151884,79.1100917431193
"10207172624.jpg",0,6,49,45,1,101,3.40594059405941,0.619325727251536,62.5344036697248
"10209014225.jpg",0,4,58,42,0,104,3.36538461538462,0.558390410586359,64.8411214953271
"10209917915.jpg",1,35,55,10,1,102,2.75490196078431,0.68123758246187,46.9097222222222
"10211880874.jpg",12,51,43,1,0,107,2.30841121495327,0.678667047514812,35.0487288135593
"10213881683.jpg",5,77,52,2,0,136,2.375,0.582936372869986,37.1232142857143
"10218118033.jpg",0,1,25,76,5,107,3.79439252336449,0.527334302993257,75.6659663865546
"10221144393.jpg",37,71,2,0,0,110,1.68181818181818,0.505598349888039,18.275641025641
"10224586444.jpg",2,52,47,1,0,102,2.46078431372549,0.557070993350661,37.975
"10226277514.jpg",2,44,55,5,0,106,2.59433962264151,0.613782990761741,43.2162162162162
"10226524916.jpg",38,52,15,2,0,107,1.82242990654206,0.737321569232619,20.6216216216216
"10227210045.jpg",0,5,48,48,2,103,3.45631067961165,0.622718565915461,70.4245283018868
"10241630856.jpg",0,5,61,39,1,106,3.33962264150943,0.58369581857791,63.6573275862069
"10241895785.jpg",0,4,39,57,3,103,3.57281553398058,0.6199611269846,67.0736607142857
"10244314384.jpg",2,34,52,15,0,103,2.77669902912621,0.713071770374435,47.5481651376147
"10244715656.jpg",1,25,61,22,0,109,2.95412844036697,0.685637323156987,53.3223684210526
"10246311914.jpg",0,0,25,73,9,107,3.85046728971963,0.546062031132427,75.4579831932773
"10246318724.jpg",0,0,24,77,5,106,3.82075471698113,0.493716128411589,74.3581081081081
"10258169584.jpg",0,10,70,25,0,105,3.14285714285714,0.562080124122946,57.2302631578947
"10260190424.jpg",0,0,56,49,3,108,3.50925925925926,0.555269916184919,68.8652173913043
"1026198859.jpg",0,2,40,61,1,104,3.58653846153846,0.550561530172921,70.2715517241379
"10262588616.jpg",1,2,68,29,0,100,3.25,0.538891492235719,61.4485981308411
"10264804094.jpg",0,1,28,76,1,106,3.72641509433962,0.488594073759443,76.6495535714286
"10264984793.jpg",0,4,45,50,2,101,3.4950495049505,0.610307502431973,66.1
"10265315316.jpg",0,2,67,32,1,102,3.31372549019608,0.526155346500202,62.9513888888889
"10265809113.jpg",0,0,36,65,2,103,3.66990291262136,0.512363793752346,73.7767857142857
"10273804555.jpg",0,4,47,49,4,104,3.50961538461538,0.638493255283538,68.3026315789474
"10278246465.jpg",0,2,56,71,0,129,3.53488372093023,0.531014824826997,70.8416030534351
"10279904885.jpg",3,43,46,10,1,103,2.64077669902913,0.739029158224927,44.0400943396226
"10280683815.jpg",0,1,30,67,5,103,3.7378640776699,0.559431873028057,77.425
"10280835505.jpg",6,66,27,1,0,100,2.23,0.565953205047052,31.2256637168142
"10283619534.jpg",0,2,30,65,3,100,3.69,0.563090318750649,77.9740566037736
"10287677265.jpg",1,5,42,53,1,102,3.47058823529412,0.655606171823823,64.1272321428571
"10289468185.jpg",0,0,35,62,4,101,3.69306930693069,0.54300228834556,73.525
"10290759976.jpg",0,0,23,77,3,103,3.80582524271845,0.465648449975302,77.9256756756757
"1029470257.jpg",0,45,62,4,0,111,2.63063063063063,0.554779693013819,43.0961538461538
"10295875445.jpg",0,6,54,48,1,109,3.40366972477064,0.610392497512353,62.563025210084
"10296038236.jpg",1,52,52,3,1,109,2.55045871559633,0.615934077342428,40.6438053097345
"10299438733.jpg",0,13,66,23,0,102,3.09803921568627,0.588836811456376,55.2683486238532
"102995966.jpg",46,51,7,0,0,104,1.625,0.610387430681514,16.4600840336134
"10316734944.jpg",0,2,50,49,0,101,3.46534653465347,0.539710226615053,67.3055555555556
"10319186405.jpg",0,18,57,26,1,102,3.09803921568627,0.682305409412992,55.5540540540541
"10319713194.jpg",82,30,0,0,0,112,1.26785714285714,0.444833056186754,7.99152542372881
"10325321.jpg",0,0,22,73,9,104,3.875,0.534035742958542,76.8717948717949
"10327985614.jpg",0,1,34,66,8,109,3.74311926605505,0.599439085416844,75.1026785714286
"10329149264.jpg",0,0,31,70,3,104,3.73076923076923,0.506861066174239,71.9797297297297
"10329235193.jpg",0,2,17,66,27,112,4.05357142857143,0.682328891058202,84.1292372881356
"10330831494.jpg",1,29,67,7,0,104,2.76923076923077,0.578427215227558,48.5321100917431
"10335072144.jpg",0,16,49,42,0,107,3.24299065420561,0.698260932675251,62.1610576923077
"10336689775.jpg",0,4,77,48,0,129,3.34108527131783,0.537589004709449,65.1811023622047
"103400056.jpg",0,3,18,63,20,104,3.96153846153846,0.69566029153948,77.8625
"10342569703.jpg",1,57,44,1,0,103,2.43689320388349,0.53632560553216,38.6081081081081
"10344523015.jpg",1,21,71,15,0,108,2.92592592592593,0.606871919907349,52.5263157894737
"10344921126.jpg",93,16,0,0,0,109,1.14678899082569,0.355530070442413,4.46638655462185
"10346758803.jpg",0,11,45,40,5,101,3.38613861386139,0.747934449396509,63.5336134453782
"10346796664.jpg",0,1,41,60,2,104,3.60576923076923,0.547159819941693,70.6504424778761
"10349956885.jpg",0,3,32,65,5,105,3.68571428571429,0.609449400220044,69.75
"10350497833.jpg",2,9,66,27,1,105,3.15238095238095,0.661887632529297,58.260593220339
"10351189716.jpg",0,2,74,30,0,106,3.26415094339623,0.484067818791518,61.01875
"10353620913.jpg",1,17,59,25,0,102,3.05882352941176,0.672273067630027,56.7071428571429
"10358252894.jpg",0,3,88,46,0,137,3.31386861313869,0.510936637281419,64.4615384615385
"10362672006.jpg",0,1,19,81,3,104,3.82692307692308,0.471360511593271,75.8189655172414
"10366373284.jpg",1,0,14,94,3,112,3.875,0.467406106580208,75.4545454545455
"1036840624.jpg",8,68,20,0,0,96,2.125,0.528154682286404,28.3382352941176
"10371125786.jpg",2,61,38,4,0,105,2.41904761904762,0.600976007151834,38.245145631068
"10371211803.jpg",0,0,63,49,1,113,3.45132743362832,0.517396477610979,66.38125
"10372323314.jpg",0,0,64,44,1,109,3.42201834862385,0.51448604310428,65.3361344537815
"10373546175.jpg",0,7,67,25,0,99,3.18181818181818,0.541419833394177,61.9538834951456
"10375167904.jpg",0,7,70,25,0,102,3.17647058823529,0.534211081244486,62.4080188679245
"10382843045.jpg",1,29,64,10,0,104,2.79807692307692,0.613438624054357,48.6347826086957
"10387390396.jpg",0,0,39,63,2,104,3.64423076923077,0.519863111757694,74.3417431192661
"10387844376.jpg",0,10,43,53,3,109,3.44954128440367,0.700346984531796,65.6134453781513
"10388184626.jpg",0,1,23,70,6,100,3.81,0.544856574585172,78.5802752293578
"10395523125.jpg",0,10,58,32,1,101,3.23762376237624,0.634799414799433,60.5069444444444
"10397166423.jpg",0,0,42,64,3,109,3.64220183486239,0.536154617344946,73.9358407079646
"10397631976.jpg",0,0,35,69,3,107,3.70093457943925,0.517886730367843,73.7247899159664
"10399580503.jpg",0,0,27,73,4,104,3.77884615384615,0.50158449460463,76.6371681415929
"10403509543.jpg",0,2,50,52,0,104,3.48076923076923,0.539341008015854,68.0117924528302
"10407720764.jpg",1,59,40,3,0,103,2.43689320388349,0.5717174489413,38.6261682242991
"10408374535.jpg",0,31,67,9,0,107,2.79439252336449,0.578519870616636,48.9217391304348
"10408474376.jpg",0,0,15,83,11,109,3.96330275229358,0.489266372662459,81.4894957983193
"10409059825.jpg",0,0,38,66,2,106,3.66037735849057,0.514305679955861,73.1513157894737
"10410038143.jpg",0,1,20,70,12,103,3.90291262135922,0.586022871580632,78.1659482758621
"10412894895.jpg",0,6,77,17,0,100,3.11,0.469149240755018,57.4121621621622
"10414716033.jpg",0,0,40,60,3,103,3.64077669902913,0.539687072220866,71.0878378378378
"10415628976.jpg",45,59,17,0,0,121,1.76859504132231,0.68020010019739,20.0868644067797
"10415631353.jpg",1,49,52,7,0,109,2.59633027522936,0.625377901382745,43.0819327731092
"104219737.jpg",1,29,50,22,0,102,2.91176470588235,0.732592591065844,50.2954545454545
"10422425365.jpg",0,2,21,76,2,101,3.77227722772277,0.507566510298146,72.5723684210526
"10422776735.jpg",0,2,58,66,0,126,3.50793650793651,0.532856930082089,69.772
"10423472445.jpg",0,1,41,68,0,110,3.60909090909091,0.508558938073631,72.5705128205128
"10429780626.jpg",0,0,42,54,0,96,3.5625,0.498682474653277,72.0285714285714
"10430002553.jpg",0,1,21,71,7,100,3.84,0.545319848688582,77.5206422018349
"10430335945.jpg",3,47,54,2,0,106,2.5188679245283,0.589287415935903,39.9741379310345
"10440370734.jpg",4,60,39,6,0,109,2.43119266055046,0.657815865222348,39.2436440677966
"10442628686.jpg",6,48,83,3,0,140,2.59285714285714,0.610418285311095,41.5810810810811
"10446770756.jpg",0,0,43,54,5,102,3.62745098039216,0.578861440139363,73.0288461538462
"10446810546.jpg",0,0,36,69,4,109,3.70642201834862,0.532338521744318,74.734375
"10451177016.jpg",0,2,41,54,4,101,3.59405940594059,0.602962980982783,70.9357798165138
"10453950204.jpg",0,6,79,22,0,107,3.14953271028037,0.491507851676416,58.975
"10458591.jpg",0,28,57,14,2,101,2.9009900990099,0.700070717785704,51.4871794871795
"10458703674.jpg",5,59,35,3,0,102,2.35294117647059,0.623739264254592,38.1615044247788
"10459022813.jpg",0,0,15,81,11,107,3.96261682242991,0.493834317278461,79.9642857142857
"10463545414.jpg",0,13,82,14,0,109,3.00917431192661,0.499915045450071,55.0444915254237
"10463583515.jpg",0,0,21,76,3,100,3.82,0.45792681696639,76.6973684210526
"10464940425.jpg",0,0,48,61,2,111,3.58558558558559,0.530325259859344,71.3851351351351
"10465121613.jpg",0,5,67,34,1,107,3.28971962616822,0.566507769341593,61.5723684210526
"10465293055.jpg",0,1,25,69,5,100,3.78,0.542720420239975,76.5366972477064
"10466350116.jpg",0,0,28,76,8,112,3.82142857142857,0.540508364550718,77.224358974359
"10466453556.jpg",11,78,17,0,0,106,2.05660377358491,0.513256432321075,28.8004201680672
"10468110795.jpg",0,7,60,38,1,106,3.31132075471698,0.607307995088549,61.4754464285714
"10468540574.jpg",0,4,47,47,3,101,3.48514851485149,0.626320387439825,67.075
"10469774844.jpg",1,7,76,26,0,110,3.15454545454545,0.561556873137655,59.6034482758621
"10471406506.jpg",13,79,21,0,0,113,2.07079646017699,0.546364840156087,28.2884615384615
"10474002734.jpg",0,0,20,84,2,106,3.83018867924528,0.424750865089678,80.7745535714286
"10475435053.jpg",0,15,64,25,3,107,3.14953271028037,0.684101646394152,57.8487394957983
"10475658035.jpg",0,0,12,70,27,109,4.13761467889908,0.584805917603453,83.225
"10481974434.jpg",2,51,51,7,0,111,2.56756756756757,0.641328473796549,42.4615384615385
"10486107003.jpg",0,4,55,44,0,103,3.38834951456311,0.564175777585734,67.9930555555556
"10490369963.jpg",3,53,43,5,0,104,2.48076923076923,0.638273904602475,39.0540540540541
"10491358066.jpg",0,5,50,44,2,101,3.42574257425743,0.622037533489183,64.45
"10491423125.jpg",0,3,39,61,3,106,3.60377358490566,0.59648566474642,72.5
"10492897986.jpg",2,30,69,5,0,106,2.72641509433962,0.577894682577149,44.6283783783784
"10505275743.jpg",0,0,23,70,8,101,3.85148514851485,0.536397960731794,75.25
"10506082433.jpg",1,49,55,3,0,108,2.55555555555556,0.569199032800311,41.9444444444444
"10512432565.jpg",0,4,46,58,1,109,3.51376146788991,0.58712543456142,68.1785714285714
"10513907744.jpg",0,12,59,26,1,98,3.16326530612245,0.637227848535258,59.4311926605505
"10516786036.jpg",0,1,28,69,11,109,3.8256880733945,0.606203069160939,73.94375
"10517436165.jpg",4,35,66,0,0,105,2.59047619047619,0.566623570867177,42.4652173913043
"10520192995.jpg",0,16,69,21,0,106,3.04716981132075,0.591721869537951,55.1630434782609
"10525460645.jpg",0,3,35,60,6,104,3.66346153846154,0.632617876088816,71.9652777777778
"10526881085.jpg",0,42,63,3,1,109,2.6605504587156,0.58087073028404,44.4598214285714
"10530470795.jpg",1,58,42,5,0,106,2.4811320754717,0.605233242335575,38.7567567567568
"10532663625.jpg",0,1,44,58,1,104,3.56730769230769,0.535432373634963,70.2565789473684
"10534454676.jpg",0,0,41,62,2,105,3.62857142857143,0.52361801360899,71.0891304347826
"10535849673.jpg",0,25,65,8,0,98,2.8265306122449,0.556600695386536,47.9556074766355
"10536668436.jpg",5,72,52,1,0,130,2.37692307692308,0.574191505954102,36.5432330827068
"10538085833.jpg",1,36,96,19,0,152,2.875,0.612372435695794,52.6710526315789
"10539008983.jpg",0,5,43,60,1,109,3.52293577981651,0.602407673504281,71.0154867256637
"10539142034.jpg",0,1,40,107,3,151,3.74172185430464,0.496166318337449,78.1809210526316
"10539341593.jpg",0,1,34,65,1,101,3.65346534653465,0.518375222485729,75.025
"10544775715.jpg",0,34,67,7,0,108,2.75,0.565768024851109,48.0642857142857
"10544833625.jpg",0,17,71,13,0,101,2.96039603960396,0.546274511197583,50.5756880733945
"10544945153.jpg",0,27,68,9,0,104,2.82692307692308,0.565038149623763,50.8235294117647
"10554234623.jpg",0,19,86,8,0,113,2.90265486725664,0.481155635830317,51.609243697479
"10556629035.jpg",0,2,34,64,2,102,3.64705882352941,0.556635202786152,73.2821100917431
"10558118243.jpg",0,0,34,70,8,112,3.76785714285714,0.569212239856606,75.8
"105620456.jpg",1,18,61,27,1,108,3.08333333333333,0.698797364769892,55.8625
"10567114974.jpg",0,8,53,47,1,109,3.37614678899083,0.635216364796543,64.8478260869565
"10567188645.jpg",0,1,64,40,1,106,3.38679245283019,0.526818930074988,64.1575630252101
"10568567754.jpg",0,2,23,79,7,111,3.81981981981982,0.55919094475368,75.1782608695652
"10569725133.jpg",0,0,28,75,4,107,3.77570093457944,0.501100886444381,74.3008849557522
"1057328504.jpg",11,57,36,1,0,105,2.25714285714286,0.650865864542283,31.4955357142857
"10574233584.jpg",2,22,60,17,0,101,2.91089108910891,0.679691251981223,51.7110091743119
"10575593285.jpg",0,6,72,25,0,103,3.18446601941748,0.519191921436553,59.2126168224299
"10576676414.jpg",0,4,72,51,0,127,3.37007874015748,0.546317391415905,66.4107142857143
"10579282866.jpg",0,6,54,52,0,112,3.41071428571429,0.593562635546243,63.3181818181818
"1057997640.jpg",1,17,70,17,0,105,2.98095238095238,0.604167456106596,52.7758620689655
"10581525775.jpg",0,5,93,42,0,140,3.26428571428571,0.517474696642216,63.3766891891892
"10582113466.jpg",0,12,68,24,0,104,3.11538461538462,0.579716909616233,58.1607142857143
"10583786994.jpg",0,14,50,34,4,102,3.27450980392157,0.74670050121638,60.1880733944954
"10586872235.jpg",2,43,60,1,0,106,2.56603773584906,0.552377854190896,41.6388888888889
"10589450596.jpg",1,6,77,41,1,126,3.27777777777778,0.60184900284226,64.5773809523809
"10597114264.jpg",0,0,38,65,2,105,3.65714285714286,0.515687954032345,72.8928571428571
"10602786066.jpg",19,67,20,2,0,108,2.0462962962963,0.661127036292569,27.7605042016807
"10603218265.jpg",0,1,32,71,1,105,3.68571428571429,0.506007861642441,71.8616071428571
"10604417276.jpg",0,0,27,67,7,101,3.8019801980198,0.548083971307281,77.3692660550459
"10605846204.jpg",0,1,48,60,0,109,3.54128440366972,0.518761168407095,70.4620535714286
"10609356094.jpg",0,5,51,43,6,105,3.47619047619048,0.680712834732799,67
"10614052044.jpg",0,1,23,81,4,109,3.80733944954128,0.499575082782089,74.6207627118644
"10615424764.jpg",0,0,41,57,6,104,3.66346153846154,0.584767432371758,74.1903669724771
"10617981003.jpg",3,50,51,1,0,105,2.47619047619048,0.573371239908821,40.3175675675676
"10619909515.jpg",0,3,73,31,0,107,3.26168224299065,0.501628453763451,60.7775423728814
"10620203775.jpg",37,49,15,1,0,102,1.80392156862745,0.718072442996927,20.8611111111111
"10620356404.jpg",0,10,68,28,0,106,3.16981132075472,0.576883220223454,56.454347826087
"1062133952.jpg",0,6,76,27,2,111,3.22522522522523,0.56704472622512,60.9872881355932
"10625988224.jpg",0,4,59,38,1,102,3.35294117647059,0.574146957824214,66.8443396226415
"10628337356.jpg",0,3,29,71,1,104,3.67307692307692,0.547586189382175,75.4042056074766
"10628497685.jpg",0,18,65,26,0,109,3.07339449541284,0.634011654559731,54.9478260869565
"10628645805.jpg",0,0,19,71,12,102,3.93137254901961,0.549703861256738,83.5808823529412
"10631219374.jpg",0,4,42,61,1,108,3.5462962962963,0.586200489757354,71.7142857142857
"10631630073.jpg",20,81,4,0,0,105,1.84761904761905,0.45533065713392,21.4116379310345
"1063351510.jpg",0,37,63,9,0,109,2.74311926605505,0.599439085416844,47.1153846153846
"10633933603.jpg",0,10,75,27,0,112,3.15178571428571,0.556854444704245,58.8898305084746
"10635160054.jpg",0,1,61,62,0,124,3.49193548387097,0.517906475876725,69.7049180327869
"1063722220.jpg",0,11,85,15,0,111,3.03603603603604,0.484822890397344,56.0233050847458
"10642085843.jpg",0,0,25,75,7,107,3.83177570093458,0.52280053753367,74.8375
"10644234544.jpg",0,15,74,19,0,108,3.03703703703704,0.56246995227618,54.7289915966387
"106456452.jpg",19,64,16,1,0,100,1.99,0.627565441877087,25.2727272727273
"10660362264.jpg",0,0,32,66,7,105,3.76190476190476,0.563706987508198,77.8932038834951
"10660571735.jpg",1,28,72,11,0,112,2.83035714285714,0.598622937122711,47.7021739130435
"10660620125.jpg",0,1,37,67,6,111,3.7027027027027,0.581449514647263,73.7898230088496
"106652866.jpg",0,29,50,19,0,98,2.89795918367347,0.695935118411553,49.0441176470588
"10665464526.jpg",0,0,20,76,9,105,3.8952380952381,0.517460692000434,76.9138655462185
"10676427864.jpg",0,0,23,74,2,99,3.78787878787879,0.457872793865044,75.872641509434
"1067765170.jpg",0,23,75,9,0,107,2.86915887850467,0.533484666709199,51.175
"10678199353.jpg",0,1,50,57,0,108,3.51851851851852,0.520270984055541,70.3611111111111
"10678350303.jpg",0,4,53,52,5,114,3.50877192982456,0.641425597463337,66.7866379310345
"10679134563.jpg",7,64,25,2,0,98,2.22448979591837,0.601212044602581,33.2791262135922
"10680153225.jpg",2,39,58,7,0,106,2.66037735849057,0.630748496445449,45.4065217391304
"10680502673.jpg",0,1,16,75,15,107,3.97196261682243,0.573929584880092,78.75625
"10680715605.jpg",6,56,45,3,0,110,2.40909090909091,0.639602149066831,37.3
"10680932454.jpg",0,27,63,18,0,108,2.91666666666667,0.643079623273167,51.39375
"10683218616.jpg",0,2,41,68,1,112,3.60714285714286,0.542884236944945,69.4391304347826
"10686332213.jpg",0,12,70,24,0,106,3.11320754716981,0.574385878540122,57.4216101694915
"10689376076.jpg",0,6,88,19,1,114,3.13157894736842,0.489051056833571,59.239406779661
"10689538413.jpg",0,2,28,71,7,108,3.76851851851852,0.58973273657517,73.66875
"10689722684.jpg",0,0,19,82,7,108,3.88888888888889,0.480134975830314,76.14375
"10690294454.jpg",0,2,37,70,0,109,3.62385321100917,0.523326093822681,72.5
"10692654005.jpg",0,3,52,51,1,107,3.46728971962617,0.571620619162577,68.2
"10692667386.jpg",0,0,46,52,5,103,3.60194174757282,0.583091924701258,71.9033018867924
"10692857705.jpg",0,3,44,47,8,102,3.58823529411765,0.680025351543596,68.9678899082569
"10693826785.jpg",0,19,68,17,0,104,2.98076923076923,0.590881671836269,53.2757009345794
"10694350076.jpg",0,3,36,67,1,107,3.61682242990654,0.560405173724722,73.1285714285714
"10698962263.jpg",3,41,47,8,0,99,2.60606060606061,0.682405436645177,39.1106194690265
"10705911926.jpg",0,2,39,55,4,100,3.61,0.601261300530104,70.7844036697248
"10706770686.jpg",0,0,25,78,3,106,3.79245283018868,0.472419932890129,76.8519417475728
"10713772814.jpg",0,7,71,30,0,108,3.21296296296296,0.547738356358812,62.3301886792453
"10714662986.jpg",0,0,10,90,13,113,4.02654867256637,0.452378179954687,80.6551724137931
"10715577856.jpg",3,40,54,8,0,105,2.63809523809524,0.666849791698734,45.2135922330097
"10721124556.jpg",0,17,61,31,1,110,3.14545454545455,0.67506525184252,58.4579646017699
"10723077086.jpg",0,7,34,64,1,106,3.55660377358491,0.633661899923134,71.8529411764706
"10724461514.jpg",0,2,36,67,3,108,3.65740740740741,0.566379500873785,72.6631355932203
"10724889206.jpg",0,3,57,38,0,98,3.35714285714286,0.542046522901578,63.5183486238532
"10728525673.jpg",0,1,45,58,0,104,3.54807692307692,0.5191443238415,68.3026315789474
"10730634575.jpg",0,16,64,24,0,104,3.07692307692308,0.618364703590649,58.75
"10732971054.jpg",0,19,75,8,0,102,2.8921568627451,0.505550630992575,51.1
"10733259996.jpg",0,4,69,27,0,100,3.23,0.509604719068583,62.3197115384615
"10737029565.jpg",0,6,60,38,1,105,3.32380952380952,0.596387169276516,63.0172413793103
"10740242265.jpg",0,3,37,60,0,100,3.57,0.555141259664437,69.1192660550459
"10740725955.jpg",0,1,10,87,4,102,3.92156862745098,0.414735380499062,77.1482300884956
"10740727595.jpg",0,1,30,74,4,109,3.74311926605505,0.534090950167954,72.9125
"10745415703.jpg",0,3,51,45,4,103,3.48543689320388,0.624092716683751,69.1388888888889
"10745932825.jpg",0,4,51,50,1,106,3.45283018867925,0.587684325235566,64.8846153846154
"10747724694.jpg",0,10,73,19,0,102,3.08823529411765,0.528456395467316,58.438679245283
"107505789.jpg",0,13,64,23,0,100,3.1,0.594588390010563,54.35
"10751799554.jpg",0,2,30,66,4,102,3.70588235294118,0.573131666211361,71.9954128440367
"1075190309.jpg",5,53,47,4,1,110,2.48181818181818,0.687126955429197,38.2697368421053
"10762659033.jpg",1,47,45,7,0,100,2.58,0.638495706858525,42.25
"10765812585.jpg",2,38,59,7,0,106,2.66981132075472,0.628250755415498,46.6448598130841
"10767441335.jpg",0,1,28,68,7,104,3.77884615384615,0.573809121695014,74.2094594594595
"10770026303.jpg",0,0,39,66,1,106,3.64150943396226,0.501211470344994,72.0825892857143
"10770700455.jpg",0,6,70,33,1,110,3.26363636363636,0.569520524672599,60.74375
"10773126784.jpg",0,0,19,77,6,102,3.87254901960784,0.480749592657772,78.475
"10775358296.jpg",10,53,42,7,0,112,2.41071428571429,0.741966845967393,37.7754237288136
"10776111906.jpg",0,0,35,61,5,101,3.7029702970297,0.557576083695231,73.975
"107799222.jpg",0,1,28,70,3,102,3.73529411764706,0.525139690764791,73.2727272727273
"10783395635.jpg",0,0,45,62,2,109,3.60550458715596,0.527368530639052,71.9915966386555
"10784159775.jpg",0,1,20,76,5,102,3.83333333333333,0.508994997608777,74.8849557522124
"10786271105.jpg",0,1,54,55,0,110,3.49090909090909,0.520152668934002,67.775641025641
"10787038944.jpg",0,9,60,35,0,104,3.25,0.603388490031847,60.4978813559322
"10787258285.jpg",0,0,42,61,7,110,3.68181818181818,0.589383415677403,71.8940677966102
"10790803694.jpg",0,3,46,90,1,140,3.63571428571429,0.539260275190716,73.8564189189189
"10791502435.jpg",0,0,35,73,2,110,3.7,0.498621954200784,70.813025210084
"10792125886.jpg",0,2,60,66,1,129,3.51162790697674,0.546527090330494,71.2224409448819
"10798439785.jpg",0,12,64,26,0,102,3.13725490196078,0.597672311394309,60.025
"10799367156.jpg",0,0,31,69,5,105,3.75238095238095,0.533150151691889,73.6
"10799853136.jpg",0,2,51,53,1,107,3.49532710280374,0.555823912928399,69.6985981308411
"10805317444.jpg",0,15,73,13,0,101,2.98019801980198,0.528775907541219,51.9380733944954
"10806677866.jpg",0,7,63,33,0,103,3.25242718446602,0.572549280385056,60.9054054054054
"10813730303.jpg",4,81,69,1,0,155,2.43225806451613,0.55851559801853,40.0817307692308
"10814874265.jpg",0,2,25,78,1,106,3.73584905660377,0.503357996099393,78.2075471698113
"10819001424.jpg",29,65,10,0,0,104,1.81730769230769,0.587316144781357,20.7702702702703
"10819132874.jpg",0,1,34,66,2,103,3.66990291262136,0.531153932759187,75.7798165137615
"10819329365.jpg",0,2,81,18,0,101,3.15841584158416,0.417915619888195,59.9911504424779
"10827568885.jpg",0,1,25,74,9,109,3.8348623853211,0.569498828859231,77.4872881355932
"10828147985.jpg",1,15,76,16,0,108,2.99074074074074,0.571853362851923,54.1184210526316
"10828395135.jpg",0,0,38,63,6,107,3.70093457943925,0.569921432371165,74.0714285714286
"10829329963.jpg",0,1,27,79,0,107,3.72897196261682,0.467229761626852,78.7967289719626
"10836905604.jpg",0,0,31,69,3,103,3.72815533980583,0.508634750057745,75.9932432432432
"10843403305.jpg",0,1,51,49,3,104,3.51923076923077,0.574215703707125,69.9299065420561
"10847909336.jpg",13,83,8,0,0,104,1.95192307692308,0.448942829242549,24.114224137931
"10849117054.jpg",0,11,76,21,0,108,3.09259259259259,0.538898791271921,56.8684210526316
"10849700404.jpg",0,3,38,63,3,107,3.61682242990654,0.593118713070191,73.0065789473684
"1084984228.jpg",11,57,35,5,0,108,2.31481481481481,0.718879555873748,34.8319327731092
"1085590803.jpg",25,66,13,1,0,105,1.9047619047619,0.628242504681627,24.0558035714286
"10856434794.jpg",1,45,63,4,0,113,2.61946902654867,0.571941931224485,44.0375
"10856757.jpg",17,59,28,5,0,109,2.19266055045872,0.751258995388106,32.2954545454545
"10858952303.jpg",1,43,56,6,0,106,2.63207547169811,0.60671593255922,45.5647321428571
"10861031374.jpg",0,2,58,44,0,104,3.40384615384615,0.530967806041971,64.675
"10862487886.jpg",0,5,62,39,1,107,3.33644859813084,0.581863065548848,65.303738317757
"10864812016.jpg",0,12,77,17,0,106,3.04716981132075,0.52339688067375,56.8847826086957
"10865798996.jpg",0,0,23,69,8,100,3.85,0.538891492235719,76.4722222222222
"10866463396.jpg",1,2,52,47,2,104,3.45192307692308,0.62130160417126,69.1029411764706
"10866561184.jpg",0,0,19,81,5,105,3.86666666666667,0.461324736840019,77.3304347826087
"10868390853.jpg",0,2,43,82,3,130,3.66153846153846,0.550600041305835,75.3149606299213
"10872249945.jpg",0,1,20,76,8,105,3.86666666666667,0.538278357119799,77.0434782608696
"10875461386.jpg",0,16,72,19,0,107,3.02803738317757,0.573929584880092,55.3888888888889
"10880314705.jpg",0,1,26,75,9,111,3.82882882882883,0.570069754485822,77.4210526315789
"10882856833.jpg",0,5,69,33,1,108,3.27777777777778,0.560929357894812,62.0065789473684
"10883456586.jpg",11,74,17,2,0,104,2.09615384615385,0.583248864754567,28.8793103448276
"1089100444.jpg",0,4,62,40,0,106,3.33962264150943,0.550095964837135,64.6228813559322
"10893404795.jpg",0,58,42,0,0,100,2.42,0.496044963748858,36.8761467889908
"10895044423.jpg",13,56,40,0,0,109,2.24770642201835,0.654839014748017,32.4747899159664
"10897840884.jpg",0,3,28,66,9,106,3.76415094339623,0.640712204800294,74.8305084745763
"10898287705.jpg",1,42,54,10,0,107,2.68224299065421,0.652977662091876,44.2212389380531
"10898689245.jpg",0,5,62,44,1,112,3.36607142857143,0.58503154168122,64.1794871794872
"10899733355.jpg",0,1,47,80,1,129,3.62790697674419,0.516444688499233,73.9904580152672
"10900020096.jpg",0,3,46,57,0,106,3.50943396226415,0.556267887140855,69.3783783783784
"10905088155.jpg",0,7,59,41,1,108,3.33333333333333,0.611417840515743,63.7139830508475
"10905114716.jpg",0,23,74,8,0,105,2.85714285714286,0.526756611228115,50.0695652173913
"10906887886.jpg",1,45,52,4,0,102,2.57843137254902,0.587599151267575,43.1061320754717
"1090979049.jpg",0,5,88,15,0,108,3.09259259259259,0.422211291327052,57.5304347826087
"10910262455.jpg",2,43,54,6,0,105,2.60952380952381,0.627805060619293,42.1763392857143
"10911046243.jpg",0,0,28,71,4,103,3.76699029126214,0.508821851314784,76.2339449541284
"10911095273.jpg",0,1,39,62,5,107,3.66355140186916,0.581863065548848,71.3805309734513
"10912602716.jpg",0,1,44,86,2,133,3.66917293233083,0.518181618320084,74.9510869565217
"10915557435.jpg",0,53,51,1,0,105,2.5047619047619,0.521163814564789,39.1836283185841
"10917741563.jpg",0,1,34,69,2,106,3.67924528301887,0.526392390510218,75.9439252336449
"10921653346.jpg",0,1,19,63,26,109,4.04587155963303,0.671997038972167,79.6176470588235
"10921880365.jpg",0,2,46,56,1,105,3.53333333333333,0.55585462035892,68.5065217391304
"10923819485.jpg",1,53,45,8,0,107,2.5607476635514,0.646873031393711,40.8275862068966
"10925112255.jpg",32,45,20,1,0,98,1.89795918367347,0.752861153097054,22.7924528301887
"10927420963.jpg",0,2,56,52,1,111,3.46846846846847,0.553005339770699,64.9551282051282
"10931213005.jpg",0,39,59,9,0,107,2.7196261682243,0.611129367821924,47.0625
"10932590295.jpg",6,53,45,4,0,108,2.43518518518519,0.659554482145832,38.4144736842105
"10933722123.jpg",1,15,78,15,0,109,2.98165137614679,0.56078072852426,53.6890756302521
"10936496124.jpg",0,7,61,33,1,102,3.27450980392157,0.599618075558597,59.1150442477876
"10937404313.jpg",3,12,58,36,1,110,3.18181818181818,0.744173923907702,56.61875
"10947519133.jpg",0,1,34,70,0,105,3.65714285714286,0.496692356195761,74.6092233009709
"10948257133.jpg",3,43,52,5,0,103,2.57281553398058,0.635578195117856,42.0928571428571
"10953973716.jpg",0,0,37,63,3,103,3.66990291262136,0.531153932759187,72.6486486486486
"10961758274.jpg",0,1,21,84,1,107,3.79439252336449,0.450121949031789,75.1806722689076
"10967023396.jpg",0,14,67,24,0,105,3.0952380952381,0.596847640715037,55.4797297297297
"10968711744.jpg",0,0,18,78,8,104,3.90384615384615,0.493043466234686,78.3793103448276
"10980930876.jpg",0,1,42,58,6,107,3.64485981308411,0.602703601371043,69.3571428571429
"10981006796.jpg",36,56,7,0,0,99,1.70707070707071,0.593373703573349,17.7402912621359
"109825878.jpg",5,56,43,2,0,106,2.39622641509434,0.612244042270399,37.23125
"10983119996.jpg",0,10,74,17,0,101,3.06930693069307,0.514925737219927,57.5389908256881
"10990397626.jpg",9,54,43,2,0,108,2.35185185185185,0.660144628939776,35.71875
"10990887046.jpg",1,18,98,28,1,146,3.06849315068493,0.606374576923349,58.0765306122449
"11004139923.jpg",0,2,54,45,0,101,3.42574257425743,0.535659120214812,68.2411504424779
"11005410885.jpg",0,11,85,17,0,113,3.05309734513274,0.497147361823322,55.4915966386555
"11006895124.jpg",0,13,41,45,4,103,3.38834951456311,0.757097265084732,66.2567567567568
"1100873520.jpg",1,22,76,8,0,107,2.85046728971963,0.546062031132427,51.5221238938053
"11009340314.jpg",0,6,56,39,1,102,3.34313725490196,0.605177300576438,63.0277777777778
"11010062705.jpg",0,1,51,48,1,101,3.48514851485149,0.540626699047293,67.6689189189189
"11013892854.jpg",6,93,12,0,0,111,2.05405405405405,0.400859028447609,27.4978813559322
"11016309165.jpg",0,6,62,37,0,105,3.2952380952381,0.570489154548862,62.6891891891892
"11016485883.jpg",0,0,52,54,1,107,3.52336448598131,0.52026470752557,68.1785714285714
"11018079835.jpg",0,0,22,86,2,110,3.81818181818182,0.432229513059863,76.6602564102564
"1101948952.jpg",0,0,26,73,1,100,3.75,0.457816513022367,75.1743119266055
"11021514993.jpg",0,1,52,45,2,100,3.48,0.559220236335625,67.7432432432432
"11021929275.jpg",0,2,32,66,1,101,3.65346534653465,0.537320082713394,72.175
"11023346856.jpg",0,2,73,28,1,104,3.26923076923077,0.506861066174239,62.1513157894737
"11031973684.jpg",1,0,35,72,3,111,3.68468468468468,0.571791156756667,71.4745762711864
"11033459414.jpg",0,7,50,43,3,103,3.40776699029126,0.663279038134847,63.5565217391304
"110356262.jpg",4,63,36,3,0,106,2.35849056603774,0.604564845397998,35.925
"11035760784.jpg",0,4,55,46,1,106,3.41509433962264,0.583387880904894,66.1160714285714
"1103755154.jpg",0,3,31,76,1,111,3.67567567567568,0.542086242084683,73.0641025641026
"11051034136.jpg",0,1,60,47,0,108,3.42592592592593,0.515257012426105,65.531779661017
"11051374673.jpg",0,4,65,31,0,100,3.27,0.529054808029367,62.6148648648649
"11051749575.jpg",0,5,64,31,0,100,3.26,0.543464382782842,62.125
"11054039594.jpg",3,43,55,6,0,107,2.5981308411215,0.642222160528438,42.7352941176471
"11054638863.jpg",0,10,59,33,0,102,3.22549019607843,0.611876884418025,61.0070754716981
"11054899145.jpg",0,2,31,76,1,110,3.69090909090909,0.520152668934002,74.0512820512821
"11054955216.jpg",5,53,48,0,0,106,2.40566037735849,0.581922951646685,36.75
"11058112996.jpg",16,52,30,6,1,105,2.27619047619048,0.82619654598693,33.5540540540541
"11060185873.jpg",1,2,60,48,0,111,3.3963963963964,0.576498510276074,63.0148305084746
"11061633946.jpg",7,51,43,3,0,104,2.40384615384615,0.661261383174813,35.7837837837838
"11062902804.jpg",0,3,39,61,4,107,3.61682242990654,0.608816665608245,69.9117647058823
"11063650646.jpg",1,7,67,32,0,107,3.21495327102804,0.599182420692982,61.045652173913
"11068654734.jpg",0,6,50,46,1,103,3.40776699029126,0.617345570177128,68.0694444444444
"11071132393.jpg",1,3,35,62,3,104,3.60576923076923,0.644894350205953,72.0089285714286
"11078122366.jpg",0,2,38,64,1,105,3.60952380952381,0.545880342186223,69.972972972973
"11079282234.jpg",0,0,40,95,1,136,3.71323529411765,0.469958047541269,76.3617021276596
"11081975613.jpg",0,3,44,52,3,102,3.53921568627451,0.608057589564304,68.0023364485981
"11087687983.jpg",0,0,17,91,3,111,3.87387387387387,0.407143421616715,76.0889830508475
"11089447095.jpg",0,3,56,48,0,107,3.42056074766355,0.550083753101153,66.1824324324324
"11095381506.jpg",0,2,19,69,10,100,3.87,0.597215762238964,76.75
"11097661494.jpg",0,3,29,70,2,104,3.68269230769231,0.561973344855967,72.7171052631579
"11098121724.jpg",0,0,41,65,4,110,3.66363636363636,0.546503023439813,72.6410256410256
"11109548195.jpg",0,8,62,37,0,107,3.27102803738318,0.591928308030625,61.5231092436975
"11111585533.jpg",0,0,5,92,12,109,4.06422018348624,0.391465181219701,83.8495762711864
"11118140253.jpg",0,0,45,55,4,104,3.60576923076923,0.56462495896549,72.8235294117647
"11124139926.jpg",1,29,66,9,0,105,2.79047619047619,0.599603043290984,47.2146017699115
"11126091314.jpg",0,40,60,3,0,103,2.64077669902913,0.539687072220866,42.5472972972973
"11126232436.jpg",0,19,72,12,0,103,2.93203883495146,0.547044392261279,52.2094594594595
"11126652126.jpg",1,25,52,20,5,103,3.02912621359223,0.821957380217701,56.6485849056604
"11139368236.jpg",0,2,42,66,0,110,3.58181818181818,0.531258125581778,70.525641025641
"11139580153.jpg",0,38,58,5,0,101,2.67326732673267,0.567607450463595,45.325
"11141708043.jpg",0,6,43,50,1,100,3.46,0.626357112455213,66.9228971962617
"11143825565.jpg",1,7,60,38,3,109,3.32110091743119,0.678788871678054,62.3550420168067
"11148529964.jpg",1,7,92,21,0,121,3.09917355371901,0.506704362814024,58.2
"11149566996.jpg",0,28,65,9,0,102,2.81372549019608,0.575582221924289,47.3974358974359
"11150131936.jpg",0,5,69,31,2,107,3.2803738317757,0.579433564058746,63.9158878504673
"11153943035.jpg",0,12,59,25,2,98,3.1734693877551,0.658419071952629,60.2777777777778
"11155257336.jpg",0,8,84,16,0,108,3.07407407407407,0.467718736947386,58.2873831775701
"11156365526.jpg",0,32,64,12,0,108,2.81481481481481,0.613678172958258,47.5882352941176
"11158314215.jpg",1,39,60,7,0,107,2.68224299065421,0.608092142365009,46.3349514563107
"11159983896.jpg",0,1,45,55,5,106,3.60377358490566,0.59648566474642,71.0878378378378
"11163249414.jpg",0,1,55,41,0,97,3.41237113402062,0.515440291554779,67.9611650485437
"11165746213.jpg",1,2,54,41,5,103,3.45631067961165,0.668282830654486,64.3482142857143
"11169904264.jpg",0,1,55,48,2,106,3.4811320754717,0.556025557402873,68.546875
"11170758174.jpg",0,5,68,31,0,104,3.25,0.535170783012574,60.283185840708
"11170786154.jpg",0,3,48,55,2,108,3.51851851851852,0.587748459794076,67.6932773109244
"11172371243.jpg",0,1,28,65,7,101,3.77227722772277,0.581054009861594,75.8785714285714
"11175382195.jpg",2,34,60,14,2,112,2.82142857142857,0.737835716404095,49.4423076923077
"11175538013.jpg",2,0,36,64,6,108,3.66666666666667,0.669774686623137,73.6438053097345
"11183022383.jpg",2,40,58,5,0,105,2.62857142857143,0.60854718003592,43.0675675675676
"11201160185.jpg",0,8,65,34,0,107,3.24299065420561,0.580193876108751,62.3197115384615
"11208321473.jpg",0,1,46,54,3,104,3.56730769230769,0.57054603512134,72.8470873786408
"11209059333.jpg",0,9,70,28,1,108,3.19444444444444,0.587380265521398,60.125
"11209188974.jpg",0,1,58,44,2,105,3.44761904761905,0.554369919210997,66.9269911504425
"11209221046.jpg",1,12,57,26,1,97,3.14432989690722,0.676844558743757,58.75
"11209649786.jpg",0,0,58,46,0,104,3.44230769230769,0.499065594399243,69.475
"11215941184.jpg",0,3,38,59,5,105,3.62857142857143,0.624147770612408,73.4077669902913
"11216436636.jpg",0,2,33,72,1,108,3.66666666666667,0.529503382213656,74.0921052631579
"11218793016.jpg",0,5,73,30,0,108,3.23148148148148,0.522511574463429,60.9173728813559
"11219420725.jpg",0,0,38,60,3,101,3.65346534653465,0.537320082713394,72.8928571428571
"11221904805.jpg",0,2,25,78,1,106,3.73584905660377,0.503357996099393,78.1297169811321
"11226958966.jpg",0,1,29,81,3,114,3.75438596491228,0.50766520060712,72.954347826087
"11229777185.jpg",0,6,56,45,1,108,3.37962962962963,0.607085770358542,66.0747663551402
"11232665444.jpg",15,61,30,3,0,109,2.19266055045872,0.700225680818314,32.2668067226891
"11239106136.jpg",0,22,95,21,0,138,2.99275362318841,0.560192573921939,56.4172413793103
"11241096796.jpg",0,2,43,61,1,107,3.57009345794393,0.551364508625548,69.95625
"11242015725.jpg",0,4,56,41,0,101,3.36633663366337,0.560763270502406,63.7152777777778
"11245083256.jpg",1,9,52,42,5,109,3.37614678899083,0.742730084386975,61.775
"11245781693.jpg",0,2,46,52,1,101,3.51485148514851,0.558817705269592,67.515625
"11250215644.jpg",0,0,44,64,0,108,3.59259259259259,0.493642517690404,69.6776315789474
"11251138933.jpg",0,0,52,55,0,107,3.51401869158878,0.502155466817674,69.2239130434783
"11252383376.jpg",0,4,37,57,2,100,3.57,0.607279078174013,70.1032110091743
"11252644224.jpg",0,4,60,39,0,103,3.33980582524272,0.552239612285735,64.5872641509434
"11253432804.jpg",0,6,64,29,1,100,3.25,0.575159178669767,61.2027027027027
"11256485296.jpg",0,9,64,31,0,104,3.21153846153846,0.585804184173917,61.9044117647059
"11256776836.jpg",0,2,47,58,3,110,3.56363636363636,0.583052277500553,69.578125
"11260247205.jpg",0,3,23,63,11,100,3.82,0.657205593341377,74.7389380530973
"11260270773.jpg",0,0,37,61,4,102,3.67647058823529,0.547935182729598,72.3513513513514
"11260385706.jpg",0,1,39,61,2,103,3.62135922330097,0.544428191746183,72.7115384615385
"11262156493.jpg",0,2,27,95,5,129,3.7984496124031,0.521114265319402,79.9271653543307
"11264048414.jpg",28,74,6,0,0,108,1.7962962962963,0.525237093935651,20.8717391304348
"11268202995.jpg",2,49,50,7,1,109,2.59633027522936,0.682034891784842,41.734375
"11269474243.jpg",0,0,32,60,7,99,3.74747474747475,0.577528766726489,74.0608108108108
"11269626135.jpg",0,1,16,80,6,103,3.88349514563107,0.491116592398531,80.304054054054
"11270256213.jpg",0,1,59,42,3,105,3.44761904761905,0.571451464742874,66.3370535714286
"11270280904.jpg",13,57,30,5,0,105,2.25714285714286,0.734173677688726,31.7702702702703
"11273127766.jpg",0,1,25,65,13,104,3.86538461538462,0.624075118513327,79.5575221238938
"11273190884.jpg",0,0,30,78,2,110,3.74545454545455,0.477692535492641,74.823275862069
"11275584366.jpg",1,26,70,8,0,105,2.80952380952381,0.573371239908821,47.4336283185841
"11287273183.jpg",0,1,28,75,2,106,3.73584905660377,0.503357996099393,76.6973684210526
"11288559554.jpg",0,4,76,27,0,107,3.21495327102804,0.495794338509114,62.4509345794393
"11291450085.jpg",0,15,67,24,0,106,3.08490566037736,0.603449205315764,56.7394957983193
"11292980633.jpg",0,1,68,72,0,141,3.50354609929078,0.515808844370765,71.125
"11293176185.jpg",0,8,59,36,0,103,3.27184466019417,0.597284291315768,61.3
"11293946974.jpg",0,1,29,70,1,101,3.7029702970297,0.500890296481087,75.9800884955752
"11294894953.jpg",0,11,71,28,1,111,3.17117117117117,0.601118259033247,58.6101694915254
"11295475784.jpg",1,23,71,8,0,103,2.83495145631068,0.561808832510734,49.4144736842105
"11297504114.jpg",1,14,64,20,2,101,3.07920792079208,0.673545370659344,54.8899082568807
"11297570034.jpg",0,17,64,23,0,104,3.05769230769231,0.620474655090888,56.5260869565217
"11301386435.jpg",0,2,28,69,11,110,3.80909090909091,0.628022300566103,76.1512605042017
"11302087114.jpg",0,4,45,55,6,110,3.57272727272727,0.656080814404133,65.5441176470588
"1130601148.jpg",0,0,43,59,5,107,3.64485981308411,0.570539903993596,72.3804347826087
"11307198154.jpg",0,0,21,72,7,100,3.86,0.512864799952486,80.8
"11310848503.jpg",0,3,40,60,4,107,3.60747663551402,0.610552013542993,70.146186440678
"11316105544.jpg",0,0,20,85,4,109,3.85321100917431,0.447745134047106,77.8625
"11320098306.jpg",0,22,71,15,0,108,2.93518518518519,0.584426360625035,51.2236842105263
"11321228905.jpg",0,1,25,71,10,107,3.8411214953271,0.585187161001945,77.0337837837838
"11324704676.jpg",1,27,69,14,0,111,2.86486486486486,0.625030711776142,50.9230769230769
"11325081573.jpg",2,28,62,12,0,104,2.80769230769231,0.65473515103323,50.0285714285714
"11327123904.jpg",0,0,38,63,0,101,3.62376237623762,0.486856963563527,74.8715596330275
"11333447674.jpg",0,0,21,82,6,109,3.86238532110092,0.480506867956021,76.9978813559322
"11333611705.jpg",0,6,69,31,1,107,3.25233644859813,0.567906747990974,63.3495575221239
"11333782783.jpg",0,1,44,63,0,108,3.57407407407407,0.515257012426105,70.358407079646
"11335231214.jpg",0,4,51,49,1,105,3.44761904761905,0.588037027565055,68.960396039604
"11338371864.jpg",0,1,55,46,0,102,3.44117647058824,0.518442630026702,68.8245192307692
"11339056674.jpg",0,3,57,44,1,105,3.40952380952381,0.566623570867177,67.1633663366337
"11341117543.jpg",0,6,68,25,0,99,3.19191919191919,0.528315916558584,61.6850961538462
"11346267905.jpg",0,2,41,55,1,99,3.55555555555556,0.55736666241522,72.8701923076923
"11347140483.jpg",1,15,72,23,0,111,3.05405405405405,0.615523987241585,53.6890756302521
"11353895754.jpg",0,2,35,64,5,106,3.67924528301887,0.594373136150632,72.9741379310345
"11356760053.jpg",0,1,34,61,4,100,3.68,0.566399223876658,73.3577981651376
"113663782.jpg",0,2,43,52,2,99,3.54545454545455,0.576278122917761,67.55
"11369797883.jpg",0,0,32,62,6,100,3.74,0.561743318211757,74.0277777777778
"113701797.jpg",1,28,66,10,0,105,2.80952380952381,0.605983594840749,48.09375
"11370407443.jpg",0,38,61,7,0,106,2.70754716981132,0.585002745326492,47.3434782608696
"11372421485.jpg",0,4,60,37,1,102,3.34313725490196,0.571520432475467,65.6858407079646
"11378848184.jpg",1,4,62,40,2,109,3.34862385321101,0.629169746703143,64.1334745762712
"11381486584.jpg",0,21,72,16,1,110,2.97272727272727,0.612695816428967,51.94375
"11382799454.jpg",0,3,29,63,6,101,3.71287128712871,0.621878342819017,72.0711009174312
"11389102005.jpg",0,5,69,29,0,103,3.23300970873786,0.527738116410649,60.2920560747664
"11389330254.jpg",1,8,48,46,1,104,3.36538461538462,0.683476156467835,64.0535714285714
"11393787465.jpg",32,64,8,1,0,105,1.79047619047619,0.615430401227124,21.5849514563107
"11396447303.jpg",0,28,65,11,0,104,2.83653846153846,0.593010697902438,48.010775862069
"11399456186.jpg",0,8,57,38,1,104,3.30769230769231,0.624374219953223,63.2765486725664
"11404463006.jpg",0,13,79,12,0,104,2.99038461538462,0.492569886770648,54.1504424778761
"11406584295.jpg",0,10,72,23,0,105,3.12380952380952,0.549391938265845,55.3310810810811
"11407368256.jpg",0,1,38,70,3,112,3.66964285714286,0.543402574328055,72.2884615384615
"11407704456.jpg",0,3,36,62,2,103,3.61165048543689,0.58129351549086,72.1836283185841
"11407835876.jpg",1,10,87,38,0,136,3.19117647058824,0.590225391754621,61.1071428571429
"11407862453.jpg",0,0,44,63,3,110,3.62727272727273,0.53943720092777,70.6504424778761
"11408091114.jpg",0,1,51,52,4,108,3.5462962962963,0.586200489757354,68.2411504424779
"11408307524.jpg",0,6,55,45,1,107,3.38317757009346,0.608816665608245,66.4260869565217
"11408357925.jpg",0,12,68,28,0,108,3.14814814814815,0.593025110417193,58.1906779661017
"11408443745.jpg",0,5,59,36,0,100,3.31,0.563090318750649,63.475
"11410644126.jpg",0,7,59,41,0,107,3.31775700934579,0.592374990253441,63.6282608695652
"11410690075.jpg",0,2,47,53,2,104,3.52884615384615,0.573809121695014,71.3584905660377
"11414474354.jpg",37,60,7,0,0,104,1.71153846153846,0.585804184173917,18.5514705882353
"11414784395.jpg",0,2,72,79,1,154,3.51298701298701,0.539147390169856,70.9387096774194
"11416241303.jpg",0,4,54,52,1,111,3.45045045045045,0.58369884418623,68.3512931034483
"11419816946.jpg",0,0,34,84,3,121,3.74380165289256,0.492086131008158,76.14375
"11424871693.jpg",2,62,41,3,0,108,2.41666666666667,0.582052443280648,37.813025210084
"11426976205.jpg",6,63,40,2,0,111,2.34234234234234,0.61044686308095,35.1885593220339
"11432746805.jpg",0,3,63,45,2,113,3.4070796460177,0.576893901819924,65.55625
"11433127464.jpg",0,15,80,15,0,110,3,0.524623062587002,54.109375
"11433593823.jpg",0,4,68,32,2,106,3.30188679245283,0.571877631278959,62.9486607142857
"11436378704.jpg",0,0,15,80,8,103,3.93203883495146,0.469921477010247,79.3397435897436
"11436390143.jpg",0,1,45,54,3,103,3.57281553398058,0.570550847480092,72.4481132075472
"11436508006.jpg",0,5,72,44,0,121,3.32231404958678,0.550982093372943,65.14375
"11437542656.jpg",1,10,73,24,0,108,3.11111111111111,0.585388014675614,57.6041666666667
"11438612393.jpg",10,58,29,1,0,98,2.21428571428571,0.630005727350828,31.9953271028037
"11439591215.jpg",6,70,25,0,0,101,2.18811881188119,0.523695928705365,31.1736111111111
"11446005074.jpg",0,2,26,61,19,108,3.89814814814815,0.696316272737311,77.468487394958
"11452299875.jpg",0,1,24,77,3,105,3.78095238095238,0.499633565359354,74.4608695652174
"11453100924.jpg",0,0,19,81,7,107,3.88785046728972,0.482272584078292,79.0254237288136
"11456199025.jpg",7,61,32,2,0,102,2.2843137254902,0.619444832573349,34.5448113207547
"11459826225.jpg",0,5,66,38,0,109,3.30275229357798,0.552847630806364,62.875
"11460414725.jpg",0,2,44,56,0,102,3.52941176470588,0.539634683047106,71.95
"11461273913.jpg",0,2,38,62,2,104,3.61538461538462,0.562720374224038,70.7754237288136
"11474376103.jpg",3,26,58,24,1,112,2.94642857142857,0.769219631639002,53.25
"11476172786.jpg",0,1,36,57,7,101,3.69306930693069,0.612251161818836,72.625
"11477250346.jpg",0,0,22,78,3,103,3.81553398058252,0.459060695195325,77.0022123893805
"11484412296.jpg",0,4,74,30,0,108,3.24074074074074,0.509175077217316,63.2641509433962
"11490304024.jpg",0,28,56,22,1,107,2.96261682242991,0.712757515792089,54.6973684210526
"11495616074.jpg",1,66,38,1,0,106,2.36792452830189,0.522365894352903,37.8303571428571
"11498400544.jpg",1,25,101,13,0,140,2.9,0.540450118822498,50.6695205479452
"11499073263.jpg",9,78,21,1,0,109,2.12844036697248,0.546044995961577,30.21875
"11501016504.jpg",0,15,63,27,0,105,3.11428571428571,0.625027471923707,55.4073275862069
"11501322724.jpg",0,0,28,77,5,110,3.79090909090909,0.508558938073631,73.39375
"11503076944.jpg",0,0,23,73,5,101,3.82178217821782,0.497916450902366,79.0464601769911
"11504259765.jpg",2,40,55,6,0,103,2.63106796116505,0.626072276447375,43.5022321428571
"11504601393.jpg",1,25,59,21,0,106,2.94339622641509,0.687717947157675,52.3177966101695
"11506037556.jpg",0,27,91,18,0,136,2.93382352941176,0.573516842496758,54.2555970149254
"11509515706.jpg",4,66,42,1,0,113,2.35398230088496,0.565691012048553,35.7522123893805
"11511265293.jpg",26,65,13,0,0,104,1.875,0.602382003109242,24.2767857142857
"11514342335.jpg",0,1,36,63,3,103,3.66019417475728,0.552239612285735,71.9646017699115
"11515148456.jpg",0,5,63,35,3,106,3.33962264150943,0.615464090520783,64.4316037735849
"11518631385.jpg",17,51,35,4,0,107,2.24299065420561,0.762828914463801,32.2668067226891
"11519797605.jpg",0,1,29,71,6,107,3.76635514018692,0.559302787883853,72.9125
"11520125355.jpg",0,5,44,54,0,103,3.47572815533981,0.591519482286928,65.7477678571429
"11521791886.jpg",0,23,64,17,0,104,2.94230769230769,0.620474655090888,51.3839285714286
"11522920033.jpg",0,12,66,25,1,104,3.14423076923077,0.614047043369844,57.3275862068966
"11522984926.jpg",1,58,77,3,0,139,2.58992805755396,0.549214849861617,44.3826530612245
"11523093675.jpg",0,2,35,63,6,106,3.68867924528302,0.607307995088549,73.0978260869565
"1152554814.jpg",4,61,35,7,0,107,2.42056074766355,0.67345046711118,39.0147058823529
"11527524903.jpg",1,69,30,0,0,100,2.29,0.477683805651624,33.697247706422
"115290990.jpg",9,34,52,9,0,104,2.58653846153846,0.770960527153419,42.9432773109244
"11529156723.jpg",0,0,42,63,0,105,3.6,0.49224759248542,69.6517857142857
"11533404563.jpg",0,3,53,48,1,105,3.44761904761905,0.571451464742874,65.466814159292
"11535275706.jpg",0,1,28,66,6,101,3.76237623762376,0.568304757176731,74.95
"11541375264.jpg",0,19,82,7,0,108,2.88888888888889,0.480134975830314,50.3513513513514
"11546100824.jpg",0,2,42,51,3,98,3.56122448979592,0.593197286954127,70.7087155963303
"11548683805.jpg",1,52,56,5,0,114,2.57017543859649,0.594507280865439,42.3910256410256
"1154962046.jpg",45,58,2,0,0,105,1.59047619047619,0.531602043450486,15.8361344537815
"11551017545.jpg",0,3,51,46,1,101,3.44554455445545,0.574025217647317,64.027027027027
"11554709013.jpg",0,0,43,55,1,99,3.57575757575758,0.516876590704738,68.7733644859813
"11555549865.jpg",0,5,67,32,0,104,3.25961538461538,0.539600576976746,60.9402654867257
"11559530473.jpg",0,10,64,36,0,110,3.23636363636364,0.604680106910321,57.925
"1159028861.jpg",0,0,36,71,2,109,3.68807339449541,0.503639489420867,72.9125
"11706252.jpg",8,72,23,4,0,107,2.21495327102804,0.62988524536149,32.2521186440678
"117172917.jpg",0,5,57,41,0,103,3.3495145631068,0.572383010806878,62.9789915966387
"1172858625.jpg",0,2,50,55,2,109,3.52293577981651,0.570839704347729,69.3157894736842
"1194894463.jpg",0,3,56,46,0,105,3.40952380952381,0.549391938265845,67.490099009901
"1195689121.jpg",7,68,30,0,0,105,2.21904761904762,0.554369919210997,32.1347826086957
"1202598832.jpg",0,7,65,35,0,107,3.26168224299065,0.571929019842775,63.0677570093458
"120328351.jpg",3,51,50,2,0,106,2.4811320754717,0.589287415935903,39.225
"120459577.jpg",0,29,50,19,1,99,2.91919191919192,0.723889264233701,51.4012605042017
"120983206.jpg",0,8,53,43,2,106,3.36792452830189,0.652109714667755,63.0125
"121123359.jpg",0,0,5,59,36,100,4.31,0.563090318750649,88.24375
"122346209.jpg",16,53,29,7,0,105,2.25714285714286,0.796972292595442,34.20625
"122553631.jpg",3,60,43,1,0,107,2.39252336448598,0.562289949809258,37.85
"122760647.jpg",1,23,58,17,0,99,2.91919191919192,0.6651187967661,50.9125
"123242995.jpg",0,9,51,38,1,99,3.31313131313131,0.649119728059794,60.968487394958
"1240561841.jpg",0,0,24,78,6,108,3.83333333333333,0.502331014967353,74.5508474576271
"1241002913.jpg",1,19,72,11,0,103,2.90291262135922,0.569047417073793,54.0902777777778
"1249337589.jpg",0,1,39,56,5,101,3.64356435643564,0.593028809010854,72.3086956521739
"1252945239.jpg",45,55,6,0,0,106,1.63207547169811,0.590810124975516,15.6584821428571
"125829275.jpg",10,60,28,5,0,103,2.27184466019417,0.702853773279595,34.1386554621849
"1266777709.jpg",1,5,58,42,0,106,3.33018867924528,0.61290406478708,64.1442307692308
"127977276.jpg",0,0,19,62,18,99,3.98989898989899,0.61436792630843,80.1029411764706
"128079586.jpg",1,15,47,39,0,102,3.2156862745098,0.726137904972236,57.640756302521
"128293583.jpg",0,4,26,63,9,102,3.75490196078431,0.666545319959921,72.4075630252101
"1286765019.jpg",0,0,40,61,4,105,3.65714285714286,0.551720585437597,71.551724137931
"128715765.jpg",0,18,54,29,0,101,3.10891089108911,0.676771602522002,56.9772727272727
"128781220.jpg",3,15,36,42,3,99,3.27272727272727,0.866828394595597,59.7205882352941
"1288155068.jpg",0,10,90,30,0,130,3.15384615384615,0.535000376172272,61.19921875
"1289162225.jpg",0,4,73,36,0,113,3.28318584070796,0.525578364224196,62.1470588235294
"129023751.jpg",0,0,13,80,6,99,3.92929292929293,0.434542340825268,77.6764705882353
"1292518332.jpg",0,0,53,50,0,103,3.48543689320388,0.502231835965145,65.7086956521739
"12949713.jpg",0,1,12,61,30,104,4.15384615384615,0.650156527370256,84.9102564102564
"1295925783.jpg",4,71,26,0,0,101,2.21782178217822,0.502074902699579,30.8040540540541
"1296759644.jpg",4,69,26,1,0,100,2.24,0.534090371802868,32.1320754716981
"1296775174.jpg",4,59,37,4,0,104,2.39423076923077,0.629659628052651,37.4245283018868
"1297819816.jpg",0,0,36,70,3,109,3.69724770642202,0.518269684480167,74.2794117647059
"1302738127.jpg",0,0,27,80,4,111,3.79279279279279,0.48835749046476,75.8141025641026
"1306121832.jpg",18,57,29,1,0,105,2.12380952380952,0.689135998848141,30.1305309734513
"1306193020.jpg",7,69,30,2,0,108,2.25,0.597893498471106,33.573275862069
"1312413141.jpg",37,57,9,1,0,104,1.75,0.649869292309906,19.4151785714286
"1313706108.jpg",3,71,33,0,0,107,2.2803738317757,0.510168165455875,34.4159663865546
"1314838096.jpg",0,4,56,39,0,99,3.35353535353535,0.559028518003738,64.1756756756757
"1315889745.jpg",12,72,20,3,0,107,2.13084112149533,0.630724533202599,27.7567567567568
"1316239068.jpg",0,5,62,37,0,104,3.30769230769231,0.558724676052145,61.6165254237288
"1317678723.jpg",2,57,39,3,0,101,2.42574257425743,0.5890082283545,38.9197247706422
"132921013.jpg",0,3,26,67,6,102,3.74509803921569,0.608296998034594,72.5909090909091
"1329449674.jpg",0,34,55,10,0,99,2.75757575757576,0.624187783932359,44.6592920353982
"1329713028.jpg",0,15,65,19,1,100,3.06,0.616605238545717,52.7632743362832
"1331642031.jpg",0,19,107,14,0,140,2.96428571428571,0.48592734581001,54.2905405405405
"1332211559.jpg",23,72,7,1,0,103,1.86407766990291,0.560961074622452,22.6106194690265
"13325497.jpg",0,11,54,33,4,102,3.29411764705882,0.711827035589678,60.2307692307692
"133829142.jpg",18,67,14,0,0,99,1.95959595959596,0.569983743398538,23.4125
"134343714.jpg",12,40,35,14,1,102,2.52941176470588,0.908767878225174,40.031512605042
"1348094685.jpg",0,1,31,71,5,108,3.74074074074074,0.553162029808515,72.3834745762712
"1348788122.jpg",1,19,67,9,0,96,2.875,0.566615064729969,49.6
"1351464251.jpg",0,0,46,53,2,101,3.56435643564356,0.536951423951151,68.8504672897196
"1351917139.jpg",0,5,75,33,0,113,3.24778761061947,0.526629672189905,61.0258620689655
"1352428885.jpg",0,25,72,10,0,107,2.85981308411215,0.55709147195867,51.5794392523364
"135352055.jpg",44,50,5,0,0,99,1.60606060606061,0.585856808760517,15.8361344537815
"135403304.jpg",27,54,18,3,0,102,1.97058823529412,0.75065492662749,25.0567226890756
"1357295757.jpg",1,5,49,63,5,123,3.53658536585366,0.681039260403037,70.8181818181818
"1360063696.jpg",0,1,46,57,1,105,3.55238095238095,0.536745040121693,70.4816513761468
"1360663704.jpg",0,0,24,81,5,110,3.82727272727273,0.485743370706337,77.224358974359
"1362231035.jpg",0,1,36,58,5,100,3.67,0.586979943903925,72.6766055045872
"136287514.jpg",27,64,13,0,0,104,1.86538461538462,0.608319223614763,22.79375
"1367218588.jpg",8,78,20,0,0,106,2.11320754716981,0.503714861082965,29.3156779661017
"1368120580.jpg",0,0,13,91,6,110,3.93636363636364,0.412583552333803,78.6059322033898
"136948336.jpg",0,0,16,76,14,106,3.9811320754717,0.534186200379279,78.9625
"1375320148.jpg",2,14,63,21,3,103,3.0873786407767,0.729044447345961,55.15
"137731604.jpg",33,55,16,0,0,104,1.83653846153846,0.669887353565891,21.5903361344538
"137841242.jpg",0,4,38,50,8,100,3.62,0.693111852736656,70.7125
"138750201.jpg",0,20,54,27,3,104,3.125,0.746350343304977,56.34375
"1387568510.jpg",16,68,20,0,0,104,2.03846153846154,0.589932971724506,27.8310810810811
"1392405539.jpg",0,5,64,28,0,97,3.23711340206186,0.535669283005862,60.752427184466
"139253033.jpg",9,71,25,1,0,106,2.16981132075472,0.576883220223454,30.90625
"1396109073.jpg",0,10,60,40,1,111,3.28828828828829,0.637999535300307,63.4343220338983
"139611767.jpg",42,46,9,1,1,99,1.71717171717172,0.756474152685811,17.6386554621849
"1396758393.jpg",0,15,68,17,0,100,3.02,0.568179797976206,54.25
"139999071.jpg",21,68,14,2,0,105,1.97142857142857,0.642368556700406,25.68125
"1402675396.jpg",11,81,19,1,0,112,2.08928571428571,0.546134185216919,29.9102564102564
"1404458044.jpg",1,48,49,3,0,101,2.53465346534653,0.57557547612183,42.0957943925234
"1408118135.jpg",1,39,65,5,0,110,2.67272727272727,0.576434642795271,44.5132743362832
"1408827056.jpg",4,72,25,1,0,102,2.22549019607843,0.524769874035287,30.6852678571429
"14092652.jpg",0,5,41,50,11,107,3.62616822429907,0.733605267439337,69.0275423728814
"1410303503.jpg",0,4,45,53,2,104,3.50961538461538,0.607320908240659,68.9888392857143
"141087919.jpg",0,1,11,76,11,99,3.97979797979798,0.514678381440689,79.5483193277311
"1413089132.jpg",2,50,44,8,0,104,2.55769230769231,0.665763640336886,40.5405405405405
"141683460.jpg",0,4,37,56,5,102,3.6078431372549,0.647261753180778,68.594537815126
"1418012844.jpg",30,59,13,1,0,103,1.85436893203884,0.662848384022915,21.4116379310345
"142117255.jpg",0,6,44,48,7,105,3.53333333333333,0.708012747965777,67.9625
"142607218.jpg",1,18,58,26,2,105,3.0952380952381,0.727532837268552,55.8625
"1427484100.jpg",0,1,45,55,2,103,3.56310679611651,0.554304066633732,71.65
"1428835063.jpg",0,15,76,12,0,103,2.97087378640777,0.513662563374043,52.7758620689655
"1429120335.jpg",0,11,71,25,0,107,3.13084112149533,0.567751476149933,59.5675675675676
"1429419760.jpg",1,1,43,66,0,111,3.56756756756757,0.566032790916852,68.4807692307692
"1429848565.jpg",0,4,45,49,2,100,3.49,0.611258017236881,67.8325688073395
"1430765461.jpg",0,22,69,15,0,106,2.93396226415094,0.589896971222672,52.8571428571429
"1431934782.jpg",1,7,66,37,1,112,3.26785714285714,0.629344616307033,64.1272321428571
"143394138.jpg",13,66,26,1,0,106,2.14150943396226,0.623945651559997,29.94375
"1434258458.jpg",0,4,50,47,6,107,3.51401869158878,0.66395734662544,67.8608695652174
"143622689.jpg",0,8,51,44,2,105,3.38095238095238,0.656051012043218,62.7375
"143643298.jpg",29,63,12,0,0,104,1.83653846153846,0.609162674131378,22.1449579831933
"143899204.jpg",4,36,56,10,0,106,2.67924528301887,0.697576345865362,44.8625
"144272742.jpg",38,45,17,5,0,105,1.8952380952381,0.842658448051914,24.16875
"1446670895.jpg",0,6,65,35,0,106,3.27358490566038,0.561172562678651,61.3326086956522
"145089144.jpg",35,69,2,0,0,106,1.68867924528302,0.504516884368361,19.425
"145215893.jpg",68,35,1,0,0,104,1.35576923076923,0.500839474520766,10.14375
"145517507.jpg",2,52,49,5,0,108,2.52777777777778,0.618383985800151,41.35625
"1459611891.jpg",5,64,34,1,0,104,2.29807692307692,0.572506118885479,34.7236842105263
"1461013559.jpg",1,4,62,43,0,110,3.33636363636364,0.594736434219807,63.8881578947368
"1465282532.jpg",6,62,33,3,0,104,2.31730769230769,0.627282984976657,35.6941964285714
"1465706268.jpg",0,4,78,21,1,104,3.18269230769231,0.497848245231476,59.78125
"1466864952.jpg",1,32,94,2,0,129,2.75193798449612,0.484623045390983,47.3169291338583
"146926363.jpg",73,31,1,0,0,105,1.31428571428571,0.486634551602316,9.9375
"1473138944.jpg",7,67,28,0,0,102,2.20588235294118,0.551114717247404,31.8050458715596
"147639760.jpg",2,36,42,19,1,100,2.81,0.80018937152591,47.40625
"147783170.jpg",9,55,38,2,0,104,2.31730769230769,0.657509615669258,34.2079831932773
"1487386722.jpg",8,81,17,0,0,106,2.08490566037736,0.480434813541747,28.9459459459459
"14898266.jpg",9,51,39,10,0,109,2.45871559633028,0.776174260833499,38.7727272727273
"1490095554.jpg",3,14,58,27,1,103,3.0873786407767,0.742370291258502,55.0669642857143
"1492755190.jpg",0,12,64,33,1,110,3.20909090909091,0.636726930732686,60.2058823529412
"1494601659.jpg",10,63,27,2,0,102,2.20588235294118,0.634615893715864,31.0481651376147
"149795981.jpg",0,6,51,45,1,103,3.39805825242718,0.615801817897875,63.0483193277311
"149836125.jpg",5,28,47,22,0,102,2.84313725490196,0.817447101134248,46.7563025210084
"149867784.jpg",0,3,29,59,7,98,3.71428571428571,0.642161299067936,72.8928571428571
"1500316824.jpg",0,3,42,57,2,104,3.55769230769231,0.588348405414552,72.0955882352941
"15012954.jpg",15,72,17,0,0,104,2.01923076923077,0.557051342926048,25.8910256410256
"1511406857.jpg",0,1,26,68,9,104,3.81730769230769,0.587316144781357,74.9679487179487
"1513796016.jpg",1,3,33,63,5,105,3.64761904761905,0.664786726658552,70.1216216216216
"1516506386.jpg",0,3,55,45,2,105,3.43809523809524,0.587101903155359,66.7866379310345
"1519242706.jpg",0,0,39,66,1,106,3.64150943396226,0.501211470344994,73.9430693069307
"1519650440.jpg",1,19,69,18,1,108,2.99074074074074,0.648439829537242,53.1567796610169
"1527228794.jpg",19,95,18,0,0,132,1.99242424242424,0.531399019458167,25.3125
"152780037.jpg",5,43,42,9,0,99,2.55555555555556,0.731537690273201,40.6554621848739
"1529757375.jpg",0,2,51,47,1,101,3.46534653465347,0.557931114666382,66.775
"153557108.jpg",0,7,41,51,5,104,3.51923076923077,0.696464988502015,67.4159663865546
"153876946.jpg",0,15,70,19,0,104,3.03846153846154,0.573239422405291,52.9264705882353
"1539716347.jpg",1,57,44,3,0,105,2.46666666666667,0.572891899231546,37.9827586206897
"1540229828.jpg",0,2,29,71,7,109,3.76146788990826,0.591593619415785,72.9125
"154270569.jpg",0,2,33,66,0,101,3.63366336633663,0.523884954493403,70.4772727272727
"1543375325.jpg",19,79,9,0,0,107,1.90654205607477,0.505306002570194,23.9474789915966
"1543929747.jpg",11,53,35,5,0,104,2.32692307692308,0.729972837535723,33.7203389830508
"154603426.jpg",1,8,43,45,4,101,3.42574257425743,0.739547627316393,64
"154740129.jpg",81,23,2,0,0,106,1.25471698113208,0.479311425846485,7.6
"155289213.jpg",3,31,54,16,0,104,2.79807692307692,0.729141105210058,48.0735294117647
"155365010.jpg",31,57,12,0,0,100,1.81,0.63077633744362,21.14375
"155711788.jpg",59,42,4,0,0,105,1.47619047619048,0.573371239908821,13.16875
"155797839.jpg",0,0,19,71,14,104,3.95192307692308,0.563963224241827,79.4096638655462
"1558503807.jpg",1,7,61,31,0,100,3.22,0.612661028100805,58.6728971962617
"156015117.jpg",1,10,55,33,4,103,3.28155339805825,0.733210449528076,62.077731092437
"156117321.jpg",10,59,28,1,0,98,2.20408163265306,0.625228760996076,32.2668067226891
"1561250178.jpg",0,8,68,31,0,107,3.21495327102804,0.56681895188049,61.4191176470588
"1562015932.jpg",0,12,78,17,0,107,3.04672897196262,0.520942135817106,56.0233050847458
"156266461.jpg",2,52,48,4,0,106,2.50943396226415,0.605455877341205,41.0125
"156451756.jpg",1,29,52,17,0,99,2.85858585858586,0.700001472448903,48.0735294117647
"1565882132.jpg",1,40,59,3,0,103,2.62135922330097,0.562147577692258,43.5878378378378
"1571972975.jpg",2,34,49,19,1,105,2.83809523809524,0.773650307655079,50.9004854368932
"1572596360.jpg",1,15,74,14,0,104,2.97115384615385,0.565285919050108,56.0252293577982
"1572804254.jpg",2,17,71,12,0,102,2.91176470588235,0.598727051921314,50.7844827586207
"1573719804.jpg",0,2,38,69,2,111,3.63963963963964,0.552560861194046,72.5
"1576235224.jpg",10,77,17,2,0,106,2.10377358490566,0.567857213491777,28.9065217391304
"1580074951.jpg",0,6,54,43,3,106,3.40566037735849,0.644068938735339,67.5892857142857
"158100229.jpg",0,19,63,19,1,102,3.01960784313725,0.644556677133118,53.7584033613445
"159144665.jpg",0,1,27,68,10,106,3.82075471698113,0.598365548590026,74.15
"159838722.jpg",0,4,20,68,7,99,3.78787878787879,0.627153063254527,74.9033613445378
"160123908.jpg",1,7,54,40,2,104,3.33653846153846,0.677095122070445,63.3949579831933
"16057476.jpg",9,47,43,10,0,109,2.4954128440367,0.77726792667233,41.6363636363636
"16079437.jpg",2,23,59,23,0,107,2.96261682242991,0.712757515792089,53.0868644067797
"160981911.jpg",0,6,50,48,1,105,3.41904761904762,0.616768133420437,64.25
"160999577.jpg",12,65,22,3,0,102,2.15686274509804,0.656198141399797,30.5909090909091
"161483962.jpg",0,20,59,26,0,105,3.05714285714286,0.662579043594792,53.9375
"161551525.jpg",1,39,60,5,0,105,2.65714285714286,0.58554004376912,42.86875
"1626230781.jpg",42,57,4,0,0,103,1.63106796116505,0.559942070920715,15.2293577981651
"163208499.jpg",15,68,18,0,0,101,2.02970297029703,0.573680146851091,27.3181818181818
"1634910276.jpg",0,0,33,72,3,108,3.72222222222222,0.508494816289356,76.9
"163666873.jpg",1,36,49,12,0,98,2.73469387755102,0.681886715629378,44.8151260504202
"163977327.jpg",25,73,8,0,0,106,1.83962264150943,0.536954240363538,22.38125
"1646704912.jpg",0,5,76,20,0,101,3.14851485148515,0.477203072367758,59.7617924528302
"165074300.jpg",0,1,34,60,7,102,3.7156862745098,0.603249467802339,71.3676470588235
"16523804.jpg",5,48,45,9,0,107,2.54205607476635,0.717442704724082,42.1806722689076
"1654836945.jpg",1,25,67,12,0,105,2.85714285714286,0.611249845502127,48.4375
"1663721615.jpg",50,55,3,0,0,108,1.56481481481481,0.551516992869059,15.4201680672269
"166528976.jpg",0,6,56,43,1,106,3.36792452830189,0.60671593255922,62.25625
"1669800671.jpg",1,11,53,38,2,105,3.27619047619048,0.713809364973457,60.0878378378378
"1674951001.jpg",2,39,54,14,0,109,2.73394495412844,0.702405942495511,44.468487394958
"1679551869.jpg",0,1,50,53,0,104,3.5,0.521387245906701,67.1398305084746
"16799807.jpg",0,50,51,2,0,103,2.53398058252427,0.538981137226463,39.9030172413793
"1682888994.jpg",0,2,50,55,1,108,3.50925925925926,0.555269916184919,66.4934210526316
"1693839090.jpg",25,73,9,0,0,107,1.85046728971963,0.546062031132427,22.0669642857143
"169625095.jpg",0,40,58,5,0,103,2.66019417475728,0.569716098170618,43.9831932773109
"169779095.jpg",0,5,43,56,0,104,3.49038461538462,0.591118608959406,66.3125
"1708787959.jpg",0,14,65,29,1,109,3.15596330275229,0.64080840041954,58.9579831932773
"171857013.jpg",0,35,54,17,0,106,2.83018867924528,0.68273536828607,48.9875
"174715115.jpg",12,73,18,0,0,103,2.05825242718447,0.539157707628326,28.3151260504202
"1748861184.jpg",0,6,74,30,1,111,3.23423423423423,0.555222395326331,62.2457627118644
"175326787.jpg",5,58,36,2,0,101,2.34653465346535,0.6072173180066,35.2272727272727
"1755366250.jpg",46,59,0,0,0,105,1.56190476190476,0.498532645405292,14.7262931034483
"17606027.jpg",0,4,41,60,4,109,3.58715596330275,0.626734765423908,69.3863636363636
"176663631.jpg",2,9,33,52,5,101,3.48514851485149,0.807636816720717,66.1818181818182
"1777841357.jpg",1,13,71,17,1,103,3.03883495145631,0.609119101929209,55.7981651376147
"178403727.jpg",5,74,27,0,0,106,2.20754716981132,0.511151475677369,32.2125
"1792473649.jpg",0,0,33,75,3,111,3.72972972972973,0.503550050702662,73.8516949152542
"1794888173.jpg",4,24,68,12,0,108,2.81481481481481,0.67183871212187,49.5911016949153
"1795186582.jpg",7,59,41,2,0,109,2.34862385321101,0.629169746703143,35.3378378378378
"1796317547.jpg",0,2,18,77,7,104,3.85576923076923,0.547159819941693,81.6077981651376
"1797683075.jpg",8,63,32,4,0,107,2.29906542056075,0.661829272732638,34.8897058823529
"1798554647.jpg",0,27,71,10,0,108,2.84259259259259,0.566379500873785,49.4048672566372
"1799451312.jpg",0,7,68,34,1,110,3.26363636363636,0.585407765473404,62.0945945945946
"1802306299.jpg",2,46,55,3,0,106,2.55660377358491,0.586842863355548,40.2236842105263
"1805206682.jpg",9,76,20,2,0,107,2.14018691588785,0.573775942905748,30.787610619469
"1807195948.jpg",4,71,23,2,0,100,2.23,0.547814758929522,34
"1809848435.jpg",17,74,12,0,0,103,1.95145631067961,0.530974700787572,24.7278761061947
"1812202754.jpg",0,0,18,83,5,106,3.87735849056604,0.451512383180483,78.4661016949153
"181220864.jpg",10,73,20,1,0,104,2.11538461538462,0.562720374224038,28.98125
"1814122396.jpg",0,7,67,37,0,111,3.27027027027027,0.571217932395269,60.5128205128205
"1820291567.jpg",14,84,9,1,0,108,1.97222222222222,0.501555213709073,26.9978991596639
"18238731.jpg",24,75,5,0,0,104,1.81730769230769,0.497848245231476,21.1666666666667
"183156510.jpg",1,25,61,15,0,102,2.88235294117647,0.649357910540376,48.8361344537815
"18438855.jpg",0,1,33,62,11,107,3.77570093457944,0.634070575426553,74.6207627118644
"185458280.jpg",57,37,4,0,0,98,1.45918367346939,0.577380636067711,11.1911764705882
"186520031.jpg",1,11,44,40,2,98,3.31632653061224,0.740533922394312,60.8298319327731
"187485230.jpg",1,38,47,13,0,99,2.72727272727273,0.69719820942699,45.7163865546218
"187499391.jpg",1,32,62,8,0,103,2.74757281553398,0.605828659559744,46.8256302521008
"187640892.jpg",8,48,39,5,0,100,2.41,0.71201804539611,37.8181818181818
"1896792999.jpg",0,4,52,50,0,106,3.43396226415094,0.569358334309913,67.7783018867924
"189899579.jpg",0,35,56,9,0,100,2.74,0.613320157961253,45.825
"1929087646.jpg",0,34,70,2,0,106,2.69811320754717,0.500852821661969,45.6470588235294
"19300996.jpg",20,73,11,0,0,104,1.91346153846154,0.54167265081622,23.4935897435897
"194278089.jpg",0,12,54,38,2,106,3.28301886792453,0.68667198769735,61.5
"194369363.jpg",7,79,18,1,0,105,2.12380952380952,0.513195833352107,29.4625
"1946326263.jpg",0,9,39,56,1,105,3.46666666666667,0.666025332543548,67.0736607142857
"1947195937.jpg",0,46,48,5,0,99,2.58585858585859,0.589190053016418,41.0818584070796
"19502065.jpg",85,17,0,0,0,102,1.16666666666667,0.374518392609282,5.08974358974359
"1966235400.jpg",0,1,51,53,0,105,3.4952380952381,0.521163814564789,68.7094594594595
"196734006.jpg",0,1,27,73,2,103,3.7378640776699,0.504123487994673,72.4768907563025
"1970440733.jpg",0,17,100,17,0,134,3,0.505607651983592,55.875
"197324620.jpg",1,6,49,44,2,102,3.3921568627451,0.67716448336183,62.563025210084
"1979184408.jpg",0,19,71,13,0,103,2.94174757281553,0.557044770940619,53.5200892857143
"198187235.jpg",0,15,46,37,1,99,3.24242424242424,0.715583237088619,60.1365546218487
"1987196687.jpg",18,86,5,0,0,109,1.88073394495413,0.445653299936709,23.6008403361345
"1988371580.jpg",0,5,42,50,8,105,3.58095238095238,0.704121825955953,68.4935344827586
"1990074154.jpg",0,0,12,78,17,107,4.04672897196262,0.520942135817106,82.4868421052632
"1990510796.jpg",0,5,91,37,0,133,3.2406015037594,0.509758943920372,64.4179389312977
"1992159390.jpg",0,0,46,57,2,105,3.58095238095238,0.533150151691889,72.4756637168142
"1993125888.jpg",0,24,60,18,0,102,2.94117647058824,0.642142598699578,53.5735294117647
"19943010.jpg",0,2,20,70,15,107,3.91588785046729,0.631283438525562,77.2605042016807
"1995190133.jpg",0,0,16,77,9,102,3.93137254901961,0.492715328040957,77.3692660550459
"20079130.jpg",1,37,56,8,0,102,2.69607843137255,0.625991738886346,44.7179487179487
"200825729.jpg",0,2,48,55,1,106,3.5188679245283,0.556025557402873,67.06875
"2017266.jpg",1,10,52,44,1,108,3.31481481481481,0.692390524403059,62.5953389830508
"2020522728.jpg",0,6,57,43,0,106,3.34905660377358,0.586230132451472,65.7747524752475
"202351926.jpg",0,2,27,68,7,104,3.76923076923077,0.594975225571673,74.6953781512605
"202551289.jpg",5,59,35,3,0,102,2.35294117647059,0.623739264254592,34.3466386554622
"2034844231.jpg",0,5,80,22,0,107,3.1588785046729,0.478786451595808,61.0630841121495
"2035975268.jpg",51,46,6,1,0,104,1.58653846153846,0.647783029165847,15.1428571428571
"203950866.jpg",0,2,30,59,7,98,3.72448979591837,0.622277364566239,72.7542016806723
"2041755502.jpg",0,0,36,68,1,105,3.66666666666667,0.493548116792825,74.1064356435644
"2044507520.jpg",0,0,17,70,22,109,4.04587155963303,0.599155595646713,80.26875
"2047083409.jpg",2,32,61,11,0,106,2.76415094339623,0.655408077786407,47.5364077669903
"20522527.jpg",0,9,45,47,3,104,3.42307692307692,0.692432152118551,64.6730769230769
"2053452455.jpg",0,5,71,32,1,109,3.26605504587156,0.555147658616896,62.0647321428571
"2054743275.jpg",0,14,78,15,0,107,3.00934579439252,0.522969155676269,54.625
"2055589084.jpg",1,52,49,2,0,104,2.5,0.557386411433294,38.4806034482759
"205662428.jpg",3,56,39,1,0,99,2.38383838383838,0.566173527648199,36.6344537815126
"2058985902.jpg",4,48,47,4,0,103,2.49514563106796,0.639757711609683,40.4247787610619
"2059981058.jpg",1,13,67,27,0,108,3.11111111111111,0.631469630371087,58.75
"2060529660.jpg",4,41,64,2,0,111,2.57657657657658,0.596193219892977,43.2456896551724
"206294085.jpg",13,81,12,0,0,106,1.99056603773585,0.487857961742534,26.9875
"2063421762.jpg",10,55,37,2,0,104,2.29807692307692,0.666534403110782,34.8102678571429
"2063914625.jpg",0,37,64,3,0,104,2.67307692307692,0.529559400892795,44.3125
"2064478851.jpg",1,46,53,2,0,102,2.54901960784314,0.556286324530138,42.5420353982301
"2064690658.jpg",2,51,55,1,0,109,2.5045871559633,0.554841539123746,40.7898230088496
"2065542928.jpg",0,10,55,33,4,102,3.30392156862745,0.700625119549713,60.6651785714286
"2065722620.jpg",0,2,40,59,2,103,3.59223300970874,0.567707692043677,67.9662162162162
"2068650026.jpg",0,3,60,40,0,103,3.35922330097087,0.539687072220866,65.1928571428571
"2070418201.jpg",1,34,89,1,0,125,2.72,0.485266803900434,46.8109756097561
"2072843602.jpg",1,7,82,44,2,136,3.28676470588235,0.619534929936775,63.9946428571429
"2074092022.jpg",0,1,55,47,0,103,3.44660194174757,0.518825130912893,68.2866972477064
"2082936451.jpg",0,3,54,46,4,107,3.47663551401869,0.619582854077224,68.8815789473684
"2084725313.jpg",0,1,62,43,1,107,3.41121495327103,0.531165877300352,65.8950892857143
"2088433684.jpg",2,75,27,0,0,104,2.24038461538462,0.472448534366542,33.8526785714286
"208949930.jpg",0,1,30,69,4,104,3.73076923076923,0.543822665820023,72.6848739495798
"2093280771.jpg",3,45,53,3,0,104,2.53846153846154,0.606166962854181,41.9415887850467
"2093652366.jpg",2,39,56,7,0,104,2.65384615384615,0.635048056727989,45.2291666666667
"2094668596.jpg",0,17,69,24,0,110,3.06363636363636,0.609967253253567,55.8834745762712
"2096424103.jpg",0,18,72,13,1,104,2.97115384615385,0.582207562647962,54.8851351351351
"2097618827.jpg",4,65,38,3,0,110,2.36363636363636,0.60163801984452,35.8581081081081
"2098594651.jpg",28,72,6,0,0,106,1.79245283018868,0.529455805648376,21.4776785714286
"2099199686.jpg",0,1,59,45,1,106,3.43396226415094,0.534858555837821,67
"2100483102.jpg",2,17,55,30,0,104,3.08653846153846,0.725547358468167,55.7689075630252
"2102208013.jpg",0,1,14,83,7,105,3.91428571428571,0.482666585716303,81.0176991150443
"2111309017.jpg",0,5,33,63,0,101,3.57425742574257,0.5890082283545,71.425
"2113239475.jpg",1,12,71,23,2,109,3.11926605504587,0.648713408190937,58.5328947368421
"2113638482.jpg",1,20,69,13,0,103,2.9126213592233,0.595848317922173,50.2790178571429
"2114240861.jpg",0,18,71,12,0,101,2.94059405940594,0.544459037544935,52.046875
"2114797362.jpg",0,12,67,21,0,100,3.09,0.570220584643798,56.9428571428571
"211562425.jpg",8,55,34,2,0,99,2.3030303030303,0.646095738380922,35.2478991596639
"2115915075.jpg",0,12,74,19,0,105,3.06666666666667,0.541839223007843,55.8086956521739
"211603206.jpg",0,5,43,49,2,99,3.48484848484848,0.628630457676932,65.4747899159664
"2124048872.jpg",2,29,55,14,0,100,2.81,0.691872003109584,49.7826086956522
"2125272449.jpg",2,32,67,5,0,106,2.70754716981132,0.585002745326492,47.0379464285714
"2125535764.jpg",0,18,71,19,0,108,3.00925925925926,0.587969265684951,55.7224770642202
"2125600207.jpg",0,1,39,59,2,101,3.61386138613861,0.547179989212014,70.4189189189189
"2126677316.jpg",19,106,30,0,0,155,2.07096774193548,0.559564735984904,29.3990384615385
"2126890271.jpg",6,41,67,12,0,126,2.67460317460317,0.713631446385206,44.8658536585366
"2127908996.jpg",3,73,34,2,0,112,2.3125,0.553957912994633,36.0448717948718
"2128879923.jpg",2,81,20,1,0,104,2.19230769230769,0.463773527692987,31.2008928571429
"2129246782.jpg",0,4,58,40,1,103,3.36893203883495,0.577185382632161,64.7429245283019
"2129680216.jpg",0,2,12,78,8,100,3.92,0.525702992538217,79.5642201834862
"2131254561.jpg",0,54,47,3,0,104,2.50961538461538,0.557302663192804,39.2369565217391
"2133766199.jpg",1,30,74,6,0,111,2.76576576576577,0.555222395326331,46.4090909090909
"213439801.jpg",30,55,12,1,0,98,1.83673469387755,0.668802246071988,20.6197478991597
"2138715193.jpg",0,20,70,17,0,107,2.97196261682243,0.590138198161191,53.425
"2138874780.jpg",0,2,46,45,2,95,3.49473684210526,0.581152270860307,70.4779411764706
"213906996.jpg",0,0,7,66,33,106,4.24528301886792,0.565875987671487,86.6625
"214064484.jpg",2,20,53,23,1,99,3.01010101010101,0.749080381710985,53.73125
"2140758242.jpg",0,2,57,48,0,107,3.42990654205607,0.533980240124661,69.0817757009346
"2140864586.jpg",0,5,58,41,1,105,3.36190476190476,0.590368358344854,62.5521739130435
"2142428164.jpg",0,1,35,67,5,108,3.7037037037037,0.567981493368036,74.0088495575221
"2144290999.jpg",38,61,7,0,0,106,1.70754716981132,0.585002745326492,17.3565217391304
"2144963177.jpg",0,5,72,29,0,106,3.22641509433962,0.521591317264946,60.296875
"2145860500.jpg",0,6,60,37,1,104,3.31730769230769,0.595524131992075,62.7276785714286
"2147067327.jpg",0,1,53,50,0,104,3.47115384615385,0.520580907214179,67.1486486486486
"2147811000.jpg",2,37,59,9,0,107,2.70093457943925,0.647417996133495,45.2894736842105
"2148143527.jpg",0,9,95,22,0,126,3.1031746031746,0.487103522128347,58.0181451612903
"2149719899.jpg",2,50,44,3,0,99,2.48484848484848,0.595281383707316,38.1621621621622
"2149726014.jpg",22,65,20,0,0,107,1.98130841121495,0.629184983615971,25.4527027027027
"2150291485.jpg",0,21,62,16,0,99,2.94949494949495,0.612351395946061,50.8650442477876
"2152767186.jpg",0,3,41,52,5,101,3.58415841584158,0.63666830818996,73.4334862385321
"2154184161.jpg",0,19,71,17,0,107,2.98130841121495,0.582468857556285,53.6890756302521
"215794898.jpg",1,18,66,19,0,104,2.99038461538462,0.630844591938848,52.7878151260504
"2159705303.jpg",3,48,46,7,0,104,2.54807692307692,0.666534403110782,43.3549107142857
"2161809899.jpg",0,9,79,17,1,106,3.09433962264151,0.526050909844691,57.7924107142857
"2164495332.jpg",2,50,51,3,0,106,2.5188679245283,0.589287415935903,39.9929245283019
"2166503846.jpg",0,23,70,9,1,103,2.88349514563107,0.582438600210717,49.3851351351351
"2167658722.jpg",0,23,93,18,0,134,2.96268656716418,0.553956601241292,54.3260869565217
"2168323029.jpg",0,21,62,18,0,101,2.97029702970297,0.62378594957813,53.05
"2169516596.jpg",0,8,68,33,0,109,3.22935779816514,0.571434639062975,60.9054054054054
"2170460897.jpg",1,30,71,5,0,107,2.74766355140187,0.551044598816994,47.141592920354
"2172409998.jpg",1,16,70,17,0,104,2.99038461538462,0.599274517831503,56
"2174764653.jpg",0,0,34,67,4,105,3.71428571428571,0.531946456861058,72.954347826087
"2178785463.jpg",0,14,66,24,0,104,3.09615384615385,0.599663834131796,58.259900990099
"2181528959.jpg",0,1,36,64,3,104,3.66346153846154,0.550561530172921,71.1949152542373
"2182811741.jpg",0,3,48,44,1,96,3.44791666666667,0.578014599463528,68.6176470588235
"2183577836.jpg",3,57,68,2,0,130,2.53076923076923,0.573152056321942,42.6976744186046
"218453569.jpg",1,12,46,40,3,102,3.31372549019608,0.757541518084022,61.6617647058824
"218457399.jpg",4,48,38,12,2,104,2.61538461538462,0.816191633547929,43.075
"21852937.jpg",1,43,55,10,0,109,2.67889908256881,0.650935707483411,45.8636363636364
"2189906236.jpg",0,11,70,22,1,104,3.125,0.586043174127766,57.1294642857143
"2189933975.jpg",2,39,57,9,1,108,2.7037037037037,0.687121304493579,46.1578947368421
"2190310.jpg",0,12,58,29,3,102,3.22549019607843,0.68804303838874,58.3269230769231
"2191202126.jpg",0,45,60,4,0,109,2.62385321100917,0.557590564404333,44.4173728813559
"2191549592.jpg",0,31,86,8,0,125,2.816,0.529515907951965,50.7682926829268
"2191619969.jpg",0,8,74,21,0,103,3.12621359223301,0.517907018123218,59.575
"2191898704.jpg",0,5,63,34,2,104,3.31730769230769,0.595524131992075,63.6282608695652
"2194214783.jpg",1,0,23,73,7,104,3.81730769230769,0.587316144781357,75.1113445378151
"2195703133.jpg",0,16,79,13,0,108,2.97222222222222,0.519855000152735,52.3982300884956
"2196513263.jpg",57,48,2,0,0,107,1.48598130841122,0.538419875108153,13.375
"2197565905.jpg",0,3,43,60,4,110,3.59090909090909,0.610240658580274,67.4852941176471
"2197636094.jpg",0,3,44,51,3,101,3.53465346534653,0.609333347776791,72.2864077669903
"2198895718.jpg",3,32,55,9,1,100,2.73,0.708605117199426,44.9766949152542
"2199106763.jpg",0,34,55,20,0,109,2.87155963302752,0.695234005785005,50.775
"2199234449.jpg",0,36,62,6,0,104,2.71153846153846,0.568989513495208,45.2894736842105
"2199696686.jpg",0,1,28,78,4,111,3.76576576576577,0.52144824470725,75.5995762711864
"2201178081.jpg",1,12,69,16,0,98,3.02040816326531,0.574000104830169,55.1357142857143
"220183616.jpg",1,42,52,4,0,99,2.5959595959596,0.587613504783473,41.5567226890756
"2202105982.jpg",2,61,43,1,0,107,2.4018691588785,0.547029940957534,37.2410714285714
"2203797715.jpg",0,0,36,70,2,108,3.68518518518519,0.505079768811405,76.3096330275229
"2204368170.jpg",1,39,62,4,0,106,2.65094339622642,0.569752708766225,44.2775423728814
"220503608.jpg",15,67,19,1,0,102,2.05882352941176,0.610526949993698,27.0672268907563
"2208434983.jpg",10,77,21,0,0,108,2.10185185185185,0.52844003921284,29.9096638655462
"2211658928.jpg",0,1,55,72,2,130,3.57692307692308,0.540820287326814,72.7873134328358
"2212296403.jpg",0,7,63,40,1,111,3.31531531531532,0.602750996107649,63.90625
"2214729676.jpg",15,76,11,0,0,102,1.96078431372549,0.505838557336368,25.975
"2215032826.jpg",0,2,31,71,1,105,3.67619047619048,0.527972138237027,71.95
"2215695798.jpg",0,12,52,37,3,104,3.29807692307692,0.70888682997691,63.0172413793103
"2217543976.jpg",0,1,31,73,1,106,3.69811320754717,0.500852821661969,76.1339285714286
"2220192526.jpg",0,2,38,56,2,98,3.59183673469388,0.571428571428571,70.3302752293578
"2221745311.jpg",3,55,43,1,0,102,2.41176470588235,0.569052385423217,39.1106194690265
"2223002938.jpg",0,5,59,36,1,101,3.32673267326733,0.584960013865719,63.2569444444444
"2223255997.jpg",1,38,55,6,0,100,2.66,0.606696635956396,46.825
"222335349.jpg",0,6,45,45,2,98,3.43877551020408,0.643225225992288,64.9894957983193
"2224984425.jpg",0,2,56,49,0,107,3.4392523364486,0.535134793343113,67.445945945946
"2225421381.jpg",0,0,23,77,6,106,3.83962264150943,0.500224567718486,77.3298319327731
"2225683996.jpg",0,1,38,64,6,109,3.68807339449541,0.588426144810633,73.5168067226891
"2227011292.jpg",0,1,40,55,5,101,3.63366336633663,0.595361609061715,70.6580188679245
"2231043641.jpg",0,5,75,22,0,102,3.16666666666667,0.489156342484424,57.625
"2231397523.jpg",0,1,54,57,0,112,3.5,0.519875244910036,65.531779661017
"223186789.jpg",0,15,61,28,1,105,3.14285714285714,0.656748567808626,57.1
"223191871.jpg",7,43,45,8,0,103,2.52427184466019,0.738900351398985,40.7247899159664
"2232895391.jpg",0,39,61,6,0,106,2.68867924528302,0.575089352016914,46.9642857142857
"2233947320.jpg",0,31,67,4,0,102,2.73529411764706,0.525139690764791,45.9330357142857
"2234060892.jpg",16,70,22,0,0,108,2.05555555555556,0.593316881706884,27.7763157894737
"2234064642.jpg",0,39,60,7,0,106,2.69811320754717,0.588295541547658,44.125
"2235352888.jpg",0,1,32,65,2,100,3.68,0.529531906880067,70.5774336283186
"2236041996.jpg",5,59,35,0,0,99,2.3030303030303,0.561603852219212,34.2894736842105
"2236324282.jpg",0,2,42,57,3,104,3.58653846153846,0.584767432371758,72.5
"2237630871.jpg",0,2,19,69,4,94,3.79787234042553,0.540405805983522,78.55
"2239201463.jpg",0,0,48,54,2,104,3.55769230769231,0.536564459286468,68.2866972477064
"2239403255.jpg",0,1,31,63,8,103,3.75728155339806,0.601729849772609,77.4711538461538
"2239600333.jpg",0,11,61,29,0,101,3.17821782178218,0.606564746815382,58.525
"2239987680.jpg",8,77,20,0,0,105,2.11428571428571,0.506007861642441,29.9121621621622
"224076897.jpg",0,12,45,46,0,103,3.33009708737864,0.677196491810793,62.2857142857143
"2243689404.jpg",0,7,59,43,2,111,3.36036036036036,0.629470091610869,64.18125
"2243706700.jpg",1,17,65,22,0,105,3.02857142857143,0.642368556700406,53.3986486486486
"2249130247.jpg",0,0,33,70,3,106,3.71698113207547,0.5118540897213,75.9708737864078
"2250728053.jpg",0,0,17,81,4,102,3.87254901960784,0.437625651035875,76.6123853211009
"2251792086.jpg",0,17,88,29,0,134,3.08955223880597,0.581192532994432,58.3938848920863
"22533278.jpg",0,29,61,13,1,104,2.86538461538462,0.654449925512819,50.5
"2255689742.jpg",0,8,72,22,0,102,3.13725490196078,0.527261103264158,58.75
"2255948084.jpg",0,1,23,74,4,102,3.79411764705882,0.513929441821196,74.8644859813084
"2256741921.jpg",4,33,58,11,0,106,2.71698113207547,0.700404195972475,45.8175675675676
"2259747766.jpg",0,17,82,8,0,107,2.91588785046729,0.478233686603045,51.5951327433628
"2260527943.jpg",2,12,62,28,0,104,3.11538461538462,0.672738098864579,58.447247706422
"2261421219.jpg",0,2,24,67,8,101,3.8019801980198,0.600329942285041,75.25
"2263434837.jpg",0,0,25,74,9,108,3.85185185185185,0.543694781315936,77.5258620689655
"226477214.jpg",1,51,42,5,0,99,2.51515151515152,0.612183051916503,38.5756302521008
"2264946914.jpg",6,48,50,5,0,109,2.4954128440367,0.675275707904079,39.1737288135593
"2266672191.jpg",0,10,76,21,0,107,3.10280373831776,0.530833794818814,57.30625
"2268779821.jpg",2,37,55,8,0,102,2.67647058823529,0.64733673282229,46.5642201834862
"2269141846.jpg",1,15,68,16,0,100,2.99,0.594503442743895,54.8899082568807
"2275633566.jpg",2,52,50,2,0,106,2.49056603773585,0.573133127040978,39.3200934579439
"2276757352.jpg",0,5,80,19,1,105,3.15238095238095,0.495769649925795,57.0405405405405
"2276823208.jpg",0,2,48,55,0,105,3.5047619047619,0.539298146522395,69.2297297297297
"2279663213.jpg",0,3,62,37,0,102,3.33333333333333,0.532755462513791,62.0654205607477
"2280116666.jpg",7,61,30,3,0,101,2.28712871287129,0.637755966861406,34.0711206896552
"2280432289.jpg",0,51,48,5,0,104,2.55769230769231,0.588348405414552,43.4836448598131
"2280531345.jpg",15,61,33,2,0,111,2.1981981981982,0.685165140277342,32.7909482758621
"2280668053.jpg",1,34,63,9,0,107,2.74766355140187,0.615728712988593,48.0907079646018
"22848476.jpg",0,12,70,25,2,109,3.15596330275229,0.62619237262181,58.0681818181818
"2285382083.jpg",0,2,64,40,0,106,3.35849056603774,0.519865902952877,64.1272321428571
"2285789022.jpg",0,24,71,8,0,103,2.84466019417476,0.53792049768654,51.6
"228617373.jpg",8,59,31,4,0,102,2.30392156862745,0.671767517633898,34.2773109243698
"2286627596.jpg",0,60,48,1,0,109,2.45871559633028,0.518761168407095,37.5656779661017
"2286659351.jpg",0,6,60,44,1,111,3.36036036036036,0.599890789951771,62.53125
"2287163032.jpg",2,8,59,30,1,100,3.2,0.681649810860727,60.475
"2292384520.jpg",0,4,56,42,0,102,3.37254901960784,0.561496737908777,66.9236111111111
"2292770854.jpg",0,10,75,19,0,104,3.08653846153846,0.523442246015848,57.4142857142857
"2293775114.jpg",3,40,58,9,0,110,2.66363636363636,0.667423812471915,43.6483050847458
"229400288.jpg",1,35,61,9,0,106,2.73584905660377,0.62185416744646,46.375
"22947511.jpg",52,49,3,0,0,104,1.52884615384615,0.556632223656022,13.974358974359
"2295329994.jpg",9,78,17,0,0,104,2.07692307692308,0.496439902253701,27.6869565217391
"2295909322.jpg",0,1,42,57,1,101,3.57425742574257,0.535659120214812,69.75
"2297923850.jpg",0,17,75,14,0,106,2.97169811320755,0.542613554844668,52.9181034482759
"2298149104.jpg",1,6,51,44,0,102,3.35294117647059,0.639415866217659,63.0306603773585
"2298165172.jpg",0,2,63,34,1,100,3.34,0.535978289926679,66.1357142857143
"2298963655.jpg",0,3,42,62,0,107,3.55140186915888,0.553439414962658,72.5514018691589
"2300197705.jpg",2,11,54,36,1,104,3.22115384615385,0.723485774166954,59.4736842105263
"2301461383.jpg",0,12,66,23,0,101,3.10891089108911,0.581394704121218,57.25
"2303343292.jpg",0,5,92,29,0,126,3.19047619047619,0.485209822065229,60.8963414634146
"2304159288.jpg",2,23,90,25,0,140,2.98571428571429,0.634564534145968,54.8741610738255
"2304572915.jpg",4,58,41,2,0,105,2.39047619047619,0.596387169276516,37.6238317757009
"2305236722.jpg",16,71,17,0,0,104,2.00961538461538,0.56594610720975,25.4605263157895
"2306462251.jpg",6,64,35,3,0,108,2.32407407407407,0.623956380330556,35.0405405405405
"2308986836.jpg",0,3,53,43,0,99,3.4040404040404,0.551790997093378,64.6869158878505
"2310631117.jpg",5,65,29,1,0,100,2.26,0.561743318211757,34.1542056074766
"231161527.jpg",0,13,69,17,0,99,3.04040404040404,0.551790997093378,52.8375
"2311702728.jpg",5,44,51,3,0,103,2.50485436893204,0.639757711609683,41.5133928571429
"2311738871.jpg",4,30,64,6,0,104,2.69230769230769,0.639734821836635,44.739224137931
"2313971368.jpg",0,0,43,58,3,104,3.61538461538462,0.545194225793602,69.8910256410256
"2314346258.jpg",0,14,73,18,0,105,3.03809523809524,0.553377905438143,54.2754237288136
"2314745999.jpg",0,6,47,51,1,105,3.44761904761905,0.619878281801423,66.4310344827586
"2317296071.jpg",4,60,39,1,0,104,2.35576923076923,0.57315799056705,37.5467289719626
"2318824279.jpg",0,7,72,30,1,110,3.22727272727273,0.569227561420358,60.9173728813559
"2319588792.jpg",0,4,49,51,1,105,3.46666666666667,0.589436932534684,69.5631067961165
"2322053874.jpg",0,0,10,82,18,110,4.07272727272727,0.501540579076493,80.0336134453782
"2322154086.jpg",0,13,77,11,0,101,2.98019801980198,0.489493575438983,54.9785714285714
"2322493147.jpg",0,5,35,60,1,101,3.56435643564356,0.606891120122191,68.0951327433628
"232327907.jpg",1,17,52,32,1,103,3.14563106796116,0.733080620319528,57.0861344537815
"2323279407.jpg",0,38,68,4,0,110,2.69090909090909,0.53750109102436,45.0924369747899
"2323828778.jpg",2,60,68,2,0,132,2.53030303030303,0.558615982467929,42.1875
"2324511288.jpg",4,54,40,4,0,102,2.43137254901961,0.637287008435109,37.1393805309735
"2325353113.jpg",52,49,6,0,0,107,1.57009345794393,0.600505283038207,14.5882352941176
"2329115753.jpg",2,10,81,8,0,101,2.94059405940594,0.50639475072749,51.7
"2329258631.jpg",7,67,29,0,0,103,2.21359223300971,0.553960525189741,32.6768867924528
"2329975863.jpg",1,14,76,19,1,111,3.04504504504505,0.608834764677388,57.4102564102564
"233025659.jpg",0,4,49,49,3,105,3.48571428571429,0.621943073611393,66.3125
"233045606.jpg",0,5,52,48,1,106,3.42452830188679,0.600763216291175,65.2125
"233045618.jpg",0,47,47,4,0,98,2.56122448979592,0.575555787520815,40.8634453781513
"2331420998.jpg",2,29,65,9,0,105,2.77142857142857,0.624147770612408,47.4869565217391
"2332998569.jpg",53,45,2,0,0,100,1.49,0.541136103793013,12.5347222222222
"2333476039.jpg",27,70,8,0,0,105,1.81904761904762,0.550890055709716,20.9137931034483
"2337030121.jpg",0,1,33,68,1,103,3.66990291262136,0.512363793752346,74.2837837837838
"23371433.jpg",3,44,45,11,1,104,2.64423076923077,0.749346242326418,43.5192307692308
"2338832331.jpg",0,26,46,33,1,106,3.08490566037736,0.769884648481612,55.5338983050847
"2339673410.jpg",5,78,21,0,0,104,2.15384615384615,0.478046810260875,29.7941176470588
"2339723901.jpg",0,2,54,48,0,104,3.44230769230769,0.536564459286468,65.5135135135135
"2341720836.jpg",0,6,82,40,1,129,3.27906976744186,0.55869188995991,62.6476377952756
"2342012928.jpg",0,0,36,68,3,107,3.69158878504673,0.521449629494023,72.0825892857143
"2344211137.jpg",0,0,46,55,3,104,3.58653846153846,0.550561530172921,68.6351351351351
"2345921877.jpg",0,25,116,12,0,153,2.91503267973856,0.485956902170464,53.0882352941176
"2347131131.jpg",0,10,63,36,0,109,3.23853211009174,0.607043267858221,61.7310924369748
"234944177.jpg",0,3,28,67,7,105,3.74285714285714,0.620616496046339,72.56875
"2349676135.jpg",9,59,32,7,1,108,2.37037037037037,0.768450225710328,37.025
"2350031609.jpg",2,52,44,3,0,101,2.47524752475248,0.593195741824578,40
"2355192446.jpg",1,5,52,48,1,107,3.4018691588785,0.642222160528438,64.6428571428571
"2355891811.jpg",5,60,36,1,0,102,2.32352941176471,0.582955336941826,34.9082568807339
"2360058082.jpg",12,86,6,0,0,104,1.94230769230769,0.414000681884038,24.2817796610169
"2361724609.jpg",3,54,42,11,0,110,2.55454545454545,0.711457524973582,40.66875
"2362202039.jpg",0,1,33,78,3,115,3.72173913043478,0.522272801051841,75.6730769230769
"2362957665.jpg",0,1,37,63,2,103,3.64077669902913,0.539687072220866,74.1041666666667
"2363413290.jpg",1,26,65,9,0,101,2.81188118811881,0.595195283703235,47.75
"2363717244.jpg",0,2,23,71,8,104,3.81730769230769,0.587316144781357,75.5296610169491
"2364482871.jpg",0,9,76,21,0,106,3.11320754716981,0.522279886960478,59.5668316831683
"2364901003.jpg",2,51,76,2,0,131,2.59541984732824,0.55162174824921,43.5845588235294
"2365109175.jpg",0,20,78,5,0,103,2.85436893203884,0.472950003374549,51.8871681415929
"2365855574.jpg",0,5,64,39,1,109,3.3302752293578,0.578232393873932,62.3918918918919
"2366273919.jpg",12,63,28,1,0,104,2.17307692307692,0.630030168676761,29.5066964285714
"2366307779.jpg",0,7,68,29,3,107,3.26168224299065,0.619440535744331,63.7146017699115
"2367261033.jpg",38,58,12,0,0,108,1.75925925925926,0.639368414562084,18.3175675675676
"2367765365.jpg",2,43,50,12,0,107,2.67289719626168,0.697376497953383,44.3486842105263
"2371655336.jpg",2,53,42,7,0,104,2.51923076923077,0.653307778175528,40.553738317757
"2371669291.jpg",0,2,56,47,2,107,3.45794392523365,0.571003318097878,66.8601694915254
"2372696116.jpg",0,5,69,29,0,103,3.23300970873786,0.527738116410649,62.0353982300885
"2375572237.jpg",0,4,74,52,0,130,3.36923076923077,0.544720418131757,67.1299212598425
"2376113642.jpg",4,71,30,0,0,105,2.24761904761905,0.514799295860353,31.6959459459459
"2376602512.jpg",2,17,77,12,0,108,2.91666666666667,0.582052443280648,50.7920353982301
"2378761573.jpg",0,9,54,43,0,106,3.32075471698113,0.6255994429927,64.549504950495
"2380962902.jpg",0,1,40,58,0,99,3.57575757575758,0.516876590704738,72.1180555555556
"2381196755.jpg",19,67,14,1,0,101,1.97029702970297,0.607543340751167,23.5401785714286
"2383953966.jpg",0,6,57,45,0,108,3.36111111111111,0.587380265521398,65.5526315789474
"2389241544.jpg",0,23,65,14,0,102,2.91176470588235,0.598727051921314,51.1
"239029957.jpg",0,3,29,61,10,103,3.75728155339806,0.663709412812857,74.2794117647059
"2393187912.jpg",7,64,33,3,0,107,2.29906542056075,0.632678541748658,36.4823008849558
"240236110.jpg",0,2,30,62,8,102,3.74509803921569,0.624361448214029,72.8235294117647
"2403326474.jpg",0,20,77,13,0,110,2.93636363636364,0.546503023439813,51.11875
"2405333928.jpg",1,22,74,12,0,109,2.88990825688073,0.582768767136427,51.0593220338983
"2405495711.jpg",2,39,55,9,0,105,2.67619047619048,0.657723903017621,45.5045871559633
"240689125.jpg",2,15,55,33,1,106,3.15094339622642,0.740559027327312,58.40625
"2407446104.jpg",0,7,55,46,0,108,3.36111111111111,0.60308139177812,63.425
"2409675838.jpg",0,72,39,2,0,113,2.38053097345133,0.523016389916574,37.1890756302521
"2410920428.jpg",0,0,14,84,10,108,3.96296296296296,0.472138224769331,80.843220338983
"2410933503.jpg",0,0,31,72,6,109,3.77064220183486,0.538052515730571,73.66875
"2413968824.jpg",22,53,24,1,0,100,2.04,0.709531072916714,27.7361111111111
"2415334988.jpg",3,50,48,2,0,103,2.47572815533981,0.591519482286928,38.4094827586207
"2415583702.jpg",21,56,25,4,0,106,2.11320754716981,0.759959331204871,29.3156779661017
"2415943373.jpg",0,1,41,57,2,101,3.59405940594059,0.550966747123312,70.9285714285714
"2416231204.jpg",0,12,70,23,1,106,3.12264150943396,0.596862115187647,57.5921052631579
"2417107784.jpg",0,5,62,34,1,102,3.30392156862745,0.576593198502975,61.5257009345794
"2418067534.jpg",7,78,28,0,0,113,2.1858407079646,0.526929660634735,32.1281512605042
"2421141390.jpg",7,59,33,2,0,101,2.2970297029703,0.625212835048123,34.3716216216216
"2421862008.jpg",0,0,17,93,3,113,3.87610619469027,0.403837470905947,75.7435897435897
"2422029745.jpg",8,82,10,1,0,101,2.03960396039604,0.467349806444978,27.0486111111111
"2422172125.jpg",5,64,33,5,0,107,2.35514018691589,0.647962502534314,34.6875
"242395156.jpg",56,40,5,0,0,101,1.4950495049505,0.593696258641363,13.4090909090909
"242503451.jpg",38,55,7,1,0,101,1.71287128712871,0.637755966861406,17.9772727272727
"2425646672.jpg",0,19,75,16,0,110,2.97272727272727,0.56599495749514,53.7860169491525
"2426998006.jpg",0,9,75,22,0,106,3.12264150943396,0.529201198369576,57.5304347826087
"2428050358.jpg",1,14,100,24,0,139,3.05755395683453,0.548645026243004,57.4413793103448
"2429849599.jpg",0,8,59,33,2,102,3.2843137254902,0.635227424470831,63.5428571428571
"2431828879.jpg",1,18,64,23,1,107,3.04672897196262,0.678277195660231,54.4516806722689
"2433641656.jpg",0,16,76,16,2,110,3.03636363636364,0.604680106910321,55.2455752212389
"2434624532.jpg",11,97,29,0,0,137,2.13138686131387,0.526049626491634,28.9230769230769
"2437860365.jpg",0,1,34,66,0,101,3.64356435643564,0.501680344758325,71.725
"2444482022.jpg",1,47,55,3,0,106,2.56603773584906,0.569358334309913,42.4902912621359
"244484608.jpg",40,54,5,0,0,99,1.64646464646465,0.576993108456905,16.0441176470588
"2444937456.jpg",0,1,51,60,1,113,3.53982300884956,0.535113443080872,67.7173913043478
"2447131470.jpg",0,24,67,11,0,102,2.87254901960784,0.574569466497057,50.2
"2447797924.jpg",0,47,51,1,0,99,2.53535353535354,0.521245198933135,41.65
"2448776548.jpg",2,9,70,28,1,110,3.15454545454545,0.652255981105123,56.75625
"2451920772.jpg",0,4,50,50,3,107,3.48598130841122,0.619867392716369,65.8214285714286
"2455942045.jpg",0,7,80,18,1,106,3.12264150943396,0.510887746288924,57.7837837837838
"2459843879.jpg",2,6,46,50,1,105,3.4,0.701646415445623,63.7
"2459857216.jpg",0,0,46,92,1,139,3.67625899280576,0.484780352745111,75.25
"2460847286.jpg",7,56,41,3,1,108,2.39814814814815,0.696316272737311,36.3349056603774
"2461703201.jpg",0,5,48,50,0,103,3.43689320388349,0.588615905800381,68.5894495412844
"246188030.jpg",71,31,3,0,0,105,1.35238095238095,0.536745040121693,10.35
"2464934588.jpg",0,48,50,2,0,100,2.54,0.539734315485991,40.7986111111111
"2465673065.jpg",3,47,45,3,0,98,2.48979591836735,0.613337968069768,39.3738532110092
"2466673147.jpg",0,1,38,66,2,107,3.64485981308411,0.536451240088433,69.5603448275862
"2471109874.jpg",38,66,5,1,0,110,1.71818181818182,0.592488426423846,18.6049107142857
"2473676566.jpg",45,58,2,0,0,105,1.59047619047619,0.531602043450486,15.0608695652174
"2473938827.jpg",1,4,54,50,0,109,3.40366972477064,0.610392497512353,63.6440677966102
"2474265369.jpg",6,38,47,9,1,101,2.61386138613861,0.774213110580065,40.6717391304348
"2474539087.jpg",0,12,81,9,0,102,2.97058823529412,0.455024367815358,51.0298165137615
"2475938786.jpg",12,63,30,3,0,108,2.22222222222222,0.674409860868105,31.3875
"2476813465.jpg",0,7,78,16,0,101,3.08910891089109,0.471147745425787,54.5114678899083
"2477552466.jpg",26,69,13,0,0,108,1.87962962962963,0.591490949877323,22.1081081081081
"2478250944.jpg",0,18,70,39,1,128,3.1796875,0.669158523760446,61.125
"2479736959.jpg",0,0,52,49,1,102,3.5,0.521801904675301,68.5894495412844
"2481588554.jpg",65,38,5,0,0,108,1.44444444444444,0.585388014675614,12.7163865546218
"2486040810.jpg",0,9,73,31,0,113,3.19469026548673,0.564712428074901,57.5304347826087
"2488865108.jpg",0,1,51,51,5,108,3.55555555555556,0.601141178518743,66.8625
"2489035588.jpg",3,50,47,2,0,102,2.47058823529412,0.592124591400669,40.9142857142857
"2489209226.jpg",0,17,72,14,0,103,2.97087378640777,0.550513319808434,54.8805309734513
"2490462635.jpg",0,13,63,25,0,101,3.11881188118812,0.604766545253146,58.3608490566038
"2491353954.jpg",1,37,59,7,0,104,2.69230769230769,0.608626068135469,47.287610619469
"2492228578.jpg",11,65,28,3,0,107,2.21495327102804,0.659159518918379,31.1756756756757
"2495556421.jpg",0,0,16,80,6,102,3.90196078431373,0.456196152044242,78.6875
"2495772957.jpg",2,39,63,7,0,111,2.67567567567568,0.620295562426965,45.8156779661017
"249590486.jpg",0,10,51,42,1,104,3.32692307692308,0.660131021009601,62.39375
"2496466506.jpg",45,53,5,0,0,103,1.61165048543689,0.58129351549086,16.1376146788991
"2500167386.jpg",0,0,15,87,12,114,3.97368421052632,0.488097740026813,79.4807692307692
"2500618710.jpg",0,3,34,62,3,102,3.63725490196078,0.593516382889227,71.0891304347826
"2501256504.jpg",1,34,61,8,0,104,2.73076923076923,0.611075277500422,47.0889423076923
"2502332369.jpg",0,3,60,43,0,106,3.37735849056604,0.542530757323038,66.4393203883495
"2503231447.jpg",0,19,65,20,0,104,3.00961538461538,0.615262077045495,54.9535398230088
"2503685415.jpg",0,15,74,17,1,107,3.03738317757009,0.581559932907514,53.9137931034483
"2503869220.jpg",1,45,46,7,1,100,2.62,0.678381913233261,42.018691588785
"2504686366.jpg",0,0,45,65,1,111,3.6036036036036,0.509532393104952,72.0338983050847
"2508139577.jpg",18,47,40,2,0,107,2.24299065420561,0.750359932441571,32.95
"2508976529.jpg",0,0,26,81,0,107,3.75700934579439,0.430907806436227,76.8365384615385
"2510458503.jpg",0,0,38,59,9,106,3.72641509433962,0.609965164780893,74.3173913043478
"2512779647.jpg",0,19,63,29,0,111,3.09009009009009,0.654349775100159,57.6120689655172
"2515829883.jpg",0,1,34,68,2,105,3.67619047619048,0.527972138237027,73.0260869565217
"2517368566.jpg",3,47,48,7,0,105,2.56190476190476,0.663959705737096,43.28125
"2517718928.jpg",0,2,49,65,7,123,3.6260162601626,0.619338277012477,73.0681818181818
"2519235976.jpg",8,76,21,0,0,105,2.12380952380952,0.513195833352107,31.2766990291262
"251925288.jpg",13,63,29,1,0,106,2.16981132075472,0.639519136512629,31.525
"2519479147.jpg",0,1,61,46,3,111,3.45945945945946,0.568631271863871,66.5657894736842
"25239707.jpg",0,0,10,67,25,102,4.14705882352941,0.569819475035116,84.275641025641
"252435496.jpg",7,67,34,0,0,108,2.25,0.565768024851109,33.3125
"2527050529.jpg",0,0,58,66,6,130,3.6,0.578691386604494,73.3414179104478
"2528064728.jpg",1,6,81,14,0,102,3.05882352941176,0.483869088992539,57.325
"2529798721.jpg",1,45,51,6,1,104,2.625,0.656372792487963,44.2942477876106
"2530204171.jpg",0,0,27,74,5,106,3.79245283018868,0.511151475677369,73.2051282051282
"2532088252.jpg",0,0,42,71,1,114,3.64035087719298,0.500038812342383,70.945652173913
"253771260.jpg",4,58,29,8,0,99,2.41414141414141,0.700001472448903,37.7125
"2537782042.jpg",0,3,60,39,1,103,3.36893203883495,0.559942070920715,67.2291666666667
"2538038277.jpg",0,6,31,68,4,109,3.64220183486239,0.645826140172365,68.8025210084034
"2539036531.jpg",0,1,47,54,4,106,3.57547169811321,0.584695495964266,70.5656779661017
"2539083530.jpg",0,15,72,14,0,101,2.99009900990099,0.538424544480478,53.6959459459459
"2539097876.jpg",0,11,68,26,1,106,3.16037735849057,0.603746910911237,58.3340336134454
"2539818768.jpg",5,63,56,1,0,125,2.424,0.585634478096606,40.1707317073171
"2540676775.jpg",0,52,53,1,0,106,2.5188679245283,0.520643047000473,41.8455882352941
"2542492471.jpg",4,51,51,3,0,109,2.48623853211009,0.61786188824524,40.8869565217391
"2545877303.jpg",1,46,44,5,0,96,2.55208333333333,0.613356454560378,39.7357142857143
"2547820942.jpg",1,1,31,67,2,102,3.66666666666667,0.58586203446916,74.3738938053097
"2549004146.jpg",1,52,48,5,0,106,2.5377358490566,0.604341882142988,41.7740384615385
"254969296.jpg",0,27,49,23,0,99,2.95959595959596,0.713130378771207,51.7478991596639
"255478501.jpg",68,29,2,0,0,99,1.33333333333333,0.515078753637713,8.76470588235294
"2555211479.jpg",0,22,75,7,0,104,2.85576923076923,0.510439925066912,48.204347826087
"2555644998.jpg",0,6,46,49,0,101,3.42574257425743,0.605748044214182,66.55
"2557729909.jpg",0,0,36,88,2,126,3.73015873015873,0.480211593574306,77.1280487804878
"255857546.jpg",0,2,25,66,9,102,3.80392156862745,0.614014797871709,75.1806722689076
"255984640.jpg",3,37,57,9,0,106,2.67924528301887,0.669714506499324,43.2125
"255985226.jpg",22,69,12,0,0,103,1.90291262135922,0.569047417073793,24.640756302521
"2562592972.jpg",5,60,34,2,0,101,2.32673267326733,0.601812444056936,33.0754310344828
"2564368557.jpg",0,6,54,38,3,101,3.37623762376238,0.645778369853231,66.0917431192661
"2567523621.jpg",1,12,74,25,1,113,3.11504424778761,0.623243422826171,56.4230769230769
"2568268182.jpg",0,27,61,13,0,101,2.86138613861386,0.616923057930193,47.5586956521739
"2569693875.jpg",0,0,28,81,4,113,3.78761061946903,0.490104351746142,74.2628205128205
"2569774614.jpg",7,59,35,4,0,105,2.34285714285714,0.662579043594792,37.1216216216216
"2569803000.jpg",0,4,88,16,1,109,3.12844036697248,0.453401086260373,57.8815789473684
"2569997123.jpg",0,1,45,55,0,101,3.53465346534653,0.520852309885318,71.9197247706422
"2570828036.jpg",0,1,45,66,0,112,3.58035714285714,0.513570663351039,70.1025641025641
"257114018.jpg",6,35,41,24,0,106,2.78301886792453,0.861943727929383,46.99375
"2571521736.jpg",0,12,69,23,1,105,3.12380952380952,0.599603043290984,58.2478260869565
"2574200121.jpg",0,16,72,15,1,104,3.00961538461538,0.582848584105705,55.7828947368421
"25742613.jpg",38,62,3,1,0,104,1.68269230769231,0.578991810008362,17.0769230769231
"257457837.jpg",3,56,41,5,0,105,2.45714285714286,0.635921067740018,38.74375
"2575730355.jpg",0,12,65,29,0,106,3.16037735849057,0.603746910911237,60.1621621621622
"2576250575.jpg",0,30,66,15,0,111,2.86486486486486,0.625030711776142,50.5
"2578696926.jpg",1,0,24,79,3,107,3.77570093457944,0.537436458990222,75.6150442477876
"2578890441.jpg",0,2,42,61,2,107,3.58878504672897,0.565573194436278,71.7142857142857
"2579041082.jpg",0,5,66,35,0,106,3.28301886792453,0.547804570316512,63.5096153846154
"2580252988.jpg",2,16,61,25,0,104,3.04807692307692,0.688036571791413,58.6691176470588
"2584408449.jpg",0,0,26,75,4,105,3.79047619047619,0.494104436469856,76.35
"258502837.jpg",1,29,46,22,0,98,2.90816326530612,0.747321467061863,49.5294117647059
"2585752058.jpg",0,10,58,30,1,99,3.22222222222222,0.63173805530579,58.6728971962617
"2585795694.jpg",1,27,64,13,0,105,2.84761904761905,0.632165879839856,48.2760869565217
"2588726621.jpg",0,3,42,56,0,101,3.52475247524752,0.558463237929599,71.3899082568807
"2588767665.jpg",0,7,61,36,0,104,3.27884615384615,0.582207562647962,61.0572033898305
"258893048.jpg",2,15,53,33,2,105,3.17142857142857,0.765319727770221,58.475
"2589128365.jpg",0,23,65,11,2,101,2.92079207920792,0.643166670729006,51.3642857142857
"2590631506.jpg",0,1,21,78,10,110,3.88181818181818,0.554081075474067,78.75625
"2593384818.jpg",7,73,25,1,0,106,2.18867924528302,0.554002020748761,31.8445945945946
"2596393826.jpg",0,18,68,19,0,105,3.00952380952381,0.596387169276516,53.472972972973
"2601194994.jpg",0,18,76,11,0,105,2.93333333333333,0.523792873528243,51.0689655172414
"2601219815.jpg",3,34,63,9,0,109,2.71559633027523,0.653930327006632,46.4789915966387
"2602273170.jpg",2,38,56,9,0,105,2.68571428571429,0.655073186079906,45.373786407767
"260267679.jpg",0,1,34,67,2,104,3.67307692307692,0.529559400892795,71.725
"2602795550.jpg",9,66,25,2,0,102,2.19607843137255,0.614014797871709,31.375
"2603439486.jpg",0,14,72,21,0,107,3.06542056074766,0.570848888529646,55.4646017699115
"2604683646.jpg",0,5,65,30,1,101,3.26732673267327,0.563756846679681,58.3715596330275
"2608308562.jpg",0,0,54,48,1,103,3.48543689320388,0.521387245906701,68.1785714285714
"2612353606.jpg",0,2,13,85,3,103,3.86407766990291,0.465443994004973,79.375
"2614925521.jpg",11,62,27,2,0,102,2.19607843137255,0.645459628792906,29.9885321100917
"2615955728.jpg",0,4,49,43,6,102,3.5,0.671189279938938,66.7828947368421
"261641635.jpg",0,2,16,74,14,106,3.94339622641509,0.598890858635405,78.6689189189189
"2619769686.jpg",0,0,36,67,2,105,3.67619047619048,0.509434794182543,72.0217391304348
"2620467173.jpg",1,19,79,13,0,112,2.92857142857143,0.56495691798253,53.6025641025641
"2620618611.jpg",0,5,43,51,5,104,3.53846153846154,0.667164364882061,68.9576271186441
"262123064.jpg",0,24,65,22,0,111,2.98198198198198,0.64641644305681,53.0868644067797
"2621420457.jpg",5,29,59,13,0,106,2.75471698113208,0.727832015610051,45.34375
"2622466873.jpg",0,13,75,16,0,104,3.02884615384615,0.52982376203792,57.9174311926606
"2624809780.jpg",0,9,75,23,2,109,3.1651376146789,0.585531753699621,57.2375
"2624882684.jpg",0,2,44,61,3,110,3.59090909090909,0.579393142588057,70.0504201680672
"2627264031.jpg",0,0,40,60,3,103,3.64077669902913,0.539687072220866,74.5810810810811
"2630235144.jpg",0,10,75,16,2,103,3.09708737864078,0.569047417073793,57.3876146788991
"2631446955.jpg",0,0,17,74,17,108,4,0.563699396261691,79.925
"2631646011.jpg",0,0,52,57,1,110,3.53636363636364,0.518948703114017,68.85625
"2633540206.jpg",0,0,41,62,4,107,3.65420560747664,0.551204576930051,71.5063025210084
"2634194915.jpg",2,43,57,2,0,104,2.56730769230769,0.57054603512134,43.4285714285714
"26344318.jpg",14,51,33,6,0,104,2.29807692307692,0.774343538977042,33.2948717948718
"2634922777.jpg",8,54,38,3,0,103,2.3495145631068,0.667285073925587,35.5137614678899
"2636294461.jpg",0,2,45,61,3,111,3.58558558558559,0.579474189063099,67.5546218487395
"2636589178.jpg",1,31,48,29,0,109,2.96330275229358,0.768917053569585,54.6973684210526
"2638753115.jpg",4,66,35,1,0,106,2.31132075471698,0.558283211063718,35.5865384615385
"2639149999.jpg",0,3,55,48,0,106,3.42452830188679,0.551156588371817,68.0023364485981
"2640025600.jpg",2,48,79,8,1,138,2.69565217391304,0.634859552859177,47.2119565217391
"264173063.jpg",5,66,36,3,0,110,2.33636363636364,0.609967253253567,34.9705882352941
"2641860474.jpg",0,44,51,6,0,101,2.62376237623762,0.597519625594254,42.0972222222222
"2642678784.jpg",0,6,79,24,0,109,3.1651376146789,0.500254777086597,60.446261682243
"2643679552.jpg",0,0,41,67,1,109,3.63302752293578,0.502964369158374,72.3834745762712
"2646059323.jpg",0,6,47,53,3,109,3.48623853211009,0.64714013164307,67.4380530973451
"264903403.jpg",0,1,46,56,1,104,3.54807692307692,0.537520515613129,71.3075221238938
"2649433967.jpg",9,68,28,2,0,107,2.21495327102804,0.614725546724555,33.1160714285714
"2649625286.jpg",0,2,53,51,2,108,3.49074074074074,0.571853362851923,67.6629464285714
"2650447326.jpg",28,91,37,1,0,157,2.07006369426752,0.661337511116179,28.4828125
"2652397944.jpg",0,0,46,57,0,103,3.55339805825243,0.499571489708456,70.3
"2653425342.jpg",0,13,62,34,1,110,3.20909090909091,0.650976042703169,58.4703389830508
"2654797164.jpg",0,3,45,48,2,98,3.5,0.596380837295082,71.6357142857143
"2655416178.jpg",0,8,59,34,1,102,3.27450980392157,0.615908935423586,62.125
"2655543598.jpg",0,0,33,69,3,105,3.71428571428571,0.513552591013095,73.1138392857143
"2656455723.jpg",1,34,68,10,0,113,2.76991150442478,0.612501451274113,48.0818965517241
"2657101675.jpg",0,7,69,25,1,102,3.19607843137255,0.563567415143367,61.5504587155963
"2659313316.jpg",0,2,46,55,4,107,3.57009345794393,0.600505283038207,71.9345794392523
"2664892520.jpg",1,17,102,15,0,135,2.97037037037037,0.517467148582209,54.593984962406
"2667565926.jpg",0,2,41,61,1,105,3.58095238095238,0.550890055709716,69.1554054054054
"2670033779.jpg",2,8,85,12,0,107,3,0.513956168750047,55.0669642857143
"2670820241.jpg",2,45,48,5,0,100,2.56,0.624742371144322,42.25
"2672397400.jpg",0,4,39,54,4,101,3.57425742574257,0.637911195284506,67.7300884955752
"2676057580.jpg",0,1,25,68,7,101,3.8019801980198,0.566035369569747,73.5131578947368
"2676808752.jpg",5,56,45,4,0,110,2.43636363636364,0.642918699145877,37.1197478991597
"2676837522.jpg",1,9,59,28,0,97,3.17525773195876,0.629323533618151,60.7720588235294
"2678740354.jpg",0,11,73,22,0,106,3.10377358490566,0.550830460184462,58.4553571428571
"2679224314.jpg",43,61,4,0,0,108,1.63888888888889,0.554646192409083,17.01875
"2680180441.jpg",6,89,42,1,0,138,2.27536231884058,0.550621625380069,34.2864583333333
"268066639.jpg",0,13,83,12,0,108,2.99074074074074,0.483278723595215,54.1666666666667
"2683241926.jpg",1,3,38,60,4,106,3.59433962264151,0.658689924692404,68.0487288135593
"26842976.jpg",6,49,45,6,0,106,2.4811320754717,0.69324814598652,39.5233050847458
"26847054.jpg",0,11,61,28,1,101,3.18811881188119,0.62789921623026,58.6794871794872
"2688019250.jpg",0,14,83,10,0,107,2.96261682242991,0.474346295857342,52.8571428571429
"2688943738.jpg",2,25,63,10,1,101,2.83168316831683,0.664368977763006,46.890625
"2688944098.jpg",10,76,19,0,0,105,2.08571428571429,0.520988072251728,27.4717391304348
"268926698.jpg",0,18,73,14,0,105,2.96190476190476,0.553377905438143,53.4575471698113
"2690466413.jpg",3,30,63,11,0,107,2.76635514018692,0.667004557880052,49.0526315789474
"2692538398.jpg",0,11,72,23,0,106,3.11320754716981,0.557558533625563,59.1804347826087
"2693336679.jpg",1,51,47,2,0,101,2.4950495049505,0.558994854649622,39.9036697247706
"2693433475.jpg",0,10,70,22,1,103,3.13592233009709,0.578173996629761,58.8230088495575
"269509962.jpg",0,6,72,24,0,102,3.17647058823529,0.51534405898039,58.6763392857143
"2696730288.jpg",1,4,44,49,3,101,3.48514851485149,0.672515596639046,67.8175675675676
"2698401109.jpg",0,0,29,67,5,101,3.76237623762376,0.531949524889066,76.525
"2700852747.jpg",0,15,58,26,1,100,3.13,0.661418738375885,55.5116822429907
"2702264162.jpg",0,7,74,28,1,110,3.20909090909091,0.560069696604103,60.5128205128205
"2703329173.jpg",0,3,52,52,0,107,3.45794392523365,0.554235387493874,67.0736607142857
"2703740653.jpg",0,4,69,26,0,99,3.22222222222222,0.506197419654031,61.2642857142857
"2704389795.jpg",0,2,26,71,7,106,3.78301886792453,0.585616760447309,76.2987288135593
"2704811.jpg",1,28,66,9,0,104,2.79807692307692,0.59740226795146,47.3974358974359
"2706980942.jpg",0,0,42,57,2,101,3.6039603960396,0.530645039942749,68.375
"2709928858.jpg",0,24,61,18,0,103,2.94174757281553,0.639013374287707,51.025
"271262860.jpg",1,6,75,31,0,113,3.20353982300885,0.569449797664976,58.8910256410256
"2713735764.jpg",0,31,97,11,0,139,2.85611510791367,0.532442431795113,51.568345323741
"2715023572.jpg",0,2,31,73,1,107,3.68224299065421,0.524820379715343,75.472972972973
"2715181629.jpg",0,7,52,46,0,105,3.37142857142857,0.60854718003592,64.8807339449541
"2716631816.jpg",13,83,10,1,0,107,1.99065420560748,0.504607583435334,25.9579831932773
"271837545.jpg",0,0,20,71,10,101,3.9009900990099,0.538608401253629,79.4121621621622
"2718449902.jpg",0,60,42,1,0,103,2.42718446601942,0.516434642668834,36.1792452830189
"2720757001.jpg",7,61,34,0,0,102,2.26470588235294,0.578945278424999,32.8541666666667
"272115602.jpg",1,13,64,27,0,105,3.11428571428571,0.640226608233452,57.2767857142857
"2722913532.jpg",1,6,67,25,1,100,3.19,0.59789191955967,60.7935779816514
"272411695.jpg",46,59,2,0,0,107,1.58878504672897,0.531165877300352,15.2627118644068
"2725001053.jpg",7,78,23,0,0,108,2.14814814814815,0.50815434432866,29.9513888888889
"2725180694.jpg",0,1,35,73,2,111,3.68468468468468,0.521919220186105,71.0897435897436
"272518935.jpg",0,8,70,32,0,110,3.21818181818182,0.564741041277403,57.65
"2725531194.jpg",0,0,45,66,0,111,3.59459459459459,0.493196961916072,68.1785714285714
"2725531293.jpg",1,27,66,10,0,104,2.81730769230769,0.603620517915844,46.890625
"2726553628.jpg",0,2,71,34,0,107,3.29906542056075,0.499338303120032,64.4891304347826
"2726774995.jpg",13,76,18,1,0,108,2.06481481481481,0.568209980736327,27.55
"2730274502.jpg",0,41,67,1,0,109,2.63302752293578,0.502964369158374,44.6764705882353
"2730850462.jpg",0,3,70,29,1,103,3.27184466019417,0.527557723954033,63.2155963302752
"273181633.jpg",0,0,56,46,1,103,3.46601941747573,0.520473652694041,68.679203539823
"2734143216.jpg",0,3,53,45,6,107,3.50467289719626,0.649728996853956,68.7331932773109
"2736161037.jpg",5,31,65,6,0,107,2.67289719626168,0.65553810439426,46.2571428571429
"2737304398.jpg",0,16,75,9,0,100,2.93,0.497569851956243,53.875
"273844105.jpg",0,0,12,80,10,102,3.98039215686275,0.46629766035944,79.7368421052632
"2739007601.jpg",0,21,67,8,0,96,2.86458333333333,0.535474048054946,51.2071428571429
"2739038267.jpg",0,0,27,68,13,108,3.87037037037037,0.597386716944033,77.4934210526316
"2741340609.jpg",1,6,54,47,2,110,3.39090909090909,0.66491986887646,62.3550420168067
"2741661469.jpg",0,4,53,50,0,107,3.42990654205607,0.568217164383648,69.0046728971963
"2741854107.jpg",10,65,33,2,0,110,2.24545454545455,0.638035454370833,33.3067226890756
"2742066850.jpg",14,75,14,2,0,105,2.03809523809524,0.587101903155359,27.5022123893805
"274223521.jpg",4,66,28,2,0,100,2.28,0.569954809479212,32.9976635514019
"2743703757.jpg",0,17,78,6,0,101,2.89108910891089,0.466925906306555,52.75
"274390572.jpg",5,59,44,1,1,110,2.4,0.638231501526902,36.5169491525424
"2745252477.jpg",0,5,48,46,2,101,3.44554455445545,0.624103317163953,64.5907079646018
"2746983219.jpg",0,3,48,52,0,103,3.47572815533981,0.557386411433294,67.5789473684211
"2747111058.jpg",1,3,43,54,1,102,3.5,0.625371176910874,69.6283185840708
"2748301393.jpg",3,52,40,7,0,102,2.5,0.671189279938938,40.825
"2748370097.jpg",2,12,63,21,4,102,3.12745098039216,0.740237701018349,56.0252293577982
"2749377637.jpg",0,10,79,17,1,107,3.08411214953271,0.534145329088297,57.3621495327103
"2753587179.jpg",1,4,63,26,1,95,3.23157894736842,0.591655297484467,61.6850961538462
"2753606061.jpg",0,10,80,37,0,127,3.21259842519685,0.572240393205992,62.2096774193548
"2756512177.jpg",0,16,81,11,0,108,2.9537037037037,0.500173040323575,53.858407079646
"2759049308.jpg",1,35,64,2,0,102,2.65686274509804,0.535753342818227,45.3819444444444
"275983561.jpg",1,25,67,10,0,103,2.83495145631068,0.595688551645559,50.7270642201835
"276009784.jpg",0,5,64,39,0,108,3.31481481481481,0.55783540513105,62.8050847457627
"2761179748.jpg",0,8,60,41,1,110,3.31818181818182,0.619733860929016,63.2245762711864
"2762549217.jpg",0,2,45,56,3,106,3.56603773584906,0.585846850205561,69.8448275862069
"2764211276.jpg",5,79,25,2,0,111,2.21621621621622,0.546150252476458,32.4217391304348
"2764419323.jpg",0,14,77,21,0,112,3.0625,0.558008847487093,56.4230769230769
"2764641436.jpg",0,0,49,55,0,104,3.52884615384615,0.50158449460463,70.2673267326733
"276570133.jpg",1,63,43,2,0,109,2.42201834862385,0.549302216986366,38.6449579831933
"276590560.jpg",3,49,47,4,0,103,2.50485436893204,0.624245213379169,40.1689189189189
"2766412345.jpg",6,58,41,1,0,106,2.34905660377358,0.602256911327458,37.1216216216216
"2768178889.jpg",1,47,52,4,0,104,2.56730769230769,0.587316144781357,42.6880530973451
"2770155406.jpg",0,6,68,32,0,106,3.24528301886792,0.548787768062993,63.2433035714286
"2771131265.jpg",0,2,57,45,1,105,3.42857142857143,0.552218303703395,65.2065217391304
"277244271.jpg",0,27,61,9,0,97,2.81443298969072,0.583271965353222,49.0582524271845
"277758418.jpg",1,13,70,21,1,106,3.07547169811321,0.627893124171503,55.6995798319328
"2778039171.jpg",0,2,38,62,3,105,3.62857142857143,0.576079970028582,68.8581081081081
"2779185055.jpg",0,23,73,13,0,109,2.90825688073395,0.569946137865639,49.9889380530973
"2780719978.jpg",0,9,88,28,1,126,3.16666666666667,0.547722557505166,59.9842519685039
"278235103.jpg",2,55,45,5,0,107,2.49532710280374,0.620009613067607,39.722972972973
"2785267250.jpg",0,1,28,69,2,100,3.72,0.514045157785213,74.1146788990826
"2785774595.jpg",0,9,65,26,2,102,3.20588235294118,0.618817705272534,59.5675675675676
"278636331.jpg",0,12,61,28,2,103,3.19417475728155,0.657658538661367,58.0870535714286
"2786566950.jpg",5,76,26,0,0,107,2.19626168224299,0.503558138451676,31.2268907563025
"27896611.jpg",0,18,58,26,2,104,3.11538461538462,0.701007490060013,56.0705128205128
"2789763994.jpg",0,0,43,57,1,101,3.58415841584158,0.515117981295029,69.2570754716981
"2790138273.jpg",0,6,56,36,0,98,3.30612244897959,0.58164649456993,59.2610619469027
"2795083224.jpg",0,6,45,59,2,112,3.50892857142857,0.62953630460519,66.8601694915254
"2796774323.jpg",0,0,28,66,12,106,3.84905660377358,0.598290466646247,78.4174107142857
"2798808586.jpg",0,4,58,40,0,102,3.35294117647059,0.556635202786152,62.1559633027523
"2799264783.jpg",0,1,38,66,4,109,3.6697247706422,0.561991265774353,74.4809322033898
"2799634889.jpg",0,3,65,32,2,102,3.32352941176471,0.565716311123285,62.2236842105263
"280028696.jpg",8,77,26,0,0,111,2.16216216216216,0.531559293546151,30.7415966386555
"2800893640.jpg",29,62,10,0,0,101,1.81188118811881,0.595195283703235,20.892523364486
"2801033102.jpg",1,45,54,8,0,108,2.63888888888889,0.633316936990578,43.4978991596639
"2806740564.jpg",0,2,44,58,3,107,3.57943925233645,0.583376366064357,72.5245535714286
"2807676440.jpg",0,2,66,33,0,101,3.30693069306931,0.504828173885447,63.175
"2807762234.jpg",0,0,43,58,6,107,3.65420560747664,0.584433344946403,70.4663865546218
"2808063507.jpg",3,62,40,0,0,105,2.35238095238095,0.536745040121693,35.7331932773109
"2808265543.jpg",6,57,58,5,0,126,2.49206349206349,0.654168562326644,39.7682926829268
"2808286292.jpg",0,0,32,68,5,105,3.74285714285714,0.537597422809103,72.3552631578947
"2809274597.jpg",2,51,51,4,0,108,2.52777777777778,0.60308139177812,41.15
"2811625726.jpg",1,1,29,76,7,114,3.76315789473684,0.614033978751189,74.9033613445378
"2815247737.jpg",2,42,50,6,0,100,2.6,0.635641726163728,40.1327433628319
"281609508.jpg",0,12,63,28,1,104,3.17307692307692,0.630030168676761,60.7361111111111
"28173586.jpg",0,5,55,42,1,103,3.37864077669903,0.596008041371744,63.5862068965517
"2817883212.jpg",0,0,18,70,12,100,3.94,0.547169022692202,79.7695652173913
"2818844013.jpg",0,1,43,61,0,105,3.57142857142857,0.516220414632661,71.0471698113208
"2819296433.jpg",1,33,62,10,0,106,2.76415094339623,0.625671247807053,46.195652173913
"2819647550.jpg",0,3,57,36,0,96,3.34375,0.53955390931086,66.7642857142857
"2822019435.jpg",0,3,47,57,0,107,3.50467289719626,0.555823912928399,70.8551401869159
"2823812300.jpg",1,7,58,44,1,111,3.33333333333333,0.65133894727893,61.2884615384615
"2824487894.jpg",9,78,16,1,0,104,2.08653846153846,0.523442246015848,27.6911764705882
"2824866912.jpg",0,10,52,42,1,105,3.32380952380952,0.657723903017621,62.9826086956522
"282730228.jpg",0,14,67,22,1,104,3.09615384615385,0.615641283292309,54.6986607142857
"2828824744.jpg",1,50,52,1,0,104,2.50961538461538,0.539600576976746,41.2278761061947
"28311109.jpg",86,16,0,0,0,102,1.15686274509804,0.365467232192233,5.16025641025641
"2832980159.jpg",0,2,40,62,2,106,3.60377358490566,0.563648747140221,71.640625
"2833068342.jpg",0,1,53,50,0,104,3.47115384615385,0.520580907214179,65.3220338983051
"2833148596.jpg",0,5,49,57,1,112,3.48214285714286,0.600032174169527,65.3782051282051
"2835381273.jpg",4,49,48,5,0,106,2.50943396226415,0.650937536596151,41.8495145631068
"2836089223.jpg",4,60,38,6,0,108,2.42592592592593,0.658569728973095,39.6155462184874
"2836927819.jpg",0,0,12,86,11,109,3.99082568807339,0.461387056201525,82.0897435897436
"2837843986.jpg",9,78,39,0,0,126,2.23809523809524,0.571714214321406,33.6673387096774
"2838554535.jpg",2,56,42,4,0,104,2.46153846153846,0.606166962854181,39.9867256637168
"2838590977.jpg",0,21,80,4,0,105,2.83809523809524,0.462514231045288,47.9891304347826
"2839454152.jpg",7,70,32,1,0,110,2.24545454545455,0.577663176618824,33.9294871794872
"2839494557.jpg",0,1,43,61,2,107,3.5981308411215,0.547029940957534,71.436974789916
"2840937282.jpg",7,61,30,0,0,98,2.23469387755102,0.570783877855586,31.9564220183486
"2841048687.jpg",0,11,84,12,1,108,3.02777777777778,0.501555213709073,55.6944444444444
"2841924891.jpg",0,1,52,50,0,103,3.47572815533981,0.521022000855986,68.9457547169811
"2844388238.jpg",0,5,52,42,2,101,3.40594059405941,0.619325727251536,67.8839285714286
"2844802224.jpg",2,21,55,27,0,105,3.01904761904762,0.733549751615552,52.5067567567568
"2848340403.jpg",1,23,80,9,1,114,2.87719298245614,0.582037174210297,50.7079831932773
"2848415190.jpg",0,2,43,57,2,104,3.56730769230769,0.57054603512134,72.6486486486486
"2848420274.jpg",1,1,60,43,1,106,3.39622641509434,0.580299516801763,66.6732673267327
"2848518668.jpg",0,4,58,39,0,101,3.34653465346535,0.555619358272486,61.7018348623853
"285149839.jpg",0,60,77,2,0,139,2.58273381294964,0.523357064571412,42.6989795918367
"2851510265.jpg",0,5,66,31,0,102,3.25490196078431,0.53927480659291,63.1399082568807
"285183593.jpg",25,70,8,2,0,105,1.87619047619048,0.615430401227124,20.8445945945946
"2852195444.jpg",0,8,44,47,2,101,3.42574257425743,0.668528752612262,64.3509174311927
"2852488757.jpg",0,1,43,65,2,111,3.61261261261261,0.5422373041587,71.4594594594595
"2855163439.jpg",0,24,94,10,0,128,2.890625,0.505627776945549,52.125
"2856053454.jpg",8,82,11,0,0,101,2.02970297029703,0.434866543770717,26.95
"2857618850.jpg",0,1,31,71,3,106,3.71698113207547,0.530134160578282,73.2394957983193
"2858136334.jpg",6,64,36,2,0,108,2.31481481481481,0.606015763468957,34.1486486486486
"2858839896.jpg",0,7,64,34,0,105,3.25714285714286,0.572252153750886,59.7631578947368
"2859973577.jpg",0,2,47,81,1,131,3.61832061068702,0.532887854664426,74.1417910447761
"2861346409.jpg",0,6,54,40,2,102,3.37254901960784,0.628081608928551,62.5344036697248
"286576891.jpg",1,27,68,5,0,101,2.76237623762376,0.550427376708048,48.0529661016949
"2866097268.jpg",2,32,62,7,0,103,2.71844660194175,0.617037128703877,46.0193965517241
"2866556638.jpg",0,26,72,8,0,106,2.83018867924528,0.542861871639687,50.7972972972973
"2867718050.jpg",4,81,24,0,0,109,2.18348623853211,0.474637046802878,31.86875
"2868335466.jpg",0,14,75,12,0,101,2.98019801980198,0.509513454578031,54.8214285714286
"2868514181.jpg",0,32,68,7,0,107,2.76635514018692,0.559302787883853,48.3411214953271
"2871570084.jpg",0,2,58,45,1,106,3.42452830188679,0.551156588371817,65.9600840336134
"2871745051.jpg",0,4,12,77,18,111,3.98198198198198,0.64641644305681,78.9555084745763
"287350518.jpg",3,77,31,0,0,111,2.25225225225225,0.494854771504979,33.510593220339
"2876226509.jpg",1,53,50,1,0,105,2.48571428571429,0.53912831557927,38.3676470588235
"288113726.jpg",34,67,10,0,0,111,1.78378378378378,0.593991206017019,22.0128205128205
"288435225.jpg",1,31,76,2,0,110,2.71818181818182,0.509214509003966,45.9734513274336
"2886173632.jpg",3,28,67,5,0,103,2.71844660194175,0.600938412037265,45.9509345794393
"2887792801.jpg",0,15,74,21,0,110,3.05454545454545,0.572077553547355,56.775641025641
"2888444557.jpg",0,4,74,29,0,107,3.23364485981308,0.506177671326723,60.1378504672897
"2889093136.jpg",0,4,61,39,2,106,3.36792452830189,0.590810124975516,64.7121848739496
"288926242.jpg",0,17,71,17,1,106,3.0188679245283,0.601286431633151,53.9663865546218
"2889734029.jpg",0,0,29,73,6,108,3.78703703703704,0.53040146892859,74.6260504201681
"2890317632.jpg",1,33,58,10,0,102,2.75490196078431,0.636143618347645,46.0344036697248
"2893674566.jpg",0,3,46,81,1,131,3.61068702290076,0.548740082566341,73.4908088235294
"289395722.jpg",7,42,47,2,0,98,2.44897959183673,0.659935157383168,38.3177570093458
"289462174.jpg",12,75,17,0,0,104,2.04807692307692,0.528412307616814,26.9695652173913
"2897238920.jpg",1,56,43,6,0,106,2.50943396226415,0.620986665279237,40.2413043478261
"2899446484.jpg",8,58,41,3,0,110,2.35454545454545,0.657858126368209,35.71875
"2901332011.jpg",0,6,60,38,2,106,3.33962264150943,0.615464090520783,61.5466101694915
"290161904.jpg",0,4,43,58,2,107,3.54205607476635,0.603142303553142,68.925
"2902284957.jpg",0,1,28,76,4,109,3.76146788990826,0.525270346068951,76.1184210526316
"2903155533.jpg",0,7,77,19,2,105,3.15238095238095,0.550890055709715,60.5069444444444
"2904337110.jpg",12,62,38,0,0,112,2.23214285714286,0.629344616307033,31.8846153846154
"2904731239.jpg",0,4,59,41,0,104,3.35576923076923,0.555960975629318,63.8881578947368
"2905127622.jpg",0,6,71,26,0,103,3.19417475728155,0.525025721632918,58.9
"2905606337.jpg",0,7,68,26,0,101,3.18811881188119,0.542454998817943,61.9174107142857
"2906250648.jpg",0,43,59,2,0,104,2.60576923076923,0.529118505469683,43.7287735849057
"2906852026.jpg",0,1,49,61,1,112,3.55357142857143,0.534221429177579,69.6089743589744
"2906945782.jpg",0,4,56,50,0,110,3.41818181818182,0.564741041277403,62.39375
"2907072293.jpg",37,65,8,0,0,110,1.73636363636364,0.585407765473404,21.1666666666667
"290776828.jpg",0,1,34,65,1,101,3.65346534653465,0.518375222485729,71.3177570093458
"290784782.jpg",0,3,35,62,6,106,3.66981132075472,0.628250755415498,71.5444915254237
"2908299910.jpg",1,27,71,11,1,111,2.85585585585586,0.630250265541711,47.7021739130435
"2908654044.jpg",2,53,48,3,0,106,2.49056603773585,0.589516073028878,41.5870535714286
"2909358760.jpg",0,1,44,58,3,106,3.59433962264151,0.565320000181818,70.5152173913043
"2910495331.jpg",0,1,61,40,1,103,3.39805825242718,0.530257167080327,66.4159292035398
"2910515798.jpg",1,5,42,50,3,101,3.48514851485149,0.68722429215124,65.7133027522936
"2910782740.jpg",0,10,72,27,0,109,3.15596330275229,0.563952846837089,56.1155462184874
"2916069086.jpg",0,1,55,62,0,118,3.51694915254237,0.518595256560915,70.525641025641
"2916773975.jpg",0,5,51,48,0,104,3.41346153846154,0.584767432371758,68.3616504854369
"2918475321.jpg",0,35,63,7,0,105,2.73333333333333,0.57623891056686,45.8175675675676
"2920995979.jpg",0,29,69,7,0,105,2.79047619047619,0.549391938265845,46.554347826087
"2923794448.jpg",0,1,44,59,2,106,3.58490566037736,0.549769207478433,72.4466019417476
"2924727768.jpg",1,1,50,53,3,108,3.51851851851852,0.61873373074401,67.2920353982301
"2926374384.jpg",0,3,44,57,1,105,3.53333333333333,0.572891899231546,68.3258928571429
"2927008302.jpg",0,12,62,26,2,102,3.17647058823529,0.651149246110707,58.1554054054054
"2928622708.jpg",0,11,75,20,0,106,3.08490566037736,0.536619480829526,55.6206896551724
"2931243331.jpg",0,2,78,49,1,130,3.37692307692308,0.5321505967326,66.3125
"2931922629.jpg",0,5,59,41,0,105,3.34285714285714,0.568881686843911,63.5862068965517
"2932540851.jpg",0,0,56,53,0,109,3.48623853211009,0.502119192340169,67.6239495798319
"2933417983.jpg",9,58,40,3,0,110,2.33636363636364,0.667423812471915,37.4551282051282
"2933544143.jpg",0,29,69,8,0,106,2.80188679245283,0.559247986917716,48.7931034482759
"2937190977.jpg",0,0,36,67,2,105,3.67619047619048,0.509434794182543,73.1875
"2937238676.jpg",1,18,68,15,0,102,2.95098039215686,0.603249467802339,53.5353773584906
"2937429297.jpg",0,32,59,9,0,100,2.77,0.600588936550675,47.3040540540541
"2938430307.jpg",0,2,35,64,2,103,3.64077669902913,0.557557153177668,72.5982142857143
"2939787669.jpg",0,1,47,59,0,107,3.54205607476635,0.519077080686367,68.8652173913043
"2941933060.jpg",0,0,19,86,9,114,3.91228070175439,0.489923301000493,79.4789915966387
"2943372707.jpg",0,2,57,45,2,106,3.44339622641509,0.570383140725355,64.2033898305085
"2944165349.jpg",5,45,46,5,0,101,2.5049504950495,0.672662803732117,39.9583333333333
"2946225988.jpg",7,67,28,1,0,103,2.22330097087379,0.576195072410062,33.3370535714286
"2946661592.jpg",0,3,36,63,5,107,3.65420560747664,0.615871889066098,71.0210084033613
"2948923084.jpg",0,0,28,72,6,106,3.79245283018868,0.529455805648376,74.9033613445378
"2949029930.jpg",4,84,41,4,0,133,2.33834586466165,0.588876923462414,34.4375
"2951011449.jpg",0,0,44,56,2,102,3.58823529411765,0.53311973979568,68.2110091743119
"2951329736.jpg",0,1,29,71,7,108,3.77777777777778,0.569199032800311,74.0818584070797
"2951685771.jpg",0,0,30,79,3,112,3.75892857142857,0.488526663712741,74.9679487179487
"2952066894.jpg",0,3,41,53,3,100,3.56,0.608359277155375,70.2702702702703
"2952908030.jpg",0,22,75,6,1,104,2.86538461538462,0.540723935947584,50.2179487179487
"2953741163.jpg",2,42,55,10,0,109,2.6697247706422,0.667430754787558,45.1864406779661
"2954125895.jpg",0,0,21,75,8,104,3.875,0.515535351871359,77.828125
"2954406623.jpg",17,81,15,0,0,113,1.98230088495575,0.534226759053209,26.3739495798319
"2956548148.jpg",8,79,16,1,0,104,2.09615384615385,0.512356648561204,28.5973451327434
"2957895882.jpg",4,51,82,2,1,140,2.60714285714286,0.608056564145484,44.8493150684931
"2958115632.jpg",0,0,16,81,13,110,3.97272727272727,0.51507710136473,77.6071428571429
"295960855.jpg",0,1,42,58,4,105,3.61904761904762,0.57814278880661,69.703781512605
"2960552821.jpg",16,77,8,0,0,101,1.92079207920792,0.483387387440584,23.9565217391304
"2962584804.jpg",0,10,62,35,0,107,3.23364485981308,0.607802091243158,61.3326086956522
"296426748.jpg",10,87,13,0,0,110,2.02727272727273,0.458539582577839,27.0084745762712
"2964711556.jpg",0,3,36,59,5,103,3.64077669902913,0.623940182716745,71.4196428571429
"2964746234.jpg",3,55,41,2,0,101,2.41584158415842,0.587661922072092,38.725
"2965834083.jpg",0,0,17,83,6,106,3.89622641509434,0.456263192279336,81.775
"2967177700.jpg",0,25,62,19,0,106,2.94339622641509,0.644835729236455,52.4888392857143
"296739390.jpg",0,16,72,25,1,114,3.09649122807018,0.623568069332061,55.0833333333333
"2971073872.jpg",0,26,73,5,0,104,2.79807692307692,0.509707848784743,49.8060747663551
"2971372651.jpg",0,1,57,69,1,128,3.546875,0.530330085889911,71.742125984252
"2973164436.jpg",6,69,33,1,0,109,2.26605504587156,0.571583275985521,32.5652173913044
"2974085281.jpg",1,52,62,3,0,118,2.56779661016949,0.562029496432532,42.9551282051282
"2975238945.jpg",0,1,32,79,1,113,3.70796460176991,0.494278260432095,71.7948717948718
"2976379229.jpg",0,0,27,73,6,106,3.80188679245283,0.524083078124337,75.9491525423729
"2977820017.jpg",0,5,71,35,0,111,3.27027027027027,0.538448038278802,62.5855263157895
"2978991004.jpg",0,28,61,17,1,107,2.91588785046729,0.674627714626046,50.56875
"2979597587.jpg",1,34,62,7,0,104,2.72115384615385,0.598651085134435,46.7354368932039
"2980838635.jpg",0,4,60,46,0,110,3.38181818181818,0.558205154187778,65.3648648648649
"2982904736.jpg",0,0,26,77,2,105,3.77142857142857,0.465277891677131,74.4469026548673
"298323953.jpg",1,6,75,19,0,101,3.10891089108911,0.527275831022244,57.7382075471698
"298392087.jpg",0,1,59,41,0,101,3.3960396039604,0.511452987493319,64.2242990654206
"2985434942.jpg",0,28,62,11,0,101,2.83168316831683,0.601154005737183,49.125
"2986131608.jpg",0,24,70,11,0,105,2.87619047619048,0.566623570867177,50.5723684210526
"2988609766.jpg",0,21,79,8,0,108,2.87962962962963,0.506363110683967,49.9159292035398
"2990464677.jpg",0,1,36,72,2,111,3.67567567567568,0.525048260330111,71.5444915254237
"2990600386.jpg",1,22,66,18,0,107,2.94392523364486,0.641810171502485,54.2234513274336
"2991438895.jpg",2,69,51,0,0,122,2.40163934426229,0.524756315985342,38.0909090909091
"299211567.jpg",7,71,23,1,0,102,2.17647058823529,0.552434122337155,30.55
"2992631389.jpg",0,8,66,30,1,105,3.22857142857143,0.592535991395376,60.0641592920354
"299519765.jpg",0,1,31,71,3,106,3.71698113207547,0.530134160578282,74.95
"2998270477.jpg",4,42,60,3,0,109,2.56880733944954,0.614138548686427,41.2012711864407
"2999079951.jpg",9,61,33,4,0,107,2.29906542056075,0.675933362672767,36.8473451327434
"3000370105.jpg",0,7,66,39,0,112,3.28571428571429,0.576234615453057,62.25625
"3001984740.jpg",5,48,53,5,0,111,2.52252252252252,0.658467184891574,40.5720338983051
"3003071617.jpg",0,0,51,54,1,106,3.52830188679245,0.520211443637723,71.004854368932
"3004729679.jpg",0,4,40,58,4,106,3.58490566037736,0.630463541158059,71.2836538461538
"3005225950.jpg",0,1,24,73,3,101,3.77227722772277,0.507566510298146,74.3660714285714
"3005232085.jpg",1,25,65,15,0,106,2.88679245283019,0.63726730157508,50.2665094339623
"30054528.jpg",0,2,40,64,1,107,3.5981308411215,0.547029940957534,69.3072033898305
"3006180799.jpg",0,10,86,10,0,106,3,0.436435780471985,55.1824324324324
"3007216990.jpg",2,57,48,0,0,107,2.42990654205607,0.533980240124661,39.1302521008403
"3009167692.jpg",0,2,28,64,5,99,3.72727272727273,0.585856808760517,79.1785714285714
"3010841196.jpg",10,42,43,6,0,101,2.44554455445545,0.754655517766252,35.9712389380531
"301104017.jpg",0,1,28,72,9,110,3.80909090909091,0.582551404125599,72.43125
"3011247965.jpg",2,23,46,34,0,105,3.06666666666667,0.787726361443376,55.2567567567568
"3012507882.jpg",0,28,72,2,0,102,2.74509803921569,0.481052363502936,47.6995412844037
"3013640771.jpg",0,1,41,61,2,105,3.60952380952381,0.545880342186223,70.9776785714286
"3014660789.jpg",0,0,35,63,4,102,3.69607843137255,0.541161488064193,73.525
"3014908112.jpg",0,7,41,60,3,111,3.53153153153153,0.65809393940959,67.7112068965517
"3015139450.jpg",0,34,62,7,0,103,2.7378640776699,0.576690440094974,47.9857142857143
"3016703765.jpg",0,1,45,56,1,103,3.55339805825243,0.537389392902424,72.2642857142857
"3016815898.jpg",1,35,56,14,0,106,2.78301886792453,0.676189843462999,48.8361344537815
"3017896883.jpg",31,71,5,0,0,107,1.75700934579439,0.529170256429054,20.9957627118644
"3018181041.jpg",0,29,69,9,0,107,2.81308411214953,0.568527411288765,49.2086956521739
"3020768905.jpg",0,2,71,57,0,130,3.42307692307692,0.526291466029296,69.0137795275591
"3020941119.jpg",0,29,66,6,0,101,2.77227722772277,0.545549046719209,48.4564220183486
"3021480593.jpg",0,0,21,75,11,107,3.90654205607477,0.541359404915138,77.468487394958
"3021647597.jpg",0,3,48,51,0,102,3.47058823529412,0.55768052803139,66.8457943925234
"3021659624.jpg",3,20,60,26,1,110,3.01818181818182,0.753971967719461,53.18125
"3022463774.jpg",0,2,36,65,4,107,3.66355140186916,0.581863065548848,71.1596638655462
"3022996908.jpg",0,7,73,19,3,102,3.17647058823529,0.58718601815648,58.75
"3024891214.jpg",0,1,33,63,3,100,3.68,0.548275533473873,72.088785046729
"3025565947.jpg",0,0,34,75,0,109,3.68807339449541,0.465419916061909,73.275641025641
"3026154930.jpg",0,10,72,24,1,107,3.14953271028037,0.579585706260149,56.61875
"302681636.jpg",0,17,70,24,0,111,3.06306306306306,0.607218386343965,53.5762711864407
"3026852045.jpg",0,0,42,55,4,101,3.62376237623762,0.563053907694722,70.6238317757009
"3032057861.jpg",0,0,51,46,5,102,3.54901960784314,0.590811674948363,66.9243119266055
"3033284037.jpg",23,69,14,0,0,106,1.91509433962264,0.587454955165592,24.1294642857143
"3034148847.jpg",0,2,55,52,3,112,3.5,0.585100284004667,66.510593220339
"3035737878.jpg",1,33,70,8,0,112,2.75892857142857,0.588868753854719,46.3391304347826
"3038029410.jpg",1,16,68,25,0,110,3.06363636363636,0.639341299892415,54.3823529411765
"3038577350.jpg",0,1,35,67,2,105,3.66666666666667,0.531085004543794,72.0089285714286
"3039024.jpg",0,45,48,8,1,102,2.65686274509804,0.667418523810257,43.4487179487179
"3040037970.jpg",0,1,22,70,12,105,3.88571428571429,0.593462553323967,77.1482300884956
"3043517594.jpg",0,2,60,39,2,103,3.39805825242718,0.566028576588288,67.231308411215
"3044304939.jpg",0,11,78,18,0,107,3.06542056074766,0.518907197821177,56.8995327102804
"3045035343.jpg",0,3,78,45,1,127,3.34645669291339,0.540105115517363,65.4697580645161
"304760277.jpg",0,1,34,63,2,100,3.66,0.535978289926679,74.2660550458716
"3047954017.jpg",0,0,34,73,1,108,3.69444444444444,0.482561958315932,74.725
"3048478105.jpg",0,0,30,76,3,109,3.75229357798165,0.493587834180471,75.3898305084746
"3048498691.jpg",0,17,90,20,0,127,3.02362204724409,0.541376360727457,54.8788461538462
"3048643650.jpg",0,18,101,10,0,129,2.93798449612403,0.463545069014602,53.2283464566929
"3049913075.jpg",0,1,64,71,1,137,3.52554744525547,0.529709853582502,71.2103448275862
"3050837263.jpg",0,17,79,11,0,107,2.94392523364486,0.510858982516343,53.7702702702703
"3051112804.jpg",15,48,34,7,0,104,2.31730769230769,0.80368596336333,33.9288793103448
"3051623040.jpg",2,28,69,5,0,104,2.74038461538462,0.57445951478755,48.7266355140187
"3052939128.jpg",0,1,34,62,7,104,3.72115384615385,0.598651085134435,73.1875
"3059406578.jpg",0,12,95,32,0,139,3.14388489208633,0.545882493581799,59.6418918918919
"306264588.jpg",30,74,6,0,0,110,1.78181818181818,0.531258125581778,20.2013274336283
"306315468.jpg",5,72,22,1,0,100,2.19,0.525991127935317,30.8967889908257
"3067436148.jpg",6,79,23,1,0,109,2.1743119266055,0.524299121177549,31.0189075630252
"3067455040.jpg",0,45,63,5,0,113,2.64601769911504,0.565691012048553,44.7457983193277
"3068655528.jpg",0,11,74,23,1,109,3.12844036697248,0.578966471094584,58.2434210526316
"306909339.jpg",2,41,56,5,0,104,2.61538461538462,0.612296208343076,42.5446428571429
"3069379747.jpg",0,6,68,30,1,105,3.24761904761905,0.568076247268466,63.1553398058252
"3070894795.jpg",4,66,33,6,0,109,2.37614678899083,0.649629393288091,37.7436974789916
"3071201670.jpg",0,32,57,12,0,101,2.8019801980198,0.632768551370847,49.675
"3072804517.jpg",1,6,48,52,1,108,3.42592592592593,0.658569728973095,63.1176470588235
"3073021963.jpg",0,41,58,6,0,105,2.66666666666667,0.582875278034323,43.783185840708
"3073780494.jpg",0,16,69,17,0,102,3.00980392156863,0.571520432475467,53.9059633027523
"3073970642.jpg",0,0,49,57,2,108,3.56481481481481,0.534302727522781,68.44375
"3074454678.jpg",0,5,72,30,1,108,3.25,0.549000791583107,62.6415094339623
"307525026.jpg",0,6,65,39,1,111,3.31531531531532,0.587475059153106,60.9358974358974
"3075864902.jpg",40,63,5,0,0,108,1.67592592592593,0.560852217090226,19.094537815126
"3076588969.jpg",0,10,55,43,0,108,3.30555555555556,0.633316936990578,63.1351351351351
"3077228870.jpg",6,61,41,0,0,108,2.32407407407407,0.577275322701455,34.3055555555556
"3077416434.jpg",0,4,48,48,2,102,3.47058823529412,0.608616062833893,67
"3077626117.jpg",25,76,12,0,0,113,1.88495575221239,0.563030898501592,23.531512605042
"3078114304.jpg",31,61,13,0,0,105,1.82857142857143,0.627221327289334,20.892523364486
"3078217018.jpg",4,31,65,3,0,103,2.6504854368932,0.605671525940304,44.6592920353982
"3078720945.jpg",0,34,57,8,1,100,2.76,0.63754579950357,46.6448598130841
"3084516747.jpg",4,84,21,0,0,109,2.15596330275229,0.454897463550355,30.6153846153846
"3084860790.jpg",60,37,6,0,0,103,1.47572815533981,0.607867700295262,12.1850961538462
"3085307148.jpg",1,25,63,19,1,109,2.94495412844037,0.691681557876127,52.6902654867257
"3086003946.jpg",0,29,75,4,0,108,2.76851851851852,0.504308196109487,48.3611111111111
"3087855667.jpg",1,38,60,4,0,103,2.6504854368932,0.572383010806878,45.5202702702703
"3090534929.jpg",6,53,42,5,0,106,2.43396226415094,0.676389123346533,37.0320512820513
"3091624267.jpg",90,22,1,0,0,113,1.21238938053097,0.432007924729486,4.94871794871795
"3092999912.jpg",10,63,22,7,0,102,2.25490196078431,0.726939529398462,33.55
"3093374173.jpg",1,31,61,16,1,110,2.86363636363636,0.697008979807011,49.2625
"3093435000.jpg",0,0,28,77,3,108,3.76851851851852,0.485422669308056,73.4474789915966
"3094633355.jpg",1,11,63,27,0,102,3.13725490196078,0.62993345061479,56.65
"3094978642.jpg",10,67,24,3,0,104,2.19230769230769,0.639734821836635,32.6858407079646
"3099787122.jpg",0,3,74,33,0,110,3.27272727272727,0.505185784866346,62.3274336283186
"3100238639.jpg",1,18,58,24,1,102,3.05882352941176,0.701109861474453,55.537610619469
"3100436628.jpg",0,12,63,26,1,102,3.15686274509804,0.62529356336085,56.4036697247706
"3102411945.jpg",2,9,69,19,0,99,3.06060606060606,0.603022689155527,56.275
"3102604471.jpg",0,4,77,25,0,106,3.19811320754717,0.486382395529528,60.1483050847458
"310467976.jpg",0,1,22,79,8,110,3.85454545454545,0.539050535262052,75.7352941176471
"3105942236.jpg",0,0,76,31,0,107,3.28971962616822,0.455766942147602,62.6239130434783
"3105967281.jpg",3,14,78,19,0,114,2.99122807017544,0.63099323355961,52.2217391304348
"3106852276.jpg",0,3,38,60,5,106,3.63207547169811,0.622215269716858,72.4481132075472
"3107236272.jpg",3,51,46,7,0,107,2.53271028037383,0.663293056967747,42.4652173913043
"3107928091.jpg",0,29,61,9,1,100,2.82,0.625711715980412,47.0940366972477
"3108798537.jpg",0,13,68,20,0,101,3.06930693069307,0.570217953813702,56.3279816513761
"3108925603.jpg",0,0,45,55,5,105,3.61904761904762,0.57814278880661,71.5337837837838
"3109009017.jpg",0,0,52,54,3,109,3.55045871559633,0.552540237048483,68.5921052631579
"3109733480.jpg",0,0,7,79,20,106,4.12264150943396,0.491892945934943,83.0805084745763
"3111479555.jpg",8,53,36,6,0,103,2.38834951456311,0.717197838387022,37.2847222222222
"3112707699.jpg",10,81,38,0,0,129,2.21705426356589,0.572293089111656,31.6428571428571
"3112828024.jpg",0,6,69,31,2,108,3.26851851851852,0.58973273657517,63.6697247706422
"3114317948.jpg",0,6,77,24,0,107,3.16822429906542,0.504432827557042,59.2897196261682
"3115128591.jpg",3,18,65,14,0,100,2.9,0.659047368816107,49.0398230088496
"3115284513.jpg",8,73,31,1,0,113,2.2212389380531,0.57839854762859,31.7627118644068
"3115828038.jpg",21,70,12,0,0,103,1.9126213592233,0.561978230624793,24.4928571428571
"3116503568.jpg",2,43,61,3,0,109,2.59633027522936,0.579259841506669,43.1339285714286
"3117619556.jpg",3,34,88,8,0,133,2.7593984962406,0.592252709420483,48.4525547445255
"3117729596.jpg",0,21,77,6,0,104,2.85576923076923,0.491051363274922,50.651376146789
"3118054377.jpg",0,5,63,37,1,106,3.32075471698113,0.578127845662116,63.7160194174757
"3118439925.jpg",0,5,57,41,0,103,3.3495145631068,0.572383010806878,62.2432432432432
"3118885310.jpg",0,7,61,35,0,103,3.27184466019417,0.58063816746346,62.4428571428571
"311996877.jpg",6,34,60,9,0,109,2.6605504587156,0.709984135011044,45.0924369747899
"3120415423.jpg",0,8,83,32,0,123,3.19512195121951,0.53803736516851,60.4545454545455
"3121612010.jpg",0,10,83,14,0,107,3.03738317757009,0.474346295857342,57.2767857142857
"3124199543.jpg",33,57,14,3,0,107,1.8785046728972,0.736005029384885,23.531512605042
"3125804438.jpg",0,12,74,22,0,108,3.09259259259259,0.555970769033215,56.4125
"312749227.jpg",0,1,23,71,11,106,3.86792452830189,0.586766306984033,76.4487179487179
"3127532138.jpg",0,0,51,55,2,108,3.5462962962963,0.536242713551076,67.6513157894737
"31286602.jpg",0,2,17,62,27,108,4.05555555555556,0.694885633477702,80.796218487395
"3128928410.jpg",0,3,28,67,3,101,3.69306930693069,0.578663533625988,72.5252293577982
"3129387328.jpg",14,66,22,2,0,104,2.11538461538462,0.643227485581592,31.25
"3129647217.jpg",0,0,15,85,4,104,3.89423076923077,0.416137328685635,80.6013513513514
"3130211082.jpg",0,0,21,73,8,102,3.87254901960784,0.520311571307667,76.7697368421053
"3130276162.jpg",5,44,52,6,0,107,2.55140186915888,0.676194189756629,41.63125
"3131665013.jpg",1,24,67,10,0,102,2.84313725490196,0.592779959162309,49.125
"3132046766.jpg",0,11,48,42,3,104,3.35576923076923,0.709413394082926,63.7434210526316
"3132085493.jpg",0,1,45,67,1,114,3.59649122807018,0.527463428176746,68.4807692307692
"3132104449.jpg",0,3,33,63,0,99,3.60606060606061,0.54991987947377,74.8571428571429
"3132669524.jpg",15,79,19,0,0,113,2.0353982300885,0.549824704854436,28.5924369747899
"313424539.jpg",0,0,26,75,7,108,3.82407407407407,0.526471302014582,75.1052631578947
"313550822.jpg",0,11,74,17,0,102,3.05882352941176,0.52319523667414,54.4357798165138
"3136368482.jpg",0,28,71,2,0,101,2.74257425742574,0.482772520894358,46.6399082568807
"313650765.jpg",3,52,51,4,0,110,2.50909090909091,0.616968833992797,39.6946902654867
"3137057232.jpg",0,32,74,3,1,110,2.75454545454545,0.544974768145213,46.1924778761062
"3138088232.jpg",0,7,60,41,0,108,3.31481481481481,0.590392680161108,64.7640186915888
"3138790639.jpg",0,2,44,57,5,108,3.60185185185185,0.610497189975925,68.2375
"3141055360.jpg",0,16,79,13,0,108,2.97222222222222,0.519855000152735,54.6973684210526
"3141860810.jpg",0,3,39,61,3,106,3.60377358490566,0.59648566474642,72.671875
"3142311257.jpg",0,10,62,33,0,105,3.21904761904762,0.604167456106596,59.5981308411215
"3146365512.jpg",0,1,21,72,8,102,3.85294117647059,0.552170493535534,79.2654867256637
"3146477274.jpg",0,32,75,4,0,111,2.74774774774775,0.512896737231836,46.0855263157895
"3146801905.jpg",6,66,33,3,0,108,2.30555555555556,0.618383985800151,35.375
"3147028593.jpg",0,33,63,5,0,101,2.72277227722772,0.549887477238537,46.1578947368421
"3147348702.jpg",2,42,70,7,0,121,2.67768595041322,0.60848001929751,46.5483193277311
"3147416579.jpg",34,46,17,3,0,100,1.89,0.790026211047085,22.2032710280374
"3147925879.jpg",0,4,82,47,0,133,3.32330827067669,0.530135376942176,64.6684782608696
"3147927973.jpg",0,11,82,16,0,109,3.04587155963303,0.497871787394763,55.9075630252101
"3148698494.jpg",0,38,54,9,0,101,2.71287128712871,0.621878342819017,47.1697247706422
"31490353.jpg",0,10,52,39,2,103,3.32038834951456,0.6746617486986,61.8081896551724
"3149433848.jpg",43,58,3,0,0,104,1.61538461538462,0.545194225793602,15.4736842105263
"3152357796.jpg",1,14,76,17,0,108,3.00925925925926,0.571853362851923,54.2905405405405
"3154777716.jpg",0,12,82,13,0,107,3.00934579439252,0.4855521483138,55.8513513513514
"3154948821.jpg",0,26,111,11,0,148,2.89864864864865,0.491282714579314,52.8186274509804
"3156288845.jpg",0,6,61,36,1,104,3.30769230769231,0.592459462820778,61.8262711864407
"3157055534.jpg",4,46,50,7,0,107,2.5607476635514,0.675411406330314,41.1548672566372
"3157096755.jpg",0,14,78,15,0,107,3.00934579439252,0.522969155676269,54.7648305084746
"3157335389.jpg",6,53,50,2,0,111,2.43243243243243,0.626993136422077,37.0847826086957
"3158018696.jpg",3,69,34,0,0,106,2.29245283018868,0.515788460368257,34.5546218487395
"3158477442.jpg",0,23,61,12,0,96,2.88541666666667,0.595947572167158,52.0218446601942
"3159188052.jpg",0,57,54,2,0,113,2.51327433628319,0.536440721125756,40.7247899159664
"3161274755.jpg",0,4,46,48,2,100,3.48,0.611010092660779,67.1542056074766
"3162134277.jpg",18,70,18,1,0,107,2.01869158878505,0.614007995941036,27.4485294117647
"3164597811.jpg",0,1,52,51,0,104,3.48076923076923,0.521029027213842,68.3357142857143
"3164921799.jpg",1,11,76,17,1,106,3.05660377358491,0.582771517414359,57.2767857142857
"3165807292.jpg",0,3,46,55,3,107,3.54205607476635,0.603142303553142,68.7934782608696
"316618516.jpg",6,82,39,1,0,128,2.2734375,0.557198331220545,33.740157480315
"3166870228.jpg",22,68,11,2,0,103,1.93203883495146,0.630314828312635,23.3928571428571
"3168536494.jpg",0,23,70,13,0,106,2.90566037735849,0.577816940640619,51.0546218487395
"3169607082.jpg",2,70,37,1,0,110,2.33636363636364,0.529449648952236,36.0448717948718
"3170684406.jpg",0,2,42,60,2,106,3.58490566037736,0.56682784029993,69.8424369747899
"3171148345.jpg",19,84,6,0,0,109,1.88073394495413,0.4659671471928,23.1848739495798
"3172797742.jpg",0,9,66,35,2,112,3.26785714285714,0.629344616307033,61.1970338983051
"3174536924.jpg",0,23,66,21,1,111,3,0.660578259075816,54.7648305084746
"3175529254.jpg",0,14,66,22,1,103,3.09708737864078,0.6185777980902,55.8738532110092
"3175555002.jpg",0,9,50,45,3,107,3.39252336448598,0.683456936377789,64.6326086956522
"3176625404.jpg",0,20,60,19,0,99,2.98989898989899,0.630758362720485,50.5
"3177560540.jpg",0,8,64,29,1,102,3.22549019607843,0.595475727034352,61.3
"3177839887.jpg",0,0,24,74,5,103,3.81553398058252,0.499952405882525,78.4410377358491
"3178336001.jpg",0,22,73,7,1,103,2.87378640776699,0.554475757536606,51.1570796460177
"3178679066.jpg",0,0,24,81,6,111,3.83783783783784,0.496177031100439,79.5172413793103
"3183550454.jpg",0,7,58,37,0,102,3.29411764705882,0.590154121405782,63.3509615384615
"3183852879.jpg",0,13,71,20,0,104,3.06730769230769,0.561973344855967,56.1486486486486
"3184407773.jpg",4,44,44,5,0,97,2.51546391752577,0.663221337831743,39.6816037735849
"3184831791.jpg",0,1,42,57,2,102,3.58823529411765,0.551378850843804,71.1621621621622
"318700026.jpg",0,1,38,66,6,111,3.69369369369369,0.584540111273077,73.781779661017
"3187135828.jpg",4,43,50,4,0,101,2.53465346534653,0.641316714824174,42.175
"3187350017.jpg",0,3,59,41,0,103,3.36893203883495,0.542150606058615,64.2008928571429
"3188292993.jpg",0,0,17,75,13,105,3.96190476190476,0.535720390685605,77.9256756756757
"3188930402.jpg",0,1,58,41,0,100,3.4,0.512470743190538,64.75
"3189407345.jpg",2,61,34,1,0,98,2.3469387755102,0.539225118268503,34.5945945945946
"3190025525.jpg",1,20,71,9,0,101,2.87128712871287,0.55970289148143,49.2477678571429
"3191275443.jpg",22,80,5,0,0,107,1.8411214953271,0.478786451595808,22.3241525423729
"3193120688.jpg",0,9,69,30,0,108,3.19444444444444,0.571247746200316,61.6334951456311
"3194036363.jpg",0,2,58,41,0,101,3.38613861386139,0.528588630783958,67.15
"3194726912.jpg",0,8,71,27,0,106,3.17924528301887,0.548542133838948,59.1959459459459
"3194756721.jpg",4,31,68,6,0,109,2.69724770642202,0.631057125370439,46.5847457627119
"3195516092.jpg",0,1,42,61,1,105,3.59047619047619,0.531602043450486,69.4092920353982
"319557469.jpg",0,9,70,27,0,106,3.16981132075472,0.560130904992541,59.3445945945946
"3197293330.jpg",0,3,62,40,0,105,3.35238095238095,0.536745040121693,65.878640776699
"3199733593.jpg",0,7,61,34,1,103,3.28155339805825,0.600938412037265,62.0654205607477
"3201560837.jpg",2,46,54,4,0,106,2.56603773584906,0.601883835090623,41.734375
"3201827278.jpg",0,9,57,39,0,105,3.28571428571429,0.615727926214882,63.7961165048544
"3202755866.jpg",0,1,18,81,6,106,3.86792452830189,0.499055712093935,75.1800847457627
"3204890107.jpg",13,69,18,0,0,100,2.05,0.557320429022713,27.3394495412844
"3206140446.jpg",0,14,59,29,0,102,3.14705882352941,0.635532969185214,61.6527777777778
"3206690420.jpg",0,17,63,23,0,103,3.05825242718447,0.623482356912612,56.6682242990654
"3206894685.jpg",0,9,73,14,0,96,3.05208333333333,0.489248439024305,56.9428571428571
"3207112247.jpg",0,14,63,27,1,105,3.14285714285714,0.641940738766369,58.1659292035398
"3207463467.jpg",0,2,42,54,3,101,3.57425742574257,0.5890082283545,72.4
"3207613793.jpg",4,65,38,0,0,107,2.31775700934579,0.542498253907659,34.3
"3207927028.jpg",6,76,28,3,0,113,2.24778761061947,0.590565308039186,33.0128205128205
"3207975884.jpg",1,62,46,0,0,109,2.41284403669725,0.51299789138098,38.1949152542373
"3208711501.jpg",0,0,44,59,3,106,3.61320754716981,0.544596918952884,73.4529702970297
"320987228.jpg",0,0,11,73,23,107,4.11214953271028,0.555030218516758,83.4306722689076
"3210385990.jpg",0,1,48,60,1,110,3.55454545454545,0.534778761361184,70.3846153846154
"3217227849.jpg",1,31,92,6,0,130,2.79230769230769,0.523792873528243,48.6666666666667
"322036819.jpg",5,64,36,1,0,106,2.31132075471698,0.575089352016914,36.2427184466019
"3220921320.jpg",1,8,62,34,1,106,3.24528301886792,0.644557001871267,61.6486486486486
"322245825.jpg",0,7,73,22,0,102,3.14705882352941,0.515061446368524,58.5229357798165
"3222932292.jpg",0,12,70,24,0,106,3.11320754716981,0.574385878540122,54.2304347826087
"3224295308.jpg",0,10,64,32,0,106,3.20754716981132,0.597087871527506,61.0334821428571
"3224700403.jpg",0,6,71,33,0,110,3.24545454545455,0.544974768145213,60.8125
"3225818665.jpg",51,53,3,0,0,107,1.55140186915888,0.553439414962658,13.2571428571429
"3225993642.jpg",0,24,68,7,1,100,2.85,0.575159178669767,49.1892523364486
"3226455393.jpg",0,0,25,67,9,101,3.84158415841584,0.560939805457354,78.1486486486486
"3228786952.jpg",1,31,62,6,0,100,2.73,0.583528106011228,46.7912844036697
"3228957282.jpg",0,1,61,63,0,125,3.496,0.517811773000638,69.5282258064516
"3230042702.jpg",0,10,70,22,1,103,3.13592233009709,0.578173996629761,57.6217948717949
"3230415578.jpg",2,35,60,6,0,103,2.67961165048544,0.613789135296507,44.777027027027
"3231616959.jpg",1,14,74,19,0,108,3.02777777777778,0.587380265521398,56.2894736842105
"3233213622.jpg",0,2,57,46,3,108,3.46296296296296,0.586864405455927,65.4747899159664
"3235296899.jpg",0,4,78,30,0,112,3.23214285714286,0.50192678941306,60.2881355932203
"323541643.jpg",30,75,15,1,0,121,1.89256198347107,0.629836657297774,23.55
"3238163707.jpg",0,9,101,27,0,137,3.13138686131387,0.497309204445389,60.125
"3241749396.jpg",0,8,80,18,0,106,3.09433962264151,0.488502120418315,58.5943396226415
"3241852622.jpg",1,17,66,15,4,103,3.03883495145631,0.712938273832897,53.827731092437
"3241859937.jpg",0,2,52,49,1,104,3.47115384615385,0.556632223656022,66.224358974359
"324220404.jpg",0,4,53,45,0,102,3.40196078431373,0.567429568562114,62.6100917431193
"324339500.jpg",5,56,64,1,0,126,2.48412698412698,0.589699950607113,40.9858870967742
"3243501762.jpg",3,55,45,2,0,105,2.43809523809524,0.587101903155359,37.3445945945946
"3243513416.jpg",1,17,55,26,2,101,3.10891089108911,0.733498331272947,55.0195652173913
"3244463289.jpg",0,11,78,17,0,106,3.05660377358491,0.513256432321075,57.5247524752475
"3245550884.jpg",0,23,71,8,0,102,2.85294117647059,0.533938455005121,48.0022935779817
"3247694646.jpg",1,14,54,35,1,105,3.2,0.712525303194425,62.8341584158416
"3247974707.jpg",0,12,66,22,0,100,3.1,0.577350269189626,59.575
"3248930020.jpg",0,9,69,21,1,100,3.14,0.568890467169528,56.3279816513761
"3248976854.jpg",0,2,32,72,5,111,3.72072072072072,0.57479120590431,73.8397435897436
"3250381402.jpg",13,59,28,2,0,102,2.18627450980392,0.670899974201386,31.4857142857143
"3250534214.jpg",7,36,55,6,0,104,2.57692307692308,0.706314208419796,41.7521551724138
"3251401307.jpg",1,17,69,14,0,101,2.95049504950495,0.589512300529215,55.3185840707965
"325203196.jpg",46,54,5,0,0,105,1.60952380952381,0.58004041794248,15.2241379310345
"3252078614.jpg",1,28,71,10,0,110,2.81818181818182,0.593262139900117,47.81875
"325223545.jpg",0,3,47,54,0,104,3.49038461538462,0.557302663192804,67.1434782608696
"325296963.jpg",3,36,53,7,0,99,2.64646464646465,0.659516386099157,44.5416666666667
"3253020934.jpg",0,3,36,66,0,105,3.6,0.547722557505166,69.8986486486486
"3253636665.jpg",0,0,25,80,7,112,3.83928571428571,0.512080572006508,77.79375
"3254432034.jpg",2,7,53,45,2,109,3.34862385321101,0.712015225453507,60.5525210084034
"3254444597.jpg",6,66,30,1,0,103,2.25242718446602,0.572549280385056,33.6826923076923
"3255665645.jpg",0,1,22,80,4,107,3.81308411214953,0.497746641649642,76.3
"3256723994.jpg",0,12,85,9,0,106,2.97169811320755,0.446308609219084,54.9933035714286
"3256967457.jpg",0,26,66,11,0,103,2.85436893203884,0.584233484589436,51.7411504424779
"3258713133.jpg",5,63,30,3,0,101,2.30693069306931,0.612251161818836,35.1353211009174
"3258938541.jpg",0,0,39,62,1,102,3.62745098039216,0.505838557336368,73.875
"3259283855.jpg",2,35,56,11,1,105,2.75238095238095,0.704121825955953,45.462389380531
"3259319485.jpg",0,3,55,67,3,128,3.546875,0.586721506324979,71.224
"3260332459.jpg",1,36,62,9,0,108,2.73148148148148,0.620618947630938,46.1323529411765
"3260477963.jpg",1,29,64,14,1,109,2.86238532110092,0.673133770045098,49.675
"3261123302.jpg",0,1,20,74,3,98,3.80612244897959,0.490280022350075,76.6880733944954
"3261304564.jpg",0,7,40,56,2,105,3.5047619047619,0.652271320431824,66.4054054054054
"3261536707.jpg",4,71,26,1,0,102,2.23529411764706,0.529832228036428,31.8663793103448
"326195053.jpg",0,31,60,17,0,108,2.87037037037037,0.656991053760519,50.9194915254237
"326299244.jpg",3,42,53,5,0,103,2.58252427184466,0.634378989907827,42.4671052631579
"3265420201.jpg",0,4,51,55,3,113,3.50442477876106,0.614176187572044,67.8319327731092
"3265568572.jpg",0,0,49,61,1,111,3.56756756756757,0.515604175552978,70.1025641025641
"3272637437.jpg",0,4,40,57,5,106,3.59433962264151,0.644068938735339,70.2410714285714
"3273769271.jpg",0,2,35,63,3,103,3.6504854368932,0.572383010806878,70.195945945946
"3274581285.jpg",1,5,47,47,4,104,3.46153846153846,0.69566029153948,68.0221238938053
"3275523745.jpg",0,7,74,23,1,105,3.17142857142857,0.545208902396822,57.5304347826087
"3277047132.jpg",0,3,45,54,4,106,3.55660377358491,0.618449500255742,70.2161016949153
"3277064835.jpg",0,45,64,0,0,109,2.58715596330275,0.494619366829498,43.1512605042017
"3277170769.jpg",0,6,75,20,1,102,3.15686274509804,0.521708883566678,57.9097222222222
"3277186380.jpg",1,16,87,16,0,120,2.98333333333333,0.549764400774135,54.2754237288136
"3281012528.jpg",0,4,62,43,0,109,3.35779816513761,0.553154853742444,62.7710084033613
"3281066235.jpg",0,0,32,62,6,100,3.74,0.561743318211757,73.0911214953271
"3282770938.jpg",0,2,55,51,0,108,3.4537037037037,0.536242713551076,69.2359813084112
"3284203868.jpg",0,1,37,63,2,103,3.64077669902913,0.539687072220866,70
"3285723816.jpg",4,66,39,2,0,111,2.35135135135135,0.582294031453474,35.8177966101695
"3285865052.jpg",0,33,63,10,0,106,2.78301886792453,0.601659878307022,49.3950892857143
"3288428899.jpg",8,64,29,4,0,105,2.27619047619048,0.657723903017621,33.4701834862385
"3289145933.jpg",0,18,62,25,0,105,3.06666666666667,0.639511031159244,58.3495145631068
"3290454927.jpg",0,43,60,4,0,107,2.63551401869159,0.556141073532199,43.7881355932203
"3292481650.jpg",0,0,46,60,4,110,3.61818181818182,0.558205154187778,73.1875
"3293762912.jpg",0,10,70,26,0,106,3.15094339622642,0.565558347462529,57.9180672268908
"3294786142.jpg",0,1,34,66,5,106,3.70754716981132,0.568489747481794,72.5233050847458
"3295126634.jpg",5,47,49,0,0,101,2.43564356435644,0.590183727057235,37.7087155963303
"3295438012.jpg",0,37,58,4,0,99,2.66666666666667,0.553283335172488,43.1991150442478
"3296835726.jpg",0,1,61,48,0,110,3.42727272727273,0.51507710136473,66.0337837837838
"3297887749.jpg",0,1,37,70,1,109,3.65137614678899,0.515969902743239,69.6089743589744
"33000255.jpg",91,14,1,0,0,106,1.15094339622642,0.385263121718099,4.70550847457627
"3301567767.jpg",1,32,67,12,0,112,2.80357142857143,0.627296296418721,47.5635593220339
"3301587792.jpg",4,36,58,7,0,105,2.64761904761905,0.664786726658552,43.4174528301887
"3302975736.jpg",0,12,69,27,1,109,3.15596330275229,0.611226937406405,57.745652173913
"3303080079.jpg",1,0,12,75,12,100,3.97,0.576562435842158,80.527027027027
"3303907744.jpg",0,0,22,68,11,101,3.89108910891089,0.563932444518134,80.1554054054054
"3304434529.jpg",0,0,43,60,2,105,3.60952380952381,0.527972138237027,70.609375
"3304676774.jpg",0,4,64,36,0,104,3.30769230769231,0.541069115641818,63.4642857142857
"3304800536.jpg",9,64,34,1,0,108,2.25,0.613325545121892,33.8601694915254
"3305619554.jpg",0,1,31,65,5,102,3.72549019607843,0.565630512031092,71.0871559633027
"3305968848.jpg",21,74,9,0,0,104,1.88461538461538,0.527085636410755,23.7064220183486
"3306813341.jpg",0,1,41,64,2,108,3.62037037037037,0.542021011983518,70.5460526315789
"3307215666.jpg",0,27,61,15,1,104,2.90384615384615,0.661261383174813,50.5705128205128
"3308046325.jpg",4,25,70,11,1,111,2.81981981981982,0.690167281411453,49.8486842105263
"3308341801.jpg",13,85,22,0,0,120,2.075,0.537071110888736,27.8474576271186
"3308768118.jpg",0,2,30,67,7,106,3.74528301886792,0.602555206002175,72.8728813559322
"3309384812.jpg",0,10,71,27,0,108,3.15740740740741,0.566379500873785,60.3421052631579
"3309773235.jpg",1,32,64,4,0,101,2.7029702970297,0.557576083695231,44.2178899082569
"3310204675.jpg",7,79,26,1,0,113,2.1858407079646,0.543610163732964,31.0882352941176
"3310575214.jpg",7,60,35,0,0,102,2.27450980392157,0.5828720754493,32.3348623853211
"3311728409.jpg",0,0,30,77,3,110,3.75454545454545,0.491885785884585,75.4615384615385
"3312331811.jpg",31,66,4,0,0,101,1.73267326732673,0.527088021281283,18.9601769911504
"331340631.jpg",5,24,55,23,3,110,2.95454545454545,0.850109152585375,51.4012605042017
"331406867.jpg",34,67,6,0,0,107,1.73831775700935,0.555189048171896,19.4411764705882
"3314110889.jpg",0,3,47,53,2,105,3.51428571428571,0.590213222786179,67.8102678571429
"3314904869.jpg",9,59,29,1,0,98,2.22448979591837,0.618121734997441,32.5619266055046
"3315237185.jpg",0,2,43,51,5,101,3.58415841584158,0.62076286507286,70.4375
"3315383233.jpg",27,63,10,0,0,100,1.83,0.586979943903925,21.2905405405405
"3317434594.jpg",3,57,50,3,0,113,2.46902654867257,0.598671094713965,40.6282051282051
"3320115265.jpg",0,2,31,68,1,102,3.66666666666667,0.532755462513791,72.925
"332288233.jpg",3,22,63,9,1,98,2.8265306122449,0.673894821921042,46.1194690265487
"3323033903.jpg",13,80,13,0,0,106,2,0.497613351528119,26.2702702702703
"3323937813.jpg",0,9,66,30,0,105,3.2,0.578459492631407,58.75
"3324248317.jpg",1,9,58,35,2,105,3.26666666666667,0.683130051063973,59.6418918918919
"3324496492.jpg",1,34,72,5,0,112,2.72321428571429,0.556854444704245,46.8333333333333
"3326988489.jpg",0,12,73,18,1,104,3.07692307692308,0.569317555905564,57.375
"332883741.jpg",1,26,75,8,0,110,2.81818181818182,0.561482607862829,48.8794642857143
"3329470769.jpg",0,19,71,21,0,111,3.01801801801802,0.602750996107649,55.5875
"3330470420.jpg",0,11,77,14,0,102,3.02941176470588,0.496639845060589,54.6628440366973
"3331414151.jpg",0,9,70,30,2,111,3.22522522522523,0.613257838176713,58.8898305084746
"333145920.jpg",0,2,57,52,0,111,3.45045045045045,0.534938207794962,65.0423728813559
"3332423009.jpg",0,18,77,7,0,102,2.8921568627451,0.485571272110461,50.2828947368421
"3332902834.jpg",0,10,53,48,1,112,3.35714285714286,0.655635897322919,63.8974358974359
"3333985138.jpg",9,63,28,4,0,104,2.25961538461538,0.668212981390574,35.6820388349515
"3335618194.jpg",0,0,32,73,0,105,3.6952380952381,0.462514231045288,75.4101941747573
"3338894282.jpg",0,4,67,35,0,106,3.29245283018868,0.533933848802149,63.7311320754717
"3340734956.jpg",0,5,62,37,1,105,3.32380952380952,0.58004041794248,63.7995689655172
"3341085556.jpg",25,68,7,0,0,100,1.82,0.538985204347068,20.6032110091743
"3342346685.jpg",0,40,57,8,0,105,2.6952380952381,0.606436779693949,44.5132743362832
"3343738489.jpg",0,0,29,73,5,107,3.77570093457944,0.519586396014798,76.228813559322
"3344016385.jpg",0,10,66,25,0,101,3.14851485148515,0.572470761067522,57.85
"3346416285.jpg",1,7,69,21,1,99,3.14141414141414,0.589190053016418,57.2362385321101
"3347228837.jpg",0,5,40,46,4,95,3.51578947368421,0.66625593917335,70.7714285714286
"3347823880.jpg",0,8,49,50,1,108,3.40740740740741,0.641799995588299,67
"3350005307.jpg",55,51,4,1,0,111,1.55855855855856,0.613257838176714,14.8655462184874
"3351610329.jpg",0,1,61,43,1,106,3.41509433962264,0.532164037157572,65.8950892857143
"3351620207.jpg",0,12,49,45,0,106,3.31132075471698,0.667093304635078,63.5096153846154
"3352596853.jpg",13,65,29,0,1,108,2.17592592592593,0.667380199669086,31.6428571428571
"3355200103.jpg",0,1,51,82,4,138,3.64492753623188,0.55105373031019,75.3645833333333
"3355209894.jpg",0,9,64,33,0,106,3.22641509433962,0.590125392130061,59.8260869565217
"3355464174.jpg",0,4,67,34,0,105,3.28571428571429,0.531946456861058,60.3282608695652
"3355714233.jpg",0,10,74,27,0,111,3.15315315315315,0.55919094475368,58.8898305084746
"3356044640.jpg",0,5,65,40,0,110,3.31818181818182,0.557382779577142,62.05
"3356844198.jpg",0,3,77,27,1,108,3.24074074074074,0.509175077217316,61.6617647058824
"3357164852.jpg",0,21,70,12,0,103,2.9126213592233,0.561978230624793,51.6785714285714
"3358149726.jpg",0,27,63,14,0,104,2.875,0.618289215010304,50.7152173913043
"3358523670.jpg",0,3,56,65,1,125,3.512,0.562482974652739,70.8545081967213
"3358682007.jpg",0,1,51,51,0,103,3.48543689320388,0.521387245906701,66.777027027027
"3358754066.jpg",3,48,52,3,0,106,2.5188679245283,0.605233242335575,40.7434782608696
"3359889192.jpg",0,2,44,54,0,100,3.52,0.54085603678359,69.0435779816514
"336052627.jpg",2,43,54,6,0,105,2.60952380952381,0.627805060619293,42.6216216216216
"3361988100.jpg",0,3,48,57,0,108,3.5,0.555347832401704,69.578125
"3362731032.jpg",0,0,25,75,6,106,3.82075471698113,0.512643379457248,76.69375
"3364202369.jpg",0,0,32,73,1,106,3.70754716981132,0.477433239054235,76.1839622641509
"3364722083.jpg",1,31,63,7,0,102,2.74509803921569,0.591796635357012,44.5334821428571
"3364868711.jpg",16,73,13,1,0,103,1.99029126213592,0.568712781692267,26.5675675675676
"3365417061.jpg",0,25,64,14,1,104,2.91346153846154,0.64024535532185,51.4326086956522
"3365447434.jpg",25,95,13,0,0,133,1.90977443609023,0.528844460958976,22.4375
"3365471102.jpg",5,65,34,1,0,105,2.2952380952381,0.570489154548862,33.1081081081081
"3366831652.jpg",0,7,55,46,2,110,3.39090909090909,0.636726930732686,62.2857142857143
"3367044769.jpg",0,0,25,84,4,113,3.8141592920354,0.473374522640592,76.5672268907563
"3367220434.jpg",0,1,40,59,2,102,3.6078431372549,0.54784659891482,69.5044642857143
"3367803108.jpg",0,2,61,36,0,99,3.34343434343434,0.518270596755743,66.9221698113208
"3368873733.jpg",0,9,62,35,1,107,3.26168224299065,0.619440535744331,61.1071428571429
"3369391628.jpg",0,7,37,58,7,109,3.59633027522936,0.708666798043338,70.3
"3370673214.jpg",0,4,59,41,0,104,3.35576923076923,0.555960975629318,63.3581081081081
"3370823326.jpg",0,23,61,22,0,106,2.99056603773585,0.654585045132999,56.5401785714286
"3371032149.jpg",0,13,50,41,0,104,3.26923076923077,0.671627052526057,64.6544117647059
"3371856854.jpg",1,2,67,41,0,111,3.33333333333333,0.56138357221379,64.2733050847458
"3372381586.jpg",4,61,41,0,0,106,2.34905660377358,0.552784343210652,35.3258928571429
"3372418412.jpg",0,3,56,43,0,102,3.3921568627451,0.54784659891482,65.125
"3376034906.jpg",6,69,34,0,0,109,2.25688073394495,0.55115484355109,33.3760504201681
"3376076568.jpg",0,10,79,21,1,111,3.11711711711712,0.551670829698929,56.9625
"3376669178.jpg",0,19,73,11,0,103,2.92233009708738,0.536680435611023,50.5771028037383
"3377992408.jpg",0,1,51,48,2,102,3.5,0.558463237929599,71.3805309734513
"3378003631.jpg",0,3,62,32,0,97,3.29896907216495,0.523707704211206,63.1129807692308
"3379476157.jpg",1,6,51,45,3,106,3.40566037735849,0.686999021095753,62.4555084745763
"3381345467.jpg",2,39,60,6,0,107,2.65420560747664,0.615871889066098,46.6305309734513
"3381533789.jpg",14,60,28,0,0,102,2.13725490196078,0.62993345061479,30.2641509433962
"3383452055.jpg",0,6,69,34,2,111,3.28828828828829,0.593715380041609,63.364406779661
"3383593963.jpg",0,19,71,14,0,104,2.95192307692308,0.563963224241827,53.9013157894737
"3383701765.jpg",0,2,60,43,1,106,3.40566037735849,0.548214450336683,65.6621621621622
"3385195104.jpg",0,1,48,55,2,106,3.54716981132075,0.554326283006989,70.0063559322034
"3385580051.jpg",4,48,47,6,1,106,2.54716981132075,0.705516703210162,39.4533898305085
"3385696346.jpg",0,8,59,31,2,100,3.27,0.633333333333333,58.4579646017699
"3385987418.jpg",0,3,50,52,3,108,3.50925925925926,0.603655072185389,70.0394736842105
"3386943260.jpg",2,33,69,4,0,108,2.69444444444444,0.571247746200316,46.6644736842105
"3386957170.jpg",0,3,42,63,2,110,3.58181818181818,0.58075904431726,69.8947368421053
"3388691081.jpg",1,14,65,27,1,108,3.12037037037037,0.665822414546109,55.2836134453782
"3388708914.jpg",0,1,44,51,6,102,3.6078431372549,0.615908935423586,69.325
"3388712525.jpg",0,32,67,11,0,110,2.80909090909091,0.598092603450267,48.1216216216216
"338924292.jpg",7,70,29,0,0,106,2.20754716981132,0.547148123621374,32.3179611650485
"3390605400.jpg",14,70,16,0,0,100,2.02,0.550114772230543,25.0688073394495
"3390896088.jpg",0,3,48,51,0,102,3.47058823529412,0.55768052803139,67.9575892857143
"3391217731.jpg",3,64,29,4,0,100,2.34,0.606696635956396,34.9252336448598
"3394722862.jpg",1,25,65,9,0,100,2.82,0.592546294487706,50.1215596330275
"3395475764.jpg",0,9,90,34,0,133,3.18796992481203,0.538662427880247,60.6305147058824
"3396059055.jpg",1,43,51,4,1,100,2.61,0.633970970880522,42.5369565217391
"3398709851.jpg",0,53,49,5,0,107,2.55140186915888,0.586541588543228,42.59375
"3398940973.jpg",0,11,66,31,0,108,3.18518518518519,0.598255222443013,59.4800884955752
"3398954278.jpg",0,2,56,46,1,105,3.43809523809524,0.553377905438143,66.8577586206897
"3401900404.jpg",0,1,30,68,5,104,3.74038461538462,0.557302663192804,74.8080357142857
"3403374656.jpg",0,10,67,26,1,104,3.17307692307692,0.598417130425389,58.8973214285714
"3405525198.jpg",7,65,39,1,0,112,2.30357142857143,0.597883439697578,34.2115384615385
"3411974393.jpg",1,27,68,15,0,111,2.87387387387387,0.634136737722553,50.5
"3412359483.jpg",0,1,47,60,3,111,3.58558558558559,0.563567669058932,67.9545454545455
"341491962.jpg",1,7,76,19,1,104,3.11538461538462,0.562720374224038,58.1810344827586
"3416685588.jpg",20,65,21,1,0,107,2.02803738317757,0.650949146279603,27.2232142857143
"3416752031.jpg",0,3,52,52,1,108,3.47222222222222,0.571247746200316,68.533185840708
"3417613077.jpg",2,29,61,14,0,106,2.82075471698113,0.673260295114407,49.8592233009709
"3417674715.jpg",0,22,69,17,0,108,2.9537037037037,0.601932390702485,52.1644736842105
"3418463077.jpg",0,2,21,75,8,106,3.83962264150943,0.571327484320177,75.9736842105263
"3418667339.jpg",0,5,70,34,0,109,3.26605504587156,0.538210371833639,61.8004201680672
"3420154563.jpg",1,20,74,16,0,111,2.94594594594595,0.600573026940072,52.7372881355932
"3421464878.jpg",0,2,54,44,1,101,3.43564356435644,0.555262849183311,63.5940366972477
"342221498.jpg",24,45,29,8,1,107,2.22429906542056,0.914334598914808,32.3361344537815
"3423724895.jpg",0,3,27,63,14,107,3.82242990654206,0.684230515500766,73.80625
"3423896683.jpg",0,1,44,60,0,105,3.56190476190476,0.517460692000434,68.7837837837838
"3423975366.jpg",0,2,50,54,1,107,3.50467289719626,0.555823912928399,67.9012605042017
"3424993568.jpg",0,0,18,79,14,111,3.96396396396396,0.538143744364542,78.0466101694915
"3426740196.jpg",22,67,16,2,0,107,1.98130841121495,0.658490389196709,25.0263157894737
"3427902428.jpg",0,0,35,66,8,109,3.75229357798165,0.579846137042889,71.2983193277311
"3427902514.jpg",0,1,43,55,1,100,3.56,0.53785958138991,69.3130841121495
"3431105203.jpg",0,2,62,42,2,108,3.40740740740741,0.564313113804657,65.8114406779661
"3431390099.jpg",4,50,45,1,0,100,2.43,0.590411600991934,36.5553097345133
"3433315492.jpg",1,29,63,16,0,109,2.86238532110092,0.659234824517492,49.6238938053097
"3434261812.jpg",0,30,68,7,0,105,2.78095238095238,0.554369919210997,47.3325892857143
"3435545140.jpg",0,32,65,9,0,106,2.78301886792453,0.585616760447309,46.6546610169492
"3437594883.jpg",10,59,38,0,0,107,2.26168224299065,0.619440535744331,34.7690677966102
"3438059129.jpg",4,66,35,2,0,107,2.32710280373832,0.579129159748765,35.2222222222222
"3439365851.jpg",0,0,33,75,2,110,3.71818181818182,0.49086738771988,71.2289915966387
"3440235836.jpg",3,54,49,0,0,106,2.43396226415094,0.552377854190896,37.2282608695652
"3442838312.jpg",0,17,77,15,1,110,3,0.574695771132691,54.445652173913
"3443268586.jpg",0,2,39,60,2,103,3.60194174757282,0.566028576588288,72.7115384615385
"344443695.jpg",1,33,91,14,0,139,2.84892086330935,0.588706135505532,51.291095890411
"3444483519.jpg",0,2,56,47,3,108,3.47222222222222,0.587380265521398,66.1680672268908
"3446054675.jpg",0,33,67,6,0,106,2.74528301886792,0.553109319337024,47.6304347826087
"344636344.jpg",0,1,51,54,0,106,3.5,0.520988072251728,69.1361607142857
"3446366493.jpg",1,3,47,54,1,106,3.4811320754717,0.620769600315327,67.231308411215
"3448332578.jpg",0,12,77,16,0,105,3.03809523809524,0.517460692000434,54.5154867256637
"3449919327.jpg",0,2,55,44,6,107,3.50467289719626,0.635043183432864,67.9705882352941
"3450351361.jpg",0,0,16,81,6,103,3.90291262135922,0.454057159457734,82.3318584070797
"3450753884.jpg",0,1,50,50,4,105,3.54285714285714,0.588815163445454,69.2632743362832
"3452963187.jpg",21,71,20,0,0,112,1.99107142857143,0.607691477469391,25.3040540540541
"3455219027.jpg",4,71,27,0,0,102,2.22549019607843,0.505550630992575,30.7
"3455882031.jpg",3,45,57,2,0,107,2.54205607476635,0.587292698581456,42.1782608695652
"3456840631.jpg",0,0,39,97,2,138,3.73188405797101,0.476297384139528,76.8214285714286
"3458045907.jpg",0,12,59,32,1,104,3.21153846153846,0.648719080271491,60.5178571428571
"3458950384.jpg",0,2,48,102,4,156,3.69230769230769,0.540195718598417,75.4066455696203
"3461062752.jpg",3,35,64,6,0,108,2.67592592592593,0.623956380330556,44.5540540540541
"3462395913.jpg",0,29,72,5,0,106,2.77358490566038,0.521591317264946,49.5424107142857
"3463146453.jpg",0,1,47,51,3,102,3.54901960784314,0.573808726891872,68.6805555555556
"3463376543.jpg",1,18,55,24,1,99,3.06060606060606,0.711683571886767,56.3055555555556
"3464327257.jpg",1,30,60,12,0,103,2.80582524271845,0.642578330117777,48.9579439252336
"3464988666.jpg",45,54,3,0,0,102,1.58823529411765,0.551378850843804,15.325
"3465087333.jpg",3,63,37,1,0,104,2.34615384615385,0.553352198616052,35.8491379310345
"3465276119.jpg",0,2,56,45,5,108,3.49074074074074,0.618943482848146,68.1186440677966
"346617303.jpg",4,71,30,0,0,105,2.24761904761905,0.514799295860353,32.5267857142857
"346617779.jpg",19,75,5,0,0,99,1.85858585858586,0.474021032214451,21.9144736842105
"3466610103.jpg",0,2,39,61,4,106,3.63207547169811,0.590810124975516,70.3559322033898
"3467784087.jpg",0,0,54,52,0,106,3.49056603773585,0.502285879874493,69.925
"3468424403.jpg",0,18,75,17,0,110,2.99090909090909,0.566584075487033,54.3453389830508
"3469092597.jpg",0,4,49,54,0,107,3.46728971962617,0.571620619162577,68.1148648648649
"3469199125.jpg",3,25,60,18,0,106,2.87735849056604,0.713179736761515,49.8125
"34713269.jpg",12,55,31,4,0,102,2.26470588235294,0.716516194647949,34
"347162205.jpg",6,95,34,0,0,135,2.20740740740741,0.505142159631581,31.5425531914894
"3471704982.jpg",0,5,48,55,1,109,3.47706422018349,0.602407673504281,65.55625
"3471964559.jpg",0,1,28,75,6,110,3.78181818181818,0.548255250635938,72.8235294117647
"3472660238.jpg",0,1,39,63,2,105,3.62857142857143,0.541670188774122,70.5869565217391
"3475569667.jpg",3,76,46,1,0,126,2.35714285714286,0.543533413350616,35.7023809523809
"3475877294.jpg",7,90,14,0,0,111,2.06306306306306,0.432314685033931,29.3156779661017
"34796696.jpg",0,11,41,47,5,104,3.44230769230769,0.748161800123178,66.1538461538462
"3479727829.jpg",21,80,8,0,0,109,1.88073394495413,0.504145236315919,22.8296460176991
"348162485.jpg",12,83,12,0,0,107,2,0.475830951430886,26.3046218487395
"3482375790.jpg",0,3,64,34,0,101,3.30693069306931,0.524262801606708,62.05
"3483143101.jpg",87,20,1,0,0,108,1.2037037037037,0.427101932705454,6.0609243697479
"3483457230.jpg",0,16,76,14,0,106,2.9811320754717,0.534186200379279,55.0069444444444
"3483459470.jpg",5,65,34,0,0,104,2.27884615384615,0.547841851767616,33.9175
"3483540691.jpg",2,23,69,6,0,100,2.79,0.573752489486468,46.1891891891892
"3484057115.jpg",0,15,82,10,0,107,2.95327102803738,0.483368244522832,54.3915094339623
"3485554199.jpg",1,19,73,7,0,100,2.86,0.532195756495975,50.3457943925234
"3486204187.jpg",0,10,77,16,0,103,3.05825242718447,0.501473177169549,58.4444444444444
"3487085790.jpg",0,2,42,59,1,104,3.56730769230769,0.553267839716467,69.0442477876106
"3487701269.jpg",0,6,45,52,3,106,3.49056603773585,0.650937536596151,69.5631067961165
"3489731995.jpg",0,4,51,57,1,113,3.48672566371681,0.584243165003537,66.0043103448276
"3490117565.jpg",0,1,49,58,2,110,3.55454545454545,0.551667424682855,67.55
"3490456545.jpg",9,44,52,3,0,108,2.4537037037037,0.688819378129774,38.9639830508475
"3491336743.jpg",7,49,44,5,0,105,2.44761904761905,0.693111051998834,37.2688679245283
"3491534419.jpg",0,7,59,36,0,102,3.2843137254902,0.586607142989058,63.4
"3492624391.jpg",9,63,33,3,0,108,2.27777777777778,0.653292642893341,33.5540540540541
"3494126077.jpg",0,0,26,81,3,110,3.79090909090909,0.47109971957979,75.5394736842105
"3494272101.jpg",0,1,52,54,3,110,3.53636363636364,0.569520524672599,69.8448275862069
"3494678423.jpg",0,32,62,11,0,105,2.8,0.610800231726317,48.2214285714286
"3496521334.jpg",0,0,29,72,4,105,3.76190476190476,0.509973783711732,78.2936893203884
"3497202348.jpg",0,12,68,22,2,104,3.13461538461538,0.624075118513327,55.5540540540541
"349896134.jpg",2,73,54,0,0,129,2.4031007751938,0.523201978281351,38.705078125
"3499629801.jpg",0,7,58,41,0,106,3.32075471698113,0.594373136150632,63.4324324324324
"35002160.jpg",0,7,38,57,4,106,3.54716981132075,0.677981253732946,68.468220338983
"3501996576.jpg",0,0,46,58,0,104,3.55769230769231,0.499065594399243,69.75
"3502153355.jpg",0,5,56,47,1,109,3.40366972477064,0.595029816480527,63.8606194690265
"3503300231.jpg",0,0,17,83,8,108,3.91666666666667,0.476062510620918,76.41875
"3505262206.jpg",0,25,69,9,0,103,2.84466019417476,0.55584737560646,50.4269911504425
"3505627590.jpg",2,56,44,4,0,106,2.47169811320755,0.604862001889472,40.703125
"3510063780.jpg",5,31,58,11,0,105,2.71428571428571,0.716753977133203,46.0521739130435
"3511207085.jpg",0,1,43,66,0,110,3.59090909090909,0.512154193837384,70.8782051282051
"3515651386.jpg",0,6,81,39,0,126,3.26190476190476,0.539311730687497,63.8023255813954
"3515663938.jpg",0,0,40,64,1,105,3.62857142857143,0.504920840276033,73.4821428571429
"3518265762.jpg",0,1,33,67,2,103,3.67961165048544,0.527918447226235,73.7712264150943
"3518866605.jpg",0,9,91,25,1,126,3.14285714285714,0.532380100518954,60.7621951219512
"3519364135.jpg",3,51,44,3,0,101,2.46534653465347,0.609333347776791,37.2545871559633
"351997474.jpg",0,25,66,12,0,103,2.87378640776699,0.588777591260319,50.6586538461538
"3522690935.jpg",0,36,72,3,0,111,2.7027027027027,0.515127426328928,47.1153846153846
"352331466.jpg",4,65,53,6,0,128,2.4765625,0.639449120075518,38.3125
"3524216401.jpg",0,2,35,62,1,100,3.62,0.546430104025994,75.6391509433962
"3524447745.jpg",0,12,58,37,0,107,3.23364485981308,0.638090300174011,61.2027027027027
"3525647615.jpg",1,21,70,14,0,106,2.91509433962264,0.603449205315764,52.4151785714286
"352602458.jpg",12,70,24,0,0,106,2.11320754716981,0.574385878540122,29.5521739130435
"3526523265.jpg",0,5,74,29,0,108,3.22222222222222,0.517602910140264,60.2565217391304
"352744670.jpg",48,51,7,0,0,106,1.61320754716981,0.610554076494007,14.3783783783784
"3530486052.jpg",0,0,17,79,9,105,3.92380952380952,0.494104436469856,77.6474358974359
"3530563948.jpg",0,16,81,10,0,107,2.94392523364486,0.492045704675218,53.2978260869565
"35311267.jpg",12,79,15,1,0,107,2.04672897196262,0.538747281569002,26.9978991596639
"3532282772.jpg",0,13,56,43,1,113,3.28318584070796,0.674391611389117,60.385775862069
"353228664.jpg",1,1,57,46,2,107,3.4392523364486,0.601532164692449,66.0508849557522
"3532374814.jpg",0,3,46,54,0,103,3.49514563106796,0.557898479902737,68.8245192307692
"3533949779.jpg",0,5,61,36,1,103,3.32038834951456,0.580965933883841,63.641592920354
"3534610078.jpg",0,0,28,74,2,104,3.75,0.477656089467962,76.7101769911504
"3535978712.jpg",0,3,50,47,1,101,3.45544554455446,0.574886988463777,66.3060747663551
"3536025260.jpg",3,80,20,1,0,104,2.18269230769231,0.477949160007531,30.6116071428571
"3537044665.jpg",7,65,32,0,0,104,2.24038461538462,0.56594610720975,34.2796610169492
"3537245055.jpg",0,15,86,32,0,133,3.12781954887218,0.582751231224555,59
"3537658496.jpg",0,3,34,100,4,141,3.74468085106383,0.539897547412588,78.3158783783784
"3538380259.jpg",1,25,81,4,0,111,2.79279279279279,0.506630887999199,48.4189189189189
"3539454254.jpg",0,4,75,32,0,111,3.25225225225225,0.512896737231836,61.2669491525424
"3541249074.jpg",0,1,48,55,2,106,3.54716981132075,0.554326283006989,70.2839805825243
"354153075.jpg",1,52,51,3,0,107,2.52336448598131,0.572083157837716,41.575
"3542002438.jpg",0,31,72,8,0,111,2.79279279279279,0.557871231755422,47.0336134453782
"3545028223.jpg",0,9,71,26,1,107,3.17757009345794,0.579737808534454,58.4004237288136
"3545446713.jpg",0,3,71,34,1,109,3.30275229357798,0.535837647398623,61.4513274336283
"3545702131.jpg",1,27,61,8,0,97,2.78350515463918,0.599075748613912,46.9757281553398
"3547062481.jpg",0,3,85,37,1,126,3.28571428571429,0.519340240800081,64.0535714285714
"3547073718.jpg",0,0,21,83,5,109,3.85321100917431,0.467968186505642,77.2942477876106
"3548223665.jpg",2,44,59,4,0,109,2.59633027522936,0.595029816480527,42.9070796460177
"354899371.jpg",0,8,70,27,0,105,3.18095238095238,0.550890055709715,59.2702702702703
"3549424661.jpg",5,49,46,9,0,109,2.54128440366972,0.714040538476518,41.0125
"3551648026.jpg",0,16,66,25,0,107,3.08411214953271,0.616158141412052,56.5202702702703
"3552766173.jpg",0,0,30,66,5,101,3.75247524752475,0.536766999620122,72.3086956521739
"3552877026.jpg",0,0,50,61,1,112,3.5625,0.51607056574545,67.2796610169491
"3555094283.jpg",0,18,62,27,3,110,3.13636363636364,0.710049393904974,55.93125
"3556213355.jpg",0,1,22,78,5,106,3.82075471698113,0.512643379457248,75.6118421052632
"3558351395.jpg",31,60,11,0,0,102,1.80392156862745,0.614014797871709,20.3947368421053
"3560022258.jpg",0,53,44,2,0,99,2.48484848484848,0.541419833394177,38.7683486238532
"3560032600.jpg",0,5,51,46,0,102,3.40196078431373,0.584618076590697,66.2995283018868
"3561351919.jpg",0,11,62,33,1,107,3.22429906542056,0.634070575426553,60.5525210084034
"3561898679.jpg",0,3,44,59,0,106,3.52830188679245,0.555621439639331,68.4864864864865
"3562407133.jpg",0,0,23,71,11,105,3.88571428571429,0.560121650836909,78.1703539823009
"3563134047.jpg",0,5,44,54,2,105,3.5047619047619,0.622090296497492,70.0353773584906
"356523006.jpg",0,3,67,36,3,109,3.35779816513761,0.585676812974409,64.3986486486486
"3566079728.jpg",0,3,57,44,1,105,3.40952380952381,0.566623570867177,63.1351351351351
"3566137302.jpg",0,8,62,33,0,103,3.24271844660194,0.585210192127677,62.3175675675676
"3566227002.jpg",1,4,46,43,3,97,3.44329896907217,0.676527163857022,68.8422330097087
"3566285762.jpg",0,4,54,41,1,100,3.39,0.584220105194208,67.3084112149533
"3567613299.jpg",0,1,56,52,3,112,3.50892857142857,0.569424171197436,67.89375
"3567892894.jpg",0,1,56,45,0,102,3.43137254901961,0.517224196779339,65.2219827586207
"3569097033.jpg",0,21,74,10,0,105,2.8952380952381,0.535720390685605,52.5420792079208
"3569259520.jpg",0,7,76,27,0,110,3.18181818181818,0.52779301930399,59.4932432432432
"3572950777.jpg",0,2,29,61,11,103,3.78640776699029,0.651551473248295,76.7428571428571
"3574423584.jpg",0,7,71,31,0,109,3.22018348623853,0.55038367367073,61.8163716814159
"357452255.jpg",12,75,17,0,0,104,2.04807692307692,0.528412307616814,26.3340707964602
"3575258454.jpg",0,4,59,32,1,96,3.3125,0.567774973957669,64.0142857142857
"3576199867.jpg",1,0,34,60,5,100,3.68,0.617587355290036,73.9
"357641600.jpg",26,81,2,0,0,109,1.77981651376147,0.458617046838314,21.313025210084
"3576734927.jpg",0,5,61,40,2,108,3.36111111111111,0.60308139177812,63.2433035714286
"3576771116.jpg",0,18,73,12,0,103,2.94174757281553,0.539157707628326,52.9977064220183
"3577464388.jpg",0,1,57,49,0,107,3.44859813084112,0.518227109458397,67.6629464285714
"3577744786.jpg",15,74,13,1,0,103,2,0.560112033611204,27.0526315789474
"3579701723.jpg",23,78,8,0,0,109,1.86238532110092,0.517613646641916,22.1449579831933
"3581381105.jpg",0,0,29,77,2,108,3.75,0.476062510620918,75.3199152542373
"358360301.jpg",0,2,59,45,1,107,3.42056074766355,0.550083753101153,66.853982300885
"358433606.jpg",18,66,24,0,0,108,2.05555555555556,0.624025720374147,27.0607476635514
"358438532.jpg",5,63,35,1,0,104,2.30769230769231,0.575839161014367,35.0117924528302
"3585032307.jpg",2,24,62,6,1,95,2.78947368421053,0.634047062521073,48.4571428571429
"3585744087.jpg",16,68,20,3,0,107,2.09345794392523,0.666343306049132,29.3550420168067
"3586744131.jpg",0,0,28,66,7,101,3.79207920792079,0.553476859194101,73.7247899159664
"3586827526.jpg",0,0,43,58,1,102,3.58823529411765,0.514212676586054,70.225
"3587076357.jpg",1,5,58,41,0,105,3.32380952380952,0.612297660381309,62.9108695652174
"3587337138.jpg",1,33,53,11,0,98,2.75510204081633,0.658978035548984,44.5862831858407
"3588199753.jpg",0,1,45,57,6,109,3.62385321100917,0.605361704329154,69.81875
"3589240869.jpg",2,7,32,54,5,100,3.53,0.784380344764277,68.8922018348624
"3591617396.jpg",3,50,48,3,0,104,2.49038461538462,0.607320908240659,39.6673913043478
"3592827455.jpg",0,8,57,36,0,101,3.27722772277228,0.601976941106354,64.5094339622642
"3593791366.jpg",0,0,29,69,5,103,3.76699029126214,0.527738116410649,76.2523364485981
"3595766183.jpg",0,0,40,65,1,106,3.63207547169811,0.503804037831665,71.640625
"3596611917.jpg",0,15,82,12,0,109,2.97247706422018,0.499234888610678,54.4152542372881
"3596718064.jpg",0,1,47,81,0,129,3.62015503875969,0.503018986495732,74.6958955223881
"3597095413.jpg",0,0,32,68,3,103,3.71844660194175,0.512920811993036,76.0588235294118
"3597199001.jpg",0,1,40,67,1,109,3.62385321100917,0.523326093822681,71.3347457627119
"359723983.jpg",0,2,37,58,8,105,3.68571428571429,0.640226608233452,72.0934782608696
"3597613662.jpg",0,0,46,52,2,100,3.56,0.53785958138991,69.6490825688073
"3599779537.jpg",0,6,56,44,0,106,3.35849056603774,0.588600911691008,61.6165254237288
"3600948934.jpg",1,41,60,2,0,104,2.60576923076923,0.547159819941693,42.6183035714286
"3601117533.jpg",0,2,60,47,1,110,3.42727272727273,0.549546784229254,65.625
"3601352242.jpg",0,4,57,48,1,110,3.41818181818182,0.58075904431726,66.9294871794872
"3603046487.jpg",0,27,72,10,0,109,2.84403669724771,0.563952846837089,49.3717948717949
"3603762742.jpg",0,15,64,24,0,103,3.0873786407767,0.6120809269271,54.109375
"3604508101.jpg",0,1,75,31,0,107,3.2803738317757,0.471736905475933,63.55
"3606644176.jpg",0,8,51,50,4,113,3.44247787610619,0.680572934809671,67.275
"3606669688.jpg",0,12,42,41,3,98,3.35714285714286,0.735688190337497,60.283185840708
"3608137140.jpg",0,1,39,55,10,105,3.7047619047619,0.649316349410456,70.4932432432432
"3608691305.jpg",0,7,76,23,0,106,3.15094339622642,0.512555740619193,59.8549107142857
"3609473273.jpg",0,0,21,74,10,105,3.8952380952381,0.535720390685605,77.4358974358974
"3609983548.jpg",0,6,64,36,0,106,3.28301886792453,0.564922531244132,62.6148648648649
"361037189.jpg",0,0,8,108,10,126,4.01587301587302,0.379138538988101,86.0487804878049
"3611703355.jpg",0,0,8,86,15,109,4.06422018348624,0.456946981238446,79.5125
"3612122165.jpg",0,8,61,34,0,103,3.25242718446602,0.589423889579224,63.2285714285714
"3612174577.jpg",9,60,32,1,0,102,2.24509803921569,0.620384334881543,34.2334905660377
"361252644.jpg",1,44,56,6,0,107,2.62616822429907,0.606931106189182,43.6621621621622
"3613844312.jpg",0,0,15,80,9,104,3.94230769230769,0.479217061241473,78
"3615125120.jpg",0,2,48,60,1,111,3.54054054054054,0.552412622194411,67.6991525423729
"3615267731.jpg",0,1,45,58,0,104,3.54807692307692,0.5191443238415,70.358407079646
"3615562.jpg",15,82,8,1,0,106,1.95283018867925,0.504872930202633,24.3516949152542
"3616806128.jpg",0,2,56,43,0,101,3.40594059405941,0.53250761162226,63.3669724770642
"3618474326.jpg",0,7,40,55,1,103,3.48543689320388,0.639608913442393,69.0810810810811
"3618795157.jpg",1,2,14,70,18,105,3.97142857142857,0.685805854691888,83.3443396226415
"3619220193.jpg",1,13,65,25,1,105,3.11428571428571,0.655073186079906,56.3716216216216
"3619609860.jpg",0,1,30,100,9,140,3.83571428571429,0.531195398016198,81.4375
"362016009.jpg",0,31,64,8,0,103,2.77669902912621,0.576195072410062,48.25
"3620678223.jpg",0,10,66,27,0,103,3.16504854368932,0.578996552169639,59.204128440367
"3620726.jpg",19,79,9,0,0,107,1.90654205607477,0.505306002570194,24.2247899159664
"362290262.jpg",1,2,29,66,2,100,3.66,0.606696635956396,72.4256756756757
"3625351305.jpg",0,3,56,41,2,102,3.41176470588235,0.586193310737911,64.825
"3628043.jpg",1,5,42,45,16,109,3.64220183486239,0.822405412548577,70.75
"3628605791.jpg",0,31,62,20,0,113,2.90265486725664,0.66767990847186,52.9957983193277
"3629779382.jpg",0,0,55,47,2,104,3.49038461538462,0.539600576976746,70.8823529411765
"3630233855.jpg",2,17,51,34,1,105,3.14285714285714,0.764960675567598,59.9632352941176
"3632417985.jpg",85,15,2,0,0,102,1.18627450980392,0.438954476921199,4.16741071428571
"363482906.jpg",0,1,53,56,0,110,3.5,0.520232834252955,68.5381355932203
"3635405613.jpg",0,21,75,12,0,108,2.91666666666667,0.549000791583107,52.0608108108108
"3636701462.jpg",0,0,30,71,3,104,3.74038461538462,0.502328409725477,77.3325242718447
"3637251050.jpg",3,24,68,12,1,108,2.85185185185185,0.681049421331231,49.0619266055046
"3638870308.jpg",0,9,78,16,0,103,3.06796116504854,0.490340736317866,56.1285046728972
"3639490630.jpg",1,38,63,7,0,109,2.69724770642202,0.600995888874262,46.2375
"3641084203.jpg",5,28,50,19,1,103,2.83495145631068,0.817661507445264,49.7567567567568
"3642904232.jpg",0,2,32,66,4,104,3.69230769230769,0.575839161014367,71.8940677966102
"36434642.jpg",1,25,57,20,1,104,2.95192307692308,0.715701946049324,53.6025641025641
"3644585173.jpg",3,24,70,14,0,111,2.85585585585586,0.658467184891574,50.9935897435897
"3645413545.jpg",3,70,31,0,0,104,2.26923076923077,0.506861066174239,33.2633928571429
"3645793167.jpg",0,2,40,55,1,98,3.56122448979592,0.557356176827417,71.7257281553398
"3647757599.jpg",0,9,82,15,0,106,3.05660377358491,0.474696668646115,55.5217391304348
"364777572.jpg",0,4,71,33,1,109,3.28440366972477,0.545889405419606,63.2433035714286
"3648316650.jpg",0,1,53,49,0,103,3.46601941747573,0.520473652694041,65.0321100917431
"364905354.jpg",0,0,24,67,7,98,3.8265306122449,0.537759962626212,74.7389380530973
"3649082846.jpg",1,14,76,13,1,105,2.99047619047619,0.58004041794248,53.25
"3651951998.jpg",0,12,73,20,0,105,3.07619047619048,0.549391938265845,56.8276699029126
"3652633823.jpg",0,0,61,73,0,134,3.54477611940298,0.499859704253811,71.8321428571429
"3653350159.jpg",0,2,42,89,2,135,3.67407407407407,0.530131349953412,76.3617021276596
"3653613515.jpg",0,6,53,43,0,102,3.36274509803922,0.593516382889227,62.4587155963303
"3654348116.jpg",0,11,80,20,0,111,3.08108108108108,0.524580094155578,56.2171052631579
"3655930326.jpg",0,29,70,6,0,105,2.78095238095238,0.536745040121693,46.890625
"3658535721.jpg",0,0,21,86,5,112,3.85714285714286,0.462214467149411,78
"3658667754.jpg",0,2,42,60,1,105,3.57142857142857,0.552218303703395,69.8448275862069
"3660430593.jpg",0,1,39,56,0,96,3.57291666666667,0.517987841081981,71.8529411764706
"3660664464.jpg",0,4,55,46,4,109,3.45871559633028,0.631460829724793,67.7626050420168
"3661422978.jpg",3,68,33,1,0,105,2.3047619047619,0.539298146522395,34.515625
"3662491369.jpg",2,27,61,19,0,109,2.88990825688073,0.698403596853466,48.2121848739496
"3662558151.jpg",2,32,61,5,0,100,2.69,0.59789191955967,45.8073394495413
"3662997757.jpg",0,3,33,79,0,115,3.66086956521739,0.52793800343327,76.0530973451327
"3663320781.jpg",0,0,27,64,13,104,3.86538461538462,0.608319223614763,75.9612068965517
"3663369776.jpg",0,1,29,78,5,113,3.76991150442478,0.534670284873941,74.6260504201681
"3663960871.jpg",0,13,92,20,0,125,3.056,0.512803804525165,56.8565573770492
"366471935.jpg",0,0,15,81,11,107,3.96261682242991,0.493834317278461,79.65
"3665983083.jpg",0,0,23,77,3,103,3.80582524271845,0.465648449975302,78.1486486486486
"3667890322.jpg",1,4,72,29,1,107,3.23364485981308,0.575923200663901,59.9978991596639
"3669066809.jpg",7,53,43,7,1,111,2.47747747747748,0.748900367773819,40.031512605042
"3670445078.jpg",15,89,39,2,0,145,2.19310344827586,0.626903232433243,31.7397260273973
"3670448728.jpg",7,61,37,0,0,105,2.28571428571429,0.583660295599538,33.0660377358491
"3671193503.jpg",0,8,68,31,0,107,3.21495327102804,0.56681895188049,60.1621621621622
"3673357278.jpg",0,1,51,51,2,105,3.51428571428571,0.556677743304068,67.5110619469027
"3673502264.jpg",3,21,64,17,0,105,2.9047619047619,0.686739922832306,49.9054054054054
"3674117315.jpg",0,3,76,27,0,106,3.22641509433962,0.483696458691754,61.5723684210526
"3675002443.jpg",1,39,59,9,0,108,2.7037037037037,0.630372375623148,46.2710084033613
"3676465885.jpg",1,11,55,34,2,103,3.24271844660194,0.706635488825852,60.4423076923077
"3677460940.jpg",0,22,71,17,0,110,2.95454545454545,0.596416879577703,51.325
"3678866923.jpg",0,1,47,63,1,112,3.57142857142857,0.532109277442409,68.4102564102564
"3680743288.jpg",3,68,34,1,0,106,2.31132075471698,0.540955196581007,34.6292372881356
"3683418770.jpg",0,14,66,25,1,106,3.12264150943396,0.627964666714226,55.9533898305085
"3686287517.jpg",3,23,68,7,0,101,2.78217821782178,0.609982957074042,46.7094594594595
"36869449.jpg",0,8,52,45,2,107,3.38317757009346,0.653652435096242,64.6228813559322
"3688540831.jpg",0,3,37,58,7,105,3.65714285714286,0.6479044835315,70.9040178571429
"3688594216.jpg",0,11,69,25,0,105,3.13333333333333,0.572891899231546,58.1554054054054
"368909912.jpg",0,6,65,28,0,99,3.22222222222222,0.545024911536171,58.3849557522124
"3689126503.jpg",0,1,24,68,8,101,3.82178217821782,0.57264368684131,74.4174311926605
"3689872234.jpg",1,52,52,1,0,106,2.5,0.538958431120797,40.875
"3691978983.jpg",0,1,31,61,10,103,3.77669902912621,0.625159412375277,73.9698275862069
"3693087386.jpg",1,44,53,7,0,105,2.62857142857143,0.624147770612408,44.0665137614679
"369451183.jpg",1,34,62,8,0,105,2.73333333333333,0.608697642933518,47.3325892857143
"369605204.jpg",0,6,47,57,0,110,3.46363636363636,0.600875091620359,65.14375
"3697066196.jpg",0,3,66,28,0,97,3.25773195876289,0.505765725481833,64.997572815534
"3697493807.jpg",0,0,8,84,13,105,4.04761904761905,0.446803871551825,82.2909482758621
"3697530291.jpg",0,1,12,76,13,102,3.99019607843137,0.535753342818227,82.0064655172414
"3697878601.jpg",0,1,28,74,4,107,3.75700934579439,0.529170256429054,78.1227678571429
"3698386210.jpg",0,23,72,14,0,109,2.91743119266055,0.579406471009462,49.8008474576271
"3702144450.jpg",0,20,60,23,0,103,3.02912621359223,0.648623137199123,55.8428571428571
"3702671816.jpg",0,2,58,44,3,107,3.44859813084112,0.586541588543228,68.8
"3704662776.jpg",5,72,24,1,0,102,2.20588235294118,0.532846555181383,31.4266055045872
"3705698114.jpg",0,20,73,9,0,102,2.8921568627451,0.524769874035287,53.712389380531
"3705884386.jpg",0,38,62,7,0,107,2.71028037383178,0.582922788414288,46.2673913043478
"3706984010.jpg",17,65,21,3,0,106,2.09433962264151,0.683524505942997,27.8861607142857
"3707022590.jpg",0,0,12,87,12,111,4,0.467099366496914,81.525641025641
"3707755654.jpg",2,32,67,8,0,109,2.74311926605505,0.614691577658179,45.6217391304348
"3708130060.jpg",0,30,57,18,0,105,2.88571428571429,0.669590657306125,52.5625
"3708879448.jpg",2,13,41,41,4,101,3.31683168316832,0.823780226386952,59.5391304347826
"3711573590.jpg",0,5,68,28,4,105,3.2952380952381,0.618991262579839,61.5948275862069
"3711772310.jpg",4,54,45,4,0,107,2.45794392523365,0.63365328642089,38.9797297297297
"3712529193.jpg",5,62,41,1,0,109,2.34862385321101,0.583351536049183,36.703781512605
"3713010621.jpg",4,44,52,6,0,106,2.56603773584906,0.662159064827986,44.0178571428571
"3713773458.jpg",0,9,52,44,0,105,3.33333333333333,0.630425171956115,64.7572815533981
"3714832332.jpg",1,37,63,8,0,109,2.71559633027523,0.609974849500736,46.6176470588235
"3715014568.jpg",3,21,69,8,0,101,2.81188118811881,0.611765825902832,48.9391891891892
"3715780832.jpg",0,10,64,33,1,108,3.23148148148148,0.620618947630938,61.8347826086957
"3716186057.jpg",31,63,4,0,0,98,1.72448979591837,0.533044402415361,18.7110091743119
"3716651057.jpg",0,0,22,87,4,113,3.84070796460177,0.454469307493758,77.5378151260504
"3716891886.jpg",0,0,43,57,4,104,3.625,0.560642834922123,72.2299107142857
"371935095.jpg",0,0,21,79,6,106,3.85849056603774,0.486751706437355,81.325
"3719984050.jpg",0,8,56,41,0,105,3.31428571428571,0.609449400220044,63.1399082568807
"372117089.jpg",0,0,57,50,0,107,3.46728971962617,0.501276803910374,67.0717391304348
"3721179887.jpg",4,44,53,6,0,107,2.57009345794393,0.660362243825315,43.5878378378378
"3722409963.jpg",9,67,35,2,0,113,2.26548672566372,0.627035245008551,34.1386554621849
"3722476330.jpg",0,9,54,42,1,106,3.33018867924528,0.643231397498414,62.5905172413793
"3722623767.jpg",0,27,67,12,0,106,2.85849056603774,0.592632211413952,51.1991525423729
"3725954413.jpg",0,27,69,8,0,104,2.81730769230769,0.553267839716467,48.7477876106195
"3726632967.jpg",0,5,55,41,1,102,3.37254901960784,0.595720191934298,65.725
"3727572481.jpg",0,10,78,13,0,101,3.02970297029703,0.478653226136719,52.5817757009346
"372866056.jpg",0,41,58,4,0,103,2.64077669902913,0.557557153177668,44.5206422018349
"3729465678.jpg",7,63,32,4,0,106,2.31132075471698,0.652660599424639,33.7828947368421
"3731180333.jpg",0,2,46,53,2,103,3.53398058252427,0.574209328172611,68.4513888888889
"3733701155.jpg",0,1,25,76,5,107,3.79439252336449,0.527334302993257,79.0405405405405
"3733759776.jpg",0,7,53,52,2,114,3.42982456140351,0.637601954305946,68.9888392857143
"3734378087.jpg",0,37,60,13,0,110,2.78181818181818,0.640839732670456,46.5125
"3734577194.jpg",0,3,53,44,1,101,3.42574257425743,0.57177853498475,66.6108490566038
"3734652007.jpg",1,20,66,19,0,106,2.97169811320755,0.639308363926894,54.1844660194175
"3736336896.jpg",0,27,71,12,0,110,2.86363636363636,0.582264997321599,49.8310810810811
"3736358849.jpg",6,78,24,1,0,109,2.18348623853211,0.529939507635837,31.8
"3736418288.jpg",0,19,71,10,1,101,2.93069306930693,0.570217953813702,49.6674311926606
"3736752039.jpg",0,1,34,65,2,102,3.66666666666667,0.532755462513791,75.872641509434
"3736907392.jpg",0,4,57,41,3,105,3.40952380952381,0.615430401227124,65.320796460177
"3737792738.jpg",7,66,30,1,0,104,2.24038461538462,0.582848584105705,33.4107142857143
"3738819299.jpg",0,3,50,51,0,104,3.46153846153846,0.556044925946993,68.0951327433628
"3739339628.jpg",2,20,60,25,2,109,3.04587155963303,0.750127410176745,55.2763157894737
"3740923361.jpg",1,77,29,3,0,110,2.30909090909091,0.53750109102436,34.275
"3741259519.jpg",0,5,59,39,3,106,3.37735849056604,0.624161611988117,66.3429203539823
"3741472599.jpg",0,6,67,36,0,109,3.27522935779817,0.558960007067151,64.25
"3742811862.jpg",0,14,75,16,1,106,3.0377358490566,0.567778097195539,54.8075221238938
"3743649571.jpg",0,7,61,32,1,101,3.26732673267327,0.598182064406998,61.7018348623853
"374612387.jpg",1,6,48,48,1,104,3.40384615384615,0.661261383174813,64.1334745762712
"3749654443.jpg",5,60,38,2,0,105,2.35238095238095,0.604167456106596,35.533185840708
"3750200495.jpg",0,2,48,60,4,114,3.57894736842105,0.593396356698839,68.0576923076923
"3750653207.jpg",2,41,57,9,1,110,2.69090909090909,0.687308999929789,44.9294871794872
"375084308.jpg",0,8,64,27,2,101,3.22772277227723,0.61451099451209,59.052752293578
"3750920837.jpg",10,57,30,0,0,97,2.20618556701031,0.611319343883527,31.6650943396226
"3753143338.jpg",65,39,4,0,0,108,1.43518518518519,0.568209980736327,11.51875
"375446021.jpg",0,27,75,5,0,107,2.79439252336449,0.509130182355242,48.2165178571429
"3754491822.jpg",3,60,42,3,0,108,2.41666666666667,0.597893498471106,38.2723214285714
"3754591467.jpg",10,46,37,6,0,99,2.39393939393939,0.753470633992742,38.0871559633027
"3755058211.jpg",0,1,28,62,15,106,3.85849056603774,0.653760976348288,77.1869565217391
"3755358004.jpg",0,4,41,53,7,105,3.6,0.673681047563425,69.304054054054
"3757841253.jpg",0,5,63,39,4,111,3.37837837837838,0.633232027761389,64.3910256410256
"3758354055.jpg",0,1,52,50,1,104,3.49038461538462,0.539600576976746,66.625
"3758613590.jpg",0,9,63,30,0,102,3.20588235294118,0.585944871095162,60.2637614678899
"3758636614.jpg",2,55,44,1,0,102,2.43137254901961,0.554188442797278,39.4756637168142
"3758843972.jpg",0,3,61,41,1,106,3.37735849056604,0.559810004991987,64.343220338983
"3759443485.jpg",0,45,52,1,0,98,2.55102040816327,0.520159550851563,41.493119266055
"3759763464.jpg",2,31,64,9,0,106,2.75471698113208,0.629607901486041,48.5776699029126
"3761038439.jpg",0,12,106,12,0,130,3,0.431331092813754,56.1279069767442
"3761173384.jpg",0,18,63,22,1,104,3.05769230769231,0.651017472166813,53.4464285714286
"3761272199.jpg",0,8,64,33,0,105,3.23809523809524,0.580513855989964,61.277027027027
"3761519418.jpg",0,0,31,86,4,121,3.77685950413223,0.491385851542776,77.10625
"3764660296.jpg",0,2,20,110,3,135,3.84444444444444,0.454934252534752,81.9722222222222
"3766742048.jpg",7,69,19,0,0,95,2.12631578947368,0.510362934339907,29.1285714285714
"376684942.jpg",0,16,58,24,2,100,3.12,0.685786431991061,56.4427966101695
"3767341492.jpg",5,56,37,3,0,101,2.37623762376238,0.63010293045684,35.275
"3767933394.jpg",0,2,31,65,5,103,3.70873786407767,0.587968719342113,75.0943396226415
"3768070080.jpg",34,62,13,0,0,109,1.80733944954128,0.630653162590088,22.5609243697479
"3770559253.jpg",0,12,74,12,0,98,3,0.497416003373807,55.1261682242991
"377273746.jpg",57,46,3,0,0,106,1.49056603773585,0.556267887140855,12.4782608695652
"3773463532.jpg",0,0,15,81,10,106,3.95283018867925,0.485642931178632,81.1536697247706
"3775591333.jpg",2,41,57,3,0,103,2.59223300970874,0.584722042292587,43.6378504672897
"3775862144.jpg",0,1,46,61,2,110,3.58181818181818,0.548255250635938,70.6184210526316
"3776716867.jpg",1,4,64,39,0,108,3.30555555555556,0.587380265521398,62.9486607142857
"3779249317.jpg",0,0,43,65,4,112,3.65178571428571,0.548705625611642,70.3717391304348
"3779311128.jpg",0,9,76,22,0,107,3.1214953271028,0.526832478007591,59.4639423076923
"3780702032.jpg",0,0,36,62,3,101,3.67326732673267,0.531204497177671,70.9357798165138
"3782183827.jpg",3,65,37,2,0,107,2.35514018691589,0.570539903993596,37.3883928571429
"3783245891.jpg",0,19,66,19,0,104,3,0.607397759985128,52.5974576271186
"3783312451.jpg",4,81,21,0,0,106,2.16037735849057,0.460575053659996,31.2021739130435
"3783568353.jpg",0,19,52,37,1,109,3.18348623853211,0.722202618725558,60.6152173913043
"3784715028.jpg",0,10,52,42,2,106,3.33962264150943,0.674526888204652,61.1681034482759
"3785783338.jpg",0,9,58,37,2,106,3.30188679245283,0.649832378691096,63.3956310679612
"3787014324.jpg",0,15,77,14,0,106,2.99056603773585,0.525452784682713,52.4038461538462
"3787979013.jpg",0,1,20,73,16,110,3.94545454545455,0.603299241653053,76.9138655462185
"3788379941.jpg",0,1,28,81,1,111,3.73873873873874,0.480751527425583,74.8849557522124
"3788909806.jpg",0,10,51,40,1,102,3.31372549019608,0.659738804554428,63.8967889908257
"3789837472.jpg",0,3,33,68,4,108,3.67592592592593,0.593243952337583,71.5265486725664
"3791999774.jpg",20,72,7,1,0,100,1.89,0.54855181241984,22.8738532110092
"3792338234.jpg",0,15,66,29,0,110,3.12727272727273,0.622352608232781,58.8898305084746
"3792378354.jpg",0,2,70,35,0,107,3.30841121495327,0.503032594939087,63.8040540540541
"379323686.jpg",0,3,39,54,5,101,3.6039603960396,0.633706681687862,72.025
"379362291.jpg",0,9,77,20,1,107,3.1214953271028,0.544445024232861,56.8622881355932
"3794248989.jpg",0,5,58,47,1,111,3.3963963963964,0.592057725675758,67.0705128205128
"379437662.jpg",0,0,42,59,1,102,3.59803921568627,0.512416212355276,68.6651376146789
"3794461596.jpg",0,3,48,50,3,104,3.50961538461538,0.607320908240659,71.0441176470588
"37951657.jpg",43,59,2,0,0,104,1.60576923076923,0.529118505469683,16.724358974359
"3796455854.jpg",0,10,58,34,0,102,3.23529411764706,0.616224058972176,59.052752293578
"3797715149.jpg",0,4,50,47,3,104,3.47115384615385,0.622502478167653,66.8552631578947
"3800059044.jpg",0,4,43,62,1,110,3.54545454545455,0.584766300632395,67.9625
"3800600451.jpg",0,0,17,82,11,110,3.94545454545455,0.503863306721062,77.7457983193277
"3801275835.jpg",0,6,64,35,0,105,3.27619047619048,0.563219421909541,62.8391304347826
"3804031946.jpg",0,0,38,62,2,102,3.64705882352941,0.519844965912666,72.1283783783784
"3805107589.jpg",0,7,78,23,0,108,3.14814814814815,0.50815434432866,59.4612068965517
"38056572.jpg",0,7,53,43,3,106,3.39622641509434,0.657256133055032,64.8326271186441
"3806051518.jpg",44,50,6,0,0,100,1.62,0.599326221011495,15.7591743119266
"3809644203.jpg",0,8,76,24,0,108,3.14814814814815,0.526224691975906,60.8514150943396
"3810011859.jpg",6,54,46,1,0,107,2.39252336448598,0.610552013542993,36.4977064220183
"381148704.jpg",0,17,67,20,0,104,3.02884615384615,0.598651085134435,57.4430693069307
"3812031514.jpg",0,1,50,63,1,115,3.55652173913043,0.532970891338817,70.9851694915254
"3812657000.jpg",0,5,117,29,0,151,3.15894039735099,0.448593583425474,60.6076158940397
"3812865597.jpg",0,2,52,49,3,106,3.5,0.589592272353571,67.8102678571429
"3812926720.jpg",0,1,38,58,4,101,3.64356435643564,0.575919411304074,70.3302752293578
"3814668128.jpg",1,20,90,34,2,147,3.10884353741497,0.663420481765341,59.7678571428571
"3815063597.jpg",1,29,67,6,0,103,2.75728155339806,0.568210459101958,47.3325892857143
"3815098207.jpg",0,3,29,70,5,107,3.7196261682243,0.595492384238558,74.7297297297297
"3816407980.jpg",0,2,60,45,0,107,3.4018691588785,0.529503382213656,64.343220338983
"3817723435.jpg",0,21,65,18,0,104,2.97115384615385,0.614654860438597,55.3529411764706
"3817779484.jpg",2,27,64,11,0,104,2.80769230769231,0.639734821836635,50.7426470588235
"3818998606.jpg",0,3,62,38,1,104,3.35576923076923,0.555960975629318,63.4847826086957
"3820650799.jpg",6,56,41,1,0,104,2.35576923076923,0.606089955045593,35.0794392523364
"3821275434.jpg",0,2,60,64,4,130,3.53846153846154,0.586063548606605,71.3097014925373
"3822506826.jpg",2,59,46,2,0,109,2.44036697247706,0.56815478884215,38.5063025210084
"3822808828.jpg",0,0,18,89,4,111,3.87387387387387,0.428891109662562,75.8046218487395
"3824105113.jpg",0,17,77,21,0,115,3.03478260869565,0.576292365837827,55.8834745762712
"3824362477.jpg",0,1,36,65,5,107,3.69158878504673,0.573160963154644,75.027027027027
"3824413541.jpg",0,3,35,76,2,116,3.66379310344828,0.558631332380526,76.3879310344828
"3824485636.jpg",2,35,51,17,2,107,2.83177570093458,0.782906791102829,48.1625
"3825250471.jpg",0,0,25,77,6,108,3.82407407407407,0.508409719674872,77.6592920353982
"3825304964.jpg",0,13,101,14,0,128,3.0078125,0.461017255044558,56.75
"3825365753.jpg",0,5,49,48,5,107,3.49532710280374,0.664090124818273,66.8613445378151
"3825837186.jpg",0,3,33,63,4,103,3.66019417475728,0.603151820679722,70.0320512820513
"3826205454.jpg",0,5,69,45,0,119,3.33613445378151,0.556583265039043,64.0384615384615
"3826585780.jpg",0,1,34,65,4,104,3.69230769230769,0.558724676052145,72.3834745762712
"3827560087.jpg",0,0,32,75,3,110,3.73636363636364,0.500958214435604,73.0260869565217
"382774042.jpg",35,56,12,0,0,103,1.77669902912621,0.640649774852576,20.8147321428571
"3827911032.jpg",0,3,45,53,1,102,3.50980392156863,0.575835132469745,72.3971962616822
"3827968988.jpg",0,26,87,13,0,126,2.8968253968254,0.548880534606431,52.8475609756098
"3828155719.jpg",0,11,79,43,0,133,3.2406015037594,0.592252709420483,62.3111510791367
"3828472247.jpg",0,13,78,19,0,110,3.05454545454545,0.539050535262052,55.2836134453782
"3829660645.jpg",0,13,72,22,1,108,3.10185185185185,0.594991790013488,56.046218487395
"3835050024.jpg",0,25,60,19,0,104,2.94230769230769,0.651017472166813,51.8141592920354
"3838001890.jpg",0,29,64,5,0,98,2.75510204081633,0.538444198063998,47.3040540540541
"3839953318.jpg",0,12,76,22,0,110,3.09090909090909,0.550986680360738,57.2817796610169
"3840546727.jpg",0,20,78,15,0,113,2.95575221238938,0.557247388812915,52.8571428571429
"3840923045.jpg",0,25,63,18,0,106,2.93396226415094,0.636491393343648,53.1013513513514
"3841233055.jpg",1,43,61,2,0,107,2.5981308411215,0.547029940957534,43.0981308411215
"3841305755.jpg",0,6,74,32,0,112,3.23214285714286,0.536625137285366,61.3368644067797
"3841509426.jpg",6,66,34,5,0,111,2.34234234234234,0.653598368411999,35.7934782608696
"3843377036.jpg",0,10,78,20,0,108,3.09259259259259,0.521267991007783,57.2635135135135
"3843859642.jpg",0,8,55,41,2,106,3.34905660377358,0.647963150483533,65.8214285714286
"3844930238.jpg",0,2,94,58,0,154,3.36363636363636,0.508980549960085,66.7911392405063
"3845656628.jpg",0,5,63,38,3,109,3.35779816513761,0.616485495606262,62.5855263157895
"3846071699.jpg",0,4,73,50,0,127,3.36220472440945,0.544369321100373,66.3503937007874
"3846844854.jpg",0,2,51,46,1,100,3.46,0.558135423992378,66.4602803738318
"3847022878.jpg",0,0,60,39,2,101,3.42574257425743,0.535659120214812,66.475
"384788069.jpg",0,3,17,72,8,100,3.85,0.592461054424762,77.35
"3847915749.jpg",25,66,16,1,0,108,1.93518518518519,0.645229049356591,23.1766055045872
"3847965007.jpg",2,42,50,7,0,101,2.61386138613861,0.647615580876541,43
"3848727332.jpg",0,0,22,84,1,107,3.80373831775701,0.422017891430813,79.8495575221239
"3848893941.jpg",0,8,40,62,0,110,3.49090909090909,0.63166380771075,64.18125
"3850107264.jpg",0,14,76,17,1,108,3.0462962962963,0.570034582641014,56.1848739495798
"3850147128.jpg",0,6,37,57,3,103,3.55339805825243,0.652719129154968,71.4
"3850577376.jpg",0,44,56,5,0,105,2.62857142857143,0.576079970028582,44.0434782608696
"3851672801.jpg",0,0,31,73,4,108,3.75,0.513827492052328,75.9189189189189
"3851941327.jpg",0,11,72,15,0,98,3.04081632653061,0.516098914577045,55.4954128440367
"3853359984.jpg",0,7,57,31,2,97,3.28865979381443,0.628469750110635,61.4471153846154
"3854279335.jpg",7,75,23,0,0,105,2.15238095238095,0.514799295860353,30.5558252427184
"3855419676.jpg",0,1,19,72,8,100,3.87,0.544114515576093,76.2905405405405
"3856196713.jpg",0,0,41,55,10,106,3.70754716981132,0.631958122965747,73.2586206896552
"3856507445.jpg",0,7,79,23,0,109,3.14678899082569,0.505995316794945,59.6907894736842
"3856900502.jpg",0,4,44,49,4,101,3.52475247524752,0.641779703729256,70.8076923076923
"3860253466.jpg",0,5,80,29,0,114,3.21052631578947,0.506133778714895,62.0789473684211
"3860848792.jpg",3,50,69,3,1,126,2.5952380952381,0.621978410282176,43.6585365853659
"3861043546.jpg",0,1,42,60,1,104,3.58653846153846,0.53263545017037,72.5982142857143
"3861673008.jpg",4,64,29,0,0,97,2.25773195876289,0.525958460722421,32.7184466019417
"3864280906.jpg",0,1,37,69,2,109,3.6605504587156,0.530900414150486,74.0921052631579
"3866688343.jpg",1,19,70,13,0,103,2.92233009708738,0.588939232331658,50.9230769230769
"3867441709.jpg",0,2,46,45,6,99,3.55555555555556,0.642416074439621,65.9048672566372
"386746008.jpg",2,6,60,45,0,113,3.30973451327434,0.655739032609379,62.4243697478992
"3867705645.jpg",28,70,4,0,0,102,1.76470588235294,0.510803494181496,19.5810810810811
"3867707916.jpg",0,13,69,22,0,104,3.08653846153846,0.576406290821484,58.127358490566
"387003357.jpg",8,74,24,1,0,107,2.16822429906542,0.55772417116537,31.7702702702703
"3870343367.jpg",0,10,64,32,0,106,3.20754716981132,0.597087871527506,62.4705882352941
"3870457394.jpg",0,2,67,39,2,110,3.37272727272727,0.556184427683838,63.672268907563
"3871801313.jpg",0,20,83,6,0,109,2.87155963302752,0.473382576295965,50.6398305084746
"3872043875.jpg",0,3,62,31,2,98,3.3265306122449,0.570322936265542,64.1238532110092
"3872509611.jpg",3,34,52,7,0,96,2.65625,0.662183390085604,43.6642857142857
"387259022.jpg",1,26,69,14,0,110,2.87272727272727,0.622352608232781,50.2828947368421
"3872832716.jpg",0,25,58,19,0,102,2.94117647058824,0.657380481352061,52.3
"3874298550.jpg",0,5,65,39,0,109,3.31192660550459,0.55606500596573,61.84375
"3874382715.jpg",6,63,28,2,0,99,2.26262626262626,0.599078520046235,32.5721153846154
"3876341199.jpg",0,2,43,81,0,126,3.62698412698413,0.517441814841081,73.9807692307692
"3876523676.jpg",0,3,37,66,2,108,3.62037037037037,0.575473678808797,72.2105263157895
"3879362113.jpg",0,1,34,65,6,106,3.71698113207547,0.581536830609117,74.4608695652174
"3880140639.jpg",1,73,28,3,0,105,2.31428571428571,0.542683604419273,34.5840707964602
"3880718005.jpg",2,25,77,4,0,108,2.76851851851852,0.540101781364678,48.8655660377358
"3881103730.jpg",0,0,13,83,12,108,3.99074074074074,0.483278723595215,78.8156779661017
"3885568060.jpg",0,2,34,58,10,104,3.73076923076923,0.657012497565065,73.5431034482759
"3886483510.jpg",0,1,41,58,0,100,3.57,0.517472489875334,72.8701923076923
"3886718406.jpg",1,6,54,41,0,102,3.32352941176471,0.631856681109741,65.6376146788991
"3886757277.jpg",0,35,57,11,0,103,2.76699029126214,0.629408117469253,45.859375
"3886880606.jpg",0,1,29,68,2,100,3.71,0.518252697615612,75.7798165137615
"3888454309.jpg",17,78,11,1,0,107,1.96261682242991,0.548157008991757,25.1953781512605
"3890421755.jpg",0,6,68,28,0,102,3.2156862745098,0.538193733390896,57.993119266055
"3890811565.jpg",0,4,62,41,0,107,3.34579439252336,0.551204576930051,64.1575630252101
"3891717415.jpg",0,1,43,57,0,101,3.55445544554455,0.519138662107774,71.4196428571429
"3892086124.jpg",0,15,83,40,1,139,3.19424460431655,0.62412486954026,61.2928082191781
"3892332557.jpg",0,24,59,21,0,104,2.97115384615385,0.660343111302948,53.1971153846154
"3894915205.jpg",0,1,60,79,1,141,3.56737588652482,0.525152556596749,72.741554054054
"3895433023.jpg",0,8,73,24,0,105,3.15238095238095,0.533150151691889,58.1760869565217
"3895663827.jpg",0,35,57,9,0,101,2.74257425742574,0.610793997130533,46.6805555555556
"3896434582.jpg",0,30,72,4,0,106,2.75471698113208,0.512906206123813,47.5586956521739
"3898078585.jpg",35,70,7,0,0,112,1.75,0.561529442963871,19.9679487179487
"3900873243.jpg",0,21,71,13,1,106,2.94339622641509,0.598890858635405,53.7860169491525
"3900966844.jpg",3,69,37,4,0,113,2.3716814159292,0.600516002306807,37.09375
"390226070.jpg",0,5,31,63,5,104,3.65384615384615,0.650156527370256,72.2566371681416
"3902626347.jpg",25,84,3,1,0,113,1.82300884955752,0.504091978844409,21.936974789916
"3903483278.jpg",6,40,56,6,0,108,2.57407407407407,0.686365256616176,42.25
"3904942577.jpg",31,73,1,0,0,105,1.71428571428571,0.474631146549323,18.2173913043478
"3905518312.jpg",2,47,53,1,0,103,2.51456310679612,0.557727842651489,39.3035714285714
"3908700784.jpg",0,3,31,68,2,104,3.66346153846154,0.567922067043096,71.9210526315789
"3908763168.jpg",0,1,34,69,5,109,3.71559633027523,0.562595557632559,73.2787610619469
"3908866899.jpg",2,59,39,2,0,102,2.40196078431373,0.567429568562114,38.2777777777778
"3910222592.jpg",0,3,37,68,2,110,3.62727272727273,0.572441910984171,67.9705882352941
"3910973897.jpg",9,82,19,1,0,111,2.10810810810811,0.528313807424602,29.1059322033898
"3913177014.jpg",2,20,70,12,0,104,2.88461538461538,0.612296208343076,51.6282051282051
"3913188131.jpg",0,0,17,72,15,104,3.98076923076923,0.557051342926048,79.9642857142857
"3916222248.jpg",0,1,24,67,5,97,3.78350515463918,0.544418729083891,79.7354368932039
"3916243478.jpg",0,22,66,14,0,102,2.92156862745098,0.591796635357012,51.8878504672897
"3916637949.jpg",4,33,56,12,2,107,2.76635514018692,0.771905743247955,47.0336134453782
"3916850615.jpg",0,1,60,45,0,106,3.41509433962264,0.513956168750047,65.7625
"3916915691.jpg",0,23,77,8,0,108,2.86111111111111,0.519855000152735,50.9583333333333
"3917849504.jpg",2,36,48,20,0,106,2.81132075471698,0.757353884033334,49.495652173913
"3918062562.jpg",0,1,26,67,9,103,3.81553398058252,0.589908148641803,76.7435344827586
"3918280584.jpg",0,6,69,30,0,105,3.22857142857143,0.541670188774122,60.3108108108108
"3918838221.jpg",12,61,34,3,0,110,2.25454545454545,0.683170746268552,34.6346153846154
"3919380535.jpg",1,4,46,53,0,104,3.45192307692308,0.62130160417126,69.1361607142857
"392103652.jpg",8,65,36,2,0,111,2.28828828828829,0.623587675360561,33.3707627118644
"3921589638.jpg",0,1,39,61,3,104,3.63461538461538,0.558390410586359,72.8407079646018
"392179845.jpg",53,86,5,0,0,144,1.66666666666667,0.541946762797135,16.248275862069
"3922421993.jpg",0,2,40,58,3,103,3.60194174757282,0.583091924701258,72.0416666666667
"3923233289.jpg",4,89,13,0,0,106,2.08490566037736,0.393226568116165,28.8004201680672
"3923541475.jpg",1,9,83,13,0,106,3.0188679245283,0.497252107668146,54.9046610169492
"3925412649.jpg",0,4,57,41,1,103,3.37864077669903,0.579325247371913,65.466814159292
"392558137.jpg",2,49,47,6,0,104,2.54807692307692,0.636736334029978,40.7302631578947
"3927444590.jpg",0,6,68,48,1,123,3.35772357723577,0.588553120307049,65.9772727272727
"3927881802.jpg",0,7,55,39,0,101,3.31683168316832,0.598843770432772,63.1399082568807
"3928559890.jpg",0,10,62,34,0,106,3.22641509433962,0.606049170846951,63.3169642857143
"3930941584.jpg",5,48,49,0,0,102,2.43137254901961,0.588836811456376,36.4527027027027
"3931210821.jpg",0,12,69,24,0,105,3.11428571428571,0.577032956569235,55.2567567567568
"3932630945.jpg",0,4,58,41,0,103,3.35922330097087,0.557557153177668,61.6227678571429
"3932684731.jpg",1,33,64,11,0,109,2.77981651376147,0.628899658797715,48.85
"3932785686.jpg",5,49,47,9,0,110,2.54545454545455,0.71210198780385,40.6987179487179
"3934165977.jpg",0,15,69,20,0,104,3.04807692307692,0.58092339772589,55.2455752212389
"3934821151.jpg",0,5,37,56,3,101,3.56435643564356,0.638996738397911,69.5683962264151
"3934995195.jpg",0,0,27,81,1,109,3.76146788990826,0.449260350337442,75.739406779661
"3935177366.jpg",29,66,7,1,0,103,1.80582524271845,0.595049057578605,21.025641025641
"3937913166.jpg",0,2,48,57,3,110,3.55454545454545,0.583981331176464,71.0192307692308
"3938367619.jpg",1,25,63,14,1,104,2.89423076923077,0.667094398507281,50.2155172413793
"3939043948.jpg",3,51,48,5,0,107,2.51401869158878,0.634904330652494,41.21875
"3939622523.jpg",0,24,48,31,0,103,3.06796116504854,0.731130415693104,55.0337837837838
"3940105265.jpg",6,35,55,15,2,113,2.75221238938053,0.81865496669109,46.1616379310345
"3940357186.jpg",0,38,63,2,0,103,2.6504854368932,0.518458080898139,45.1703539823009
"3940847938.jpg",15,67,18,1,0,101,2.04950495049505,0.60623819780285,27.55
"3941788092.jpg",0,2,52,46,0,100,3.44,0.53785958138991,65.2477876106195
"3943080167.jpg",15,75,21,0,0,111,2.05405405405405,0.569494797451499,28.8525641025641
"3944642127.jpg",0,1,47,56,7,111,3.62162162162162,0.618709126165909,69.4470338983051
"3945869834.jpg",0,0,15,91,5,111,3.90990990990991,0.416687141184095,76
"3946405001.jpg",0,0,36,68,1,105,3.66666666666667,0.493548116792825,71.6228448275862
"3947046278.jpg",0,6,47,52,0,105,3.43809523809524,0.603257336399164,68.375
"3948135332.jpg",0,3,46,66,0,115,3.54782608695652,0.55001560202543,72.9342105263158
"3948277105.jpg",0,7,80,20,0,107,3.1214953271028,0.489710741996757,57.9789719626168
"3948522988.jpg",2,31,56,15,0,104,2.80769230769231,0.697804087966653,49.6238938053097
"3948731617.jpg",0,1,35,69,0,105,3.64761904761905,0.499633565359354,74.5688073394495
"3949143151.jpg",0,0,63,58,0,121,3.47933884297521,0.501650169502596,68.99375
"3949472497.jpg",0,4,51,48,2,105,3.45714285714286,0.604924843211176,66.4978260869565
"395036065.jpg",31,87,33,0,0,151,2.01324503311258,0.653062069197994,27.4325657894737
"395147567.jpg",1,67,69,2,0,139,2.51798561151079,0.543105909355605,41.851724137931
"3951898034.jpg",0,1,37,68,4,110,3.68181818181818,0.557382779577142,71.95
"3952840501.jpg",0,1,42,82,3,128,3.6796875,0.531430897871584,76
"395315549.jpg",0,28,93,13,0,134,2.88805970149254,0.543733235139621,52.1875
"39540491.jpg",0,3,34,54,16,107,3.77570093457944,0.730835799834596,73.3088235294118
"3954258141.jpg",0,7,57,38,2,104,3.33653846153846,0.632617876088816,65.3348623853211
"3955560376.jpg",1,4,53,47,1,106,3.40566037735849,0.629108240922058,63.0847457627119
"3956832242.jpg",1,41,60,3,0,105,2.61904761904762,0.561264924094064,44.0233644859813
"3957754780.jpg",0,53,50,4,0,107,2.54205607476635,0.571003318097878,40.7635135135135
"3960128594.jpg",0,15,75,12,0,102,2.97058823529412,0.516190968440775,53.5555555555556
"3960444662.jpg",0,1,23,80,4,108,3.80555555555556,0.501555213709073,73.7375
"3960629357.jpg",0,17,81,38,2,138,3.18115942028985,0.653296047917389,60.9537671232877
"3961390501.jpg",0,2,25,69,5,101,3.76237623762376,0.568304757176731,74.0389908256881
"3961459513.jpg",0,0,36,66,1,103,3.66019417475728,0.496130083713671,74.1394230769231
"3962058482.jpg",31,50,19,2,0,102,1.92156862745098,0.753687627467837,25.4527027027027
"396221760.jpg",0,4,75,31,0,110,3.24545454545455,0.510196285961106,61.5948275862069
"3962244093.jpg",0,2,48,48,1,99,3.48484848484848,0.559949639930132,67.0771028037383
"3964553280.jpg",0,19,70,19,0,108,3,0.595936395025415,55.1081081081081
"396505725.jpg",7,93,10,0,0,110,2.02727272727273,0.393970401465676,28.5705128205128
"3965556653.jpg",0,18,65,23,1,107,3.06542056074766,0.648234584218584,57.25
"3966627187.jpg",0,0,37,75,2,114,3.69298245614035,0.500038812342383,71.6630434782609
"3966829877.jpg",0,3,46,53,3,105,3.53333333333333,0.605530070819498,68.0760869565217
"3969622447.jpg",1,39,58,6,0,104,2.66346153846154,0.601140936628686,45.373786407767
"3970268650.jpg",0,0,34,65,1,100,3.67,0.493493012650993,69.9518348623853
"3971050023.jpg",0,3,21,67,16,107,3.89719626168224,0.672008808332494,77.51875
"3971662930.jpg",0,27,70,9,0,106,2.83018867924528,0.560130904992541,49.8831775700935
"3971799391.jpg",0,16,59,28,0,103,3.11650485436893,0.646270914991878,58.8256880733945
"3973001148.jpg",3,56,44,3,0,106,2.44339622641509,0.602853353079302,38.1596638655462
"3973813247.jpg",1,55,49,5,0,110,2.52727272727273,0.601360703388282,39.98125
"3974701478.jpg",1,17,63,29,1,111,3.10810810810811,0.692181680713582,54.6590909090909
"3975469304.jpg",0,1,14,80,8,103,3.92233009708738,0.498808784699235,82.3851351351351
"3976452832.jpg",0,11,83,16,0,110,3.04545454545455,0.495602008799337,55.2567567567568
"3976883946.jpg",0,24,79,33,1,137,3.08029197080292,0.664857284117337,56.5265957446809
"3977122123.jpg",1,8,93,25,0,127,3.11811023622047,0.528762755159244,60.1904761904762
"3978652004.jpg",2,22,62,18,0,104,2.92307692307692,0.678266031553529,52.2569444444444
"3978837773.jpg",0,10,72,40,0,122,3.24590163934426,0.593511408397612,63.077868852459
"3980206588.jpg",0,5,71,30,0,106,3.23584905660377,0.526477726068939,63.6116071428571
"3980253534.jpg",1,18,74,14,0,107,2.94392523364486,0.580041893427398,54.2234513274336
"3980401611.jpg",1,40,60,6,0,107,2.66355140186916,0.597856631290651,45.4782608695652
"3982768803.jpg",0,15,69,18,0,102,3.02941176470588,0.570840657709211,53.5275229357798
"3983499964.jpg",0,7,55,45,1,108,3.37037037037037,0.62040976197892,67.1542056074766
"3984248064.jpg",18,74,17,0,0,109,1.99082568807339,0.569200427566091,24.6021739130435
"3985027264.jpg",0,53,51,1,0,105,2.5047619047619,0.521163814564789,40.0260869565217
"3985258920.jpg",2,18,57,29,0,106,3.06603773584906,0.720698971892047,52.3877118644068
"398551269.jpg",1,37,56,13,0,107,2.75700934579439,0.670695520369644,48.7905405405405
"3985602874.jpg",0,3,49,51,1,104,3.48076923076923,0.574215703707125,66.4
"3986881860.jpg",0,1,22,84,1,108,3.78703703703704,0.454488023056075,76.718220338983
"3987605606.jpg",0,0,11,74,23,108,4.11111111111111,0.552535926574701,84.05
"3989767571.jpg",0,15,100,10,0,125,2.96,0.447213595499958,55.0609756097561
"3992677101.jpg",22,73,6,0,0,101,1.84158415841584,0.504632009831456,21.6596638655462
"3993808694.jpg",8,46,41,12,0,107,2.53271028037383,0.792866271640204,40.875
"3994007574.jpg",0,2,34,58,4,98,3.6530612244898,0.593817647325148,73.1307339449541
"3994759280.jpg",0,5,58,43,1,107,3.37383177570093,0.59118308765705,66.4602803738318
"3994759840.jpg",0,18,82,5,0,105,2.87619047619048,0.453516984993567,49.8599137931034
"3995400927.jpg",0,7,64,31,1,103,3.25242718446602,0.589423889579224,63.2912844036697
"3999106249.jpg",0,23,63,13,0,99,2.8989898989899,0.597528062613978,50.2828947368421
"4000012271.jpg",0,0,16,79,15,110,3.99090909090909,0.533216904166657,77.45
"4000500172.jpg",1,21,71,14,0,107,2.91588785046729,0.600652087901185,52.9527027027027
"4000774743.jpg",0,8,71,27,1,107,3.19626168224299,0.573622259779138,60.1642857142857
"4001539544.jpg",2,47,52,2,0,103,2.52427184466019,0.57470640747058,42.3263888888889
"4002090879.jpg",0,3,64,73,4,144,3.54166666666667,0.589832262513757,73.6109271523179
"4002265121.jpg",0,3,57,40,2,102,3.40196078431373,0.584618076590697,65.8646788990826
"4003392015.jpg",4,55,42,2,0,103,2.40776699029126,0.601255112144644,37.7905405405405
"4004417944.jpg",12,81,33,0,0,126,2.16666666666667,0.576194411635517,30.8475609756098
"4005014529.jpg",0,21,63,21,0,105,3,0.635488909302243,56.1067961165049
"4005164524.jpg",1,59,73,5,0,138,2.59420289855072,0.574871374498517,42.7620689655172
"4005784260.jpg",0,0,47,58,3,108,3.59259259259259,0.547501325685026,69.9810924369748
"4007753969.jpg",0,4,64,43,1,112,3.36607142857143,0.569424171197436,64.1089743589744
"4008219206.jpg",1,11,72,22,2,108,3.12037037037037,0.637131313107367,57.6041666666667
"4010417256.jpg",0,25,61,20,0,106,2.95283018867925,0.652935867509179,50.9459459459459
"4010451143.jpg",0,2,37,68,1,108,3.62962962962963,0.539861397799015,71.8241525423729
"4011871379.jpg",0,23,69,19,0,111,2.96396396396396,0.616853127176786,54.5192307692308
"4014803633.jpg",20,76,11,0,0,107,1.91588785046729,0.534145329088297,23.89375
"4016051317.jpg",7,62,35,1,0,105,2.28571428571429,0.599908417919027,32.3348623853211
"4016200124.jpg",0,3,51,44,1,99,3.43434343434343,0.574307323005264,67.375
"4016398417.jpg",0,7,56,37,0,100,3.3,0.594588390010563,61.2544642857143
"4016639569.jpg",0,4,41,47,6,98,3.56122448979592,0.674518943214267,66.0508849557522
"4017312321.jpg",10,64,23,2,0,99,2.17171717171717,0.623361591930366,29.6458333333333
"4018386659.jpg",0,10,73,22,0,105,3.11428571428571,0.542683604419273,58.0688073394495
"4018505209.jpg",0,1,42,62,2,107,3.60747663551402,0.545254127107898,73.1327433628319
"4018879156.jpg",7,50,44,3,0,104,2.41346153846154,0.662601183671924,38.2867647058824
"4019770428.jpg",0,1,47,58,4,110,3.59090909090909,0.579393142588057,70.327731092437
"4023100592.jpg",22,71,23,1,0,117,2.02564102564103,0.649423331217761,26.9590517241379
"4023245742.jpg",0,18,71,15,0,104,2.97115384615385,0.565285919050108,53.5504201680672
"4023598688.jpg",0,17,65,17,0,99,3,0.589015089373952,53.0733944954128
"4026925102.jpg",0,6,56,42,3,107,3.39252336448598,0.640710238952061,65.8214285714286
"4027767419.jpg",0,8,74,18,0,100,3.1,0.502518907629606,55.588785046729
"4028266820.jpg",0,5,56,50,1,112,3.41964285714286,0.594848649947965,65.9423076923077
"4029731030.jpg",2,22,66,12,0,102,2.86274509803922,0.62993345061479,50.95
"4033495510.jpg",10,70,27,0,0,107,2.1588785046729,0.568837488983642,31.3308823529412
"4034220859.jpg",0,29,76,8,0,113,2.8141592920354,0.543610163732964,49.125
"4034290606.jpg",0,8,65,29,1,103,3.22330097087379,0.592965938825234,61.8819444444444
"4034550282.jpg",3,70,36,3,0,112,2.34821428571429,0.580615104534751,35.5381355932203
"4035961068.jpg",1,50,45,4,0,100,2.52,0.594248528085104,40.1111111111111
"4036944943.jpg",0,2,25,97,2,126,3.78571428571429,0.483440053899432,80.134
"4037056912.jpg",0,44,52,5,0,101,2.61386138613861,0.58258556504093,43.3194444444444
"4037555676.jpg",21,73,15,0,0,109,1.94495412844037,0.574695771132691,24.1419491525424
"4039710407.jpg",0,1,45,52,10,108,3.65740740740741,0.657978169638111,70.85
"403993453.jpg",5,77,20,1,1,104,2.19230769230769,0.575839161014367,32.3919491525424
"404033442.jpg",0,4,65,37,0,106,3.31132075471698,0.540955196581007,62.8050847457627
"4040650709.jpg",1,39,58,7,0,105,2.67619047619048,0.612297660381309,45
"4040905906.jpg",0,0,48,60,1,109,3.56880733944954,0.515805240252132,67.1375
"4041954882.jpg",0,0,28,81,4,113,3.78761061946903,0.490104351746142,75.86875
"4042188530.jpg",8,37,54,3,0,102,2.50980392156863,0.685711281205573,39.4495412844037
"4042245241.jpg",6,49,50,8,0,113,2.53097345132743,0.708000157134983,40.6987179487179
"4042292027.jpg",0,12,71,30,0,113,3.15929203539823,0.591100240493098,57.3987068965517
"4042306910.jpg",0,24,69,8,0,101,2.84158415841584,0.542819919813684,49.4594594594595
"4042433513.jpg",1,29,59,14,0,103,2.83495145631068,0.658237208846935,49.4976635514019
"4042572733.jpg",5,38,60,2,0,105,2.56190476190476,0.618991262579839,41.4324324324324
"4042987026.jpg",16,73,17,1,0,107,2.02803738317757,0.590138198161191,26.85
"4045599734.jpg",0,1,35,70,0,106,3.65094339622642,0.498425192938695,72.7056074766355
"4046637583.jpg",4,80,40,1,0,125,2.304,0.542158172373126,35.140243902439
"4046716515.jpg",2,59,67,1,0,129,2.51937984496124,0.546305420440893,41.0534351145038
"4047293612.jpg",0,1,60,45,1,107,3.42990654205607,0.533980240124661,68.3141592920354
"4047658369.jpg",0,6,54,35,1,96,3.32291666666667,0.606886647990193,64.8
"4049047636.jpg",35,72,4,1,0,112,1.74107142857143,0.565455022295657,20.1567796610169
"4050875089.jpg",0,1,39,59,2,101,3.61386138613861,0.547179989212014,68.3630434782609
"4054072823.jpg",0,17,60,24,1,102,3.08823529411765,0.661575395170095,57.1308411214953
"4054594935.jpg",0,1,34,69,0,104,3.65384615384615,0.497941993136503,71.3108108108108
"4054655583.jpg",0,24,72,8,0,104,2.84615384615385,0.535519542113137,50.6571428571429
"4054847919.jpg",0,0,34,61,6,101,3.72277227722772,0.567781857427448,76.9951923076923
"4056860839.jpg",0,0,25,76,6,107,3.82242990654206,0.510513690836126,77.4021739130435
"405908679.jpg",0,9,86,44,4,143,3.3006993006993,0.628377802332559,65.2281879194631
"4062759482.jpg",5,77,30,0,0,112,2.22321428571429,0.514822131946391,33.6474358974359
"4063780436.jpg",0,5,76,24,0,105,3.18095238095238,0.495769649925795,60.6357142857143
"4065100469.jpg",0,3,54,43,1,101,3.41584158415842,0.570391562572121,65.125
"4067961238.jpg",1,75,67,1,0,144,2.47222222222222,0.52815081079487,40.0879310344828
"4068780416.jpg",1,36,62,4,0,103,2.66990291262136,0.566868756027408,43.9868421052632
"406881914.jpg",0,0,13,87,9,109,3.96330275229358,0.449827240594924,76.7625
"4069729710.jpg",0,0,39,63,1,103,3.63106796116505,0.504689601017511,73.779702970297
"4074943155.jpg",2,9,70,30,0,111,3.15315315315315,0.635298043129053,60.1724137931034
"4075989770.jpg",0,31,60,11,0,102,2.80392156862745,0.614014797871709,46.6399082568807
"4076940518.jpg",0,1,54,44,4,103,3.49514563106796,0.592002027152183,67.5840707964602
"4077667734.jpg",0,2,34,60,11,107,3.74766355140187,0.660095161005968,76.2019230769231
"4078925567.jpg",2,54,93,1,0,150,2.62,0.526734909066724,44.6539735099338
"4079545582.jpg",0,7,68,30,0,105,3.21904761904762,0.554369919210997,58.8243243243243
"4079839829.jpg",0,37,58,2,0,97,2.63917525773196,0.524117651596258,44.1102941176471
"4080245276.jpg",33,65,4,0,0,102,1.7156862745098,0.533574736669312,17.6447368421053
"4080731983.jpg",0,3,58,45,1,107,3.41121495327103,0.565573194436278,66.1824324324324
"4081025902.jpg",2,42,60,4,0,108,2.61111111111111,0.593316881706884,43.9868421052632
"4081293153.jpg",0,5,70,30,0,105,3.23809523809524,0.528492222557749,61.6334951456311
"4083824869.jpg",0,16,77,13,0,106,2.97169811320755,0.524768378290412,52.7239130434783
"4084687519.jpg",0,1,50,58,1,110,3.53636363636364,0.536336070311266,68.594537815126
"4085075628.jpg",1,23,95,16,0,135,2.93333333333333,0.562510364746963,53.8
"408607884.jpg",0,17,60,32,1,110,3.15454545454545,0.679805201946725,59.7899159663866
"4086204414.jpg",15,66,20,0,0,101,2.04950495049505,0.589512300529215,27.625
"4087443308.jpg",0,1,46,56,1,104,3.54807692307692,0.537520515613129,68.4864864864865
"4088500384.jpg",1,11,76,21,1,110,3.09090909090909,0.598859076490103,56.4230769230769
"4089514101.jpg",0,1,31,76,3,111,3.72972972972973,0.521291158321788,74.1548672566372
"4091583861.jpg",3,44,57,3,0,107,2.5607476635514,0.601532164692449,40.9473684210526
"409233389.jpg",3,34,65,9,0,111,2.72072072072072,0.649071661139216,46.0576923076923
"4092627138.jpg",0,6,60,43,1,110,3.35454545454545,0.599485461888649,64.4131355932203
"409280416.jpg",0,25,77,6,0,108,2.82407407407407,0.508409719674872,49.6680672268908
"409446076.jpg",2,54,43,3,0,102,2.46078431372549,0.59155054900552,39.8407079646018
"4094774604.jpg",3,48,43,4,0,98,2.48979591836735,0.629922233118488,37.212389380531
"4094850958.jpg",11,71,20,0,0,102,2.08823529411765,0.546871229914619,29.2638888888889
"4095160762.jpg",0,0,67,37,5,109,3.43119266055046,0.583205898414645,65.8318584070797
"4095383312.jpg",4,49,45,7,0,105,2.52380952380952,0.680712834732799,39.4495412844037
"4095785910.jpg",0,27,88,16,0,131,2.91603053435115,0.568914863698783,52.046875
"409597917.jpg",2,67,60,1,0,130,2.46153846153846,0.544939313225234,40.251953125
"409821164.jpg",0,2,71,31,1,105,3.2952380952381,0.517460692000434,62.7673913043478
"4098700616.jpg",0,4,59,47,0,110,3.39090909090909,0.560069696604103,65.5897435897436
"4099198318.jpg",1,20,67,13,0,101,2.91089108910891,0.601647902032245,49.743119266055
"4100096331.jpg",40,57,11,0,0,108,1.73148148148148,0.635499383904956,18.5405405405405
"4100631766.jpg",0,44,52,6,0,102,2.62745098039216,0.595720191934298,42.098623853211
"4103115026.jpg",55,53,2,0,0,110,1.51818181818182,0.537268288981667,13.7875
"4103158795.jpg",0,2,37,63,3,105,3.63809523809524,0.573850180189942,71.5265486725664
"4106514523.jpg",0,2,31,74,0,107,3.67289719626168,0.50982240590043,75.3986486486486
"4106517753.jpg",0,2,31,76,1,110,3.69090909090909,0.520152668934002,75.1089743589744
"4107362083.jpg",0,1,17,69,17,104,3.98076923076923,0.607090294635138,80.75
"4107566763.jpg",1,18,51,33,0,103,3.12621359223301,0.72327701484673,56.3598130841121
"4109408743.jpg",0,0,30,76,1,107,3.72897196261682,0.467229761626852,73.9915254237288
"411025625.jpg",0,2,62,78,2,144,3.55555555555556,0.55189156958981,71.8931034482759
"4110400471.jpg",0,9,67,29,0,105,3.19047619047619,0.573371239908821,59.754347826087
"411090819.jpg",44,46,10,1,0,101,1.68316831683168,0.69181924039892,16.9
"4112798557.jpg",0,1,12,76,12,101,3.98019801980198,0.528775907541219,80.107476635514
"41130035.jpg",0,1,27,65,11,104,3.82692307692308,0.614426999500113,76.025641025641
"4113272660.jpg",1,15,53,34,2,105,3.2,0.739022223044643,60.3705357142857
"4113685341.jpg",80,26,1,0,0,107,1.26168224299065,0.462488115056491,7.51680672268908
"4114019902.jpg",0,6,54,55,2,117,3.45299145299145,0.622781946892004,68.0668103448276
"4114743309.jpg",0,0,29,71,2,102,3.73529411764706,0.485970919315653,77.7323008849557
"411787882.jpg",0,0,31,66,7,104,3.76923076923077,0.561391634768236,75.4652173913043
"4122173034.jpg",0,12,81,14,1,108,3.03703703703704,0.528194348363815,54.7697368421053
"412289790.jpg",36,66,5,0,0,107,1.71028037383178,0.549602700317316,17.4263392857143
"4124391067.jpg",24,80,7,0,0,111,1.84684684684685,0.508083711753347,22.8834745762712
"4124667437.jpg",3,41,58,6,0,108,2.62037037037037,0.637131313107367,42.7702702702703
"4125943270.jpg",1,1,30,69,8,109,3.75229357798165,0.640543220023157,76.7232142857143
"4126410943.jpg",2,51,50,1,0,104,2.48076923076923,0.557051342926048,40.0065789473684
"4127387822.jpg",0,0,32,67,6,105,3.75238095238095,0.550890055709715,75.5344827586207
"4127400247.jpg",2,37,96,3,0,138,2.72463768115942,0.523437765206351,47.0721830985916
"4128658349.jpg",0,1,45,50,3,99,3.55555555555556,0.575383141599742,74.0163551401869
"4130373740.jpg",0,12,79,15,1,107,3.04672897196262,0.538747281569002,55.9742990654206
"4131278870.jpg",0,0,20,75,6,101,3.86138613861386,0.490503883171113,80.40625
"4132558989.jpg",0,1,30,65,8,104,3.76923076923077,0.594975225571673,75.8340707964602
"4132747677.jpg",0,3,61,36,0,100,3.33,0.532859638121892,62.6458333333333
"4135617147.jpg",0,2,62,52,0,116,3.43103448275862,0.531186333163543,68.8491379310345
"4136576616.jpg",0,1,40,69,0,110,3.61818181818182,0.506504810048403,68.44375
"4137012282.jpg",3,30,62,9,1,105,2.76190476190476,0.686739922832306,46.1924778761062
"4138608778.jpg",0,4,56,46,0,106,3.39622641509434,0.563648747140221,65.7415254237288
"4139461254.jpg",0,2,66,31,1,100,3.31,0.525991127935317,66.2142857142857
"4139991387.jpg",0,8,76,20,0,104,3.11538461538462,0.508332364091029,56.7413043478261
"4141916319.jpg",0,0,41,60,5,106,3.66037735849057,0.567144769505739,72.3804347826087
"4142709624.jpg",0,3,26,71,6,106,3.75471698113208,0.598590737915664,73.703125
"4142940823.jpg",0,2,56,51,0,109,3.44954128440367,0.535520489840562,66.0987394957983
"4143454418.jpg",0,19,94,22,0,135,3.02222222222222,0.552695790481455,56.5789473684211
"4143494301.jpg",0,16,69,23,0,108,3.06481481481481,0.600204764874847,55.8135593220339
"414385138.jpg",0,5,38,54,1,98,3.52040816326531,0.613080641451322,68.7408256880734
"4144540155.jpg",0,8,59,43,0,110,3.31818181818182,0.604749067406287,62.9121621621622
"4146534497.jpg",4,40,77,4,0,125,2.648,0.599139167418959,45.6036585365854
"4147791219.jpg",0,5,74,23,0,102,3.17647058823529,0.495759537405347,58.2102803738318
"414892775.jpg",0,5,69,36,0,110,3.28181818181818,0.544055754391562,61.1071428571429
"4149241552.jpg",0,9,45,54,1,109,3.43119266055046,0.657815865222348,63.6440677966102
"4149265699.jpg",0,3,54,38,1,96,3.38541666666667,0.568836146358078,66.6071428571429
"4149460224.jpg",8,70,30,1,0,109,2.22018348623853,0.583060224402528,33.0375
"4151017008.jpg",0,8,53,40,4,105,3.38095238095238,0.684736788017461,64.0796460176991
"4151551954.jpg",0,4,69,22,0,95,3.18947368421053,0.490217859560448,59.3
"415283727.jpg",1,24,60,17,1,103,2.93203883495146,0.689730494715005,49.9889380530973
"4154530402.jpg",1,19,61,19,0,100,2.98,0.651028711992324,53.25
"4155484757.jpg",0,1,62,37,2,102,3.3921568627451,0.54784659891482,64.1736111111111
"4156345687.jpg",0,1,52,81,6,140,3.65714285714286,0.572404100496458,75.1938775510204
"4156534842.jpg",0,4,76,21,0,101,3.16831683168317,0.470516884515169,58.5972222222222
"415663858.jpg",0,43,58,8,0,109,2.67889908256881,0.606763330897124,45.9936974789916
"4156652933.jpg",0,6,61,38,4,109,3.36697247706422,0.647796127890209,62.5576923076923
"4157144630.jpg",0,27,77,8,0,112,2.83035714285714,0.535048921854206,50.2203389830508
"4157443022.jpg",0,1,29,77,6,113,3.7787610619469,0.546653998599275,73.6
"4157689684.jpg",3,35,59,12,0,109,2.73394495412844,0.689097663277484,47.141592920354
"4158327759.jpg",1,22,62,22,0,107,2.98130841121495,0.67266449080707,55.140625
"4162089194.jpg",0,22,63,18,0,103,2.96116504854369,0.625007138737072,52.8798076923077
"4162338388.jpg",1,7,50,48,0,106,3.36792452830189,0.652109714667755,66.5373831775701
"4163479239.jpg",1,47,55,2,0,105,2.55238095238095,0.554369919210997,42.9034653465347
"4164273130.jpg",0,1,32,67,4,104,3.71153846153846,0.551662569637779,76.1839622641509
"416573735.jpg",6,51,49,4,0,110,2.46363636363636,0.659124700752914,39.2884615384615
"4167140049.jpg",0,6,63,30,1,100,3.26,0.579445921340012,60.1123853211009
"4167190092.jpg",0,66,41,0,0,107,2.38317757009346,0.488448831121775,37.4957627118644
"4167198294.jpg",1,52,48,1,0,102,2.48039215686275,0.540084191399139,38.65
"4167927417.jpg",1,38,59,12,0,110,2.74545454545455,0.655762930372485,48.3846153846154
"416910261.jpg",9,65,26,0,0,100,2.17,0.569511575249735,30.2155963302752
"4169148705.jpg",0,8,51,37,3,99,3.35353535353535,0.674811104531185,63.025
"4169643886.jpg",1,38,80,13,0,132,2.79545454545455,0.614564158398732,48.9111111111111
"4170535749.jpg",2,20,62,19,0,103,2.95145631067961,0.677055921702001,53.4071428571429
"4171644754.jpg",0,2,65,39,1,107,3.36448598130841,0.538910910208028,64.0328947368421
"4172438232.jpg",0,1,52,51,0,104,3.48076923076923,0.521029027213842,68.5277777777778
"4172609703.jpg",1,61,48,0,0,110,2.42727272727273,0.51507710136473,39.0769230769231
"4172859607.jpg",0,14,69,23,0,106,3.08490566037736,0.587454955165592,57.4121621621622
"4172951303.jpg",0,13,72,20,0,105,3.06666666666667,0.559303596287842,56.1216814159292
"4174114328.jpg",0,1,47,52,0,100,3.51,0.522136249101959,69.4977064220184
"4174901273.jpg",0,27,67,8,0,102,2.81372549019608,0.55811550238036,48.325
"4175024777.jpg",2,53,40,4,0,99,2.46464646464646,0.611340636419152,38.1628440366973
"4176378029.jpg",1,36,50,13,0,100,2.75,0.687184270936277,47.95
"417711208.jpg",0,2,47,52,4,105,3.55238095238095,0.604167456106596,71.3899082568807
"4178406108.jpg",2,81,24,0,0,107,2.20560747663551,0.450121949031789,32.2125
"4178432884.jpg",0,33,61,6,3,103,2.79611650485437,0.676774693892692,48.4551282051282
"417853178.jpg",0,1,37,66,1,105,3.63809523809524,0.521163814564789,74.2087378640777
"4178645830.jpg",0,2,48,60,2,112,3.55357142857143,0.566946709513841,69.1673728813559
"4180311266.jpg",0,5,30,60,9,104,3.70192307692308,0.695056157433741,72.3772321428571
"418145002.jpg",0,10,64,29,0,103,3.18446601941748,0.589908148641803,58.6714285714286
"4182412787.jpg",27,67,12,0,0,106,1.85849056603774,0.592632211413952,22.2542372881356
"4182428810.jpg",4,51,67,6,0,128,2.5859375,0.634038968349601,43.504
"418308346.jpg",0,7,67,27,0,101,3.1980198019802,0.548083971307281,61.75
"4183330908.jpg",0,1,54,50,1,106,3.4811320754717,0.538624917208215,67.48125
"4184866542.jpg",1,10,62,37,0,110,3.22727272727273,0.644796972656217,58.2
"4185039279.jpg",0,0,34,71,2,107,3.70093457943925,0.499338303120032,72.7542016806723
"4186216137.jpg",0,3,59,34,0,96,3.32291666666667,0.533011141715614,64.8207547169811
"4186428624.jpg",0,0,65,38,2,105,3.4,0.529876618439831,65.8434579439252
"4187118157.jpg",0,0,26,69,8,103,3.8252427184466,0.549994375479608,76.1034482758621
"4187182991.jpg",1,30,73,9,0,113,2.79646017699115,0.584918981498998,46.9343220338983
"4190943330.jpg",0,45,58,5,0,108,2.62962962962963,0.573440063479698,44.468487394958
"4191882783.jpg",0,31,69,4,0,104,2.74038461538462,0.521297714310625,45.025
"4193122125.jpg",0,4,67,33,0,104,3.27884615384615,0.52982376203792,59.725
"4193696727.jpg",1,14,76,17,0,108,3.00925925925926,0.571853362851923,56.1631355932203
"4193794378.jpg",57,47,0,0,0,104,1.45192307692308,0.500093344535491,11.4021739130435
"4194035905.jpg",0,5,41,59,4,109,3.56880733944954,0.643586197816351,70.6418918918919
"4194428227.jpg",0,2,26,71,5,104,3.75961538461538,0.56594610720975,75.8739495798319
"4195621541.jpg",0,14,73,21,0,108,3.06481481481481,0.568209980736327,55.4210526315789
"4195632386.jpg",10,80,20,0,0,110,2.09090909090909,0.516613079807823,29.4871794871795
"4196095816.jpg",2,12,56,36,3,109,3.23853211009174,0.756442484763839,60.283185840708
"4196316000.jpg",5,74,29,0,0,108,2.22222222222222,0.517602910140264,31.73125
"4198235482.jpg",2,51,44,3,0,100,2.48,0.594248528085104,39.2429906542056
"4199130600.jpg",0,4,28,65,5,102,3.69607843137255,0.625991738886346,71.3421052631579
"4201007649.jpg",0,3,69,33,0,105,3.28571428571429,0.513552591013095,63.8960396039604
"4201088382.jpg",0,9,66,34,1,110,3.24545454545455,0.608598384263196,57.58125
"4202847613.jpg",1,40,53,6,0,100,2.64,0.611671001553461,44.0665137614679
"4204561283.jpg",10,76,23,1,0,110,2.13636363636364,0.566289593099423,28.7630434782609
"4206004485.jpg",45,51,12,1,0,109,1.71559633027523,0.695111809808002,20.1125
"4206098907.jpg",1,35,55,5,0,96,2.66666666666667,0.592348877759092,43.7867647058824
"4207059536.jpg",0,19,73,14,1,107,2.97196261682243,0.590138198161191,54.0357142857143
"4210559322.jpg",17,55,32,5,0,109,2.22935779816514,0.765373638153479,32.7625
"4210983675.jpg",0,10,66,35,0,111,3.22522522522523,0.598250246889508,60.5833333333333
"4211408239.jpg",3,20,62,19,0,104,2.93269230769231,0.700407968174264,53.25
"4213244648.jpg",0,6,44,52,3,105,3.4952380952381,0.652271320431824,66.9282608695652
"4213334951.jpg",8,69,26,1,0,104,2.19230769230769,0.575839161014367,32.8214285714286
"4213592284.jpg",0,22,72,11,0,105,2.8952380952381,0.553377905438143,49.2364864864865
"4214550696.jpg",2,10,70,28,1,111,3.14414414414414,0.658467184891574,56.8130434782609
"4214561622.jpg",1,40,59,6,0,106,2.66037735849057,0.599790319755959,45.9705882352941
"4214814193.jpg",0,0,43,58,3,104,3.61538461538462,0.545194225793602,71.640625
"4215055375.jpg",2,65,35,2,0,104,2.35576923076923,0.555960975629318,36.3349056603774
"4215952664.jpg",0,0,22,67,12,101,3.9009900990099,0.574542435248251,76.4911504424779
"4216117221.jpg",11,68,20,2,0,101,2.12871287128713,0.610956075943822,29.35
"4217228822.jpg",1,47,54,8,1,111,2.64864864864865,0.669445478106506,45.6217391304348
"4217243298.jpg",1,16,57,25,2,101,3.10891089108911,0.719735925169918,55.7566371681416
"4217551619.jpg",0,8,48,40,7,103,3.44660194174757,0.737352914409613,64.1272321428571
"4220863406.jpg",0,10,64,29,0,103,3.18446601941748,0.589908148641803,57.9469026548673
"422092606.jpg",0,2,70,28,2,102,3.29411764705882,0.537471809882315,62.1689189189189
"4222055381.jpg",0,6,73,21,0,100,3.15,0.5,57.0694444444444
"4223697086.jpg",0,6,54,45,0,105,3.37142857142857,0.592535991395376,64.472972972973
"4224633098.jpg",0,0,13,82,13,108,4,0.492940822214602,80.2146017699115
"4228738752.jpg",0,2,41,61,1,105,3.58095238095238,0.550890055709716,72.2027027027027
"4229929371.jpg",1,0,29,69,6,105,3.75238095238095,0.600976007151834,75.5420353982301
"4231049527.jpg",0,14,70,18,0,102,3.03921568627451,0.561496737908777,54.3303571428571
"4232014784.jpg",71,35,1,0,0,107,1.34579439252336,0.497214955571261,9.25
"4232963375.jpg",35,57,13,1,0,106,1.81132075471698,0.677716158413434,21.0902777777778
"4233571199.jpg",0,1,20,78,8,107,3.86915887850467,0.533484666709199,77.93125
"4234199993.jpg",0,5,56,42,0,103,3.35922330097087,0.574872005055769,66.1824324324324
"4236326911.jpg",0,19,67,16,0,102,2.97058823529412,0.587929448736755,51.5596330275229
"4236329723.jpg",20,82,11,0,0,113,1.92035398230089,0.51998614199175,24.5125
"4236732050.jpg",0,1,59,44,0,104,3.41346153846154,0.51408466914511,67.5606796116505
"4237536969.jpg",0,1,48,88,1,138,3.64492753623188,0.509769156825734,75.4206896551724
"4239274380.jpg",20,88,28,1,0,137,2.07299270072993,0.61399171886002,27.5017123287671
"4239526963.jpg",0,2,36,67,1,106,3.63207547169811,0.54029042803915,72.43125
"4240173491.jpg",0,1,35,71,5,112,3.71428571428571,0.560382292750506,73.5576923076923
"4240917469.jpg",1,22,63,15,0,101,2.91089108910891,0.634019083324628,53.425
"4241084648.jpg",54,52,1,0,0,107,1.50467289719626,0.520772861357457,13.4449152542373
"4242548000.jpg",1,5,54,37,0,97,3.30927835051546,0.618479734615924,64.7572815533981
"4243451745.jpg",0,0,34,72,2,108,3.7037037037037,0.497831921102291,74.271186440678
"4243562466.jpg",0,2,56,43,5,106,3.4811320754717,0.620769600315327,67.1398305084746
"4243875190.jpg",0,1,38,59,3,101,3.63366336633663,0.560763270502406,69.1949541284404
"4244098975.jpg",0,13,66,22,0,101,3.08910891089109,0.584790730107619,55.3888888888889
"4244935320.jpg",0,7,51,47,2,107,3.41121495327103,0.64359355256743,64.1575630252101
"4245591001.jpg",0,5,53,51,1,110,3.43636363636364,0.598580472578076,67.3525641025641
"4246091470.jpg",4,34,55,10,0,103,2.68932038834951,0.700547771860471,47.4799107142857
"4246274521.jpg",0,8,61,41,2,112,3.33035714285714,0.635133423694948,64.4615384615385
"4246970583.jpg",9,76,21,1,0,107,2.13084112149533,0.550884574245936,28.8716216216216
"4247073360.jpg",64,41,4,0,0,109,1.44954128440367,0.569051168240706,11.4173728813559
"4248616737.jpg",6,33,43,23,0,105,2.79047619047619,0.851415541852758,46.375
"42490373.jpg",0,14,46,40,3,103,3.31067961165049,0.741343854139519,62.9461206896552
"4250403356.jpg",3,76,26,1,0,106,2.23584905660377,0.508066114791276,33.2373949579832
"4251971063.jpg",0,1,28,66,2,97,3.71134020618557,0.519590441409504,75.8907766990291
"4252517673.jpg",0,4,64,36,1,105,3.32380952380952,0.563219421909541,61.722972972973
"4252888669.jpg",0,2,30,66,2,100,3.68,0.548275533473873,74.8715596330275
"4253075090.jpg",0,0,31,75,4,110,3.75454545454545,0.510196285961106,72.1995798319328
"4254945684.jpg",29,68,10,0,0,107,1.82242990654206,0.579737808534454,22.4915966386555
"4255841453.jpg",0,4,62,37,2,105,3.35238095238095,0.588037027565055,61.0540540540541
"4255843674.jpg",0,3,65,34,2,104,3.33653846153846,0.567922067043096,62.875
"4256128407.jpg",7,73,27,0,0,107,2.18691588785047,0.534310367043445,31.4891304347826
"4257293580.jpg",19,73,21,0,0,113,2.01769911504425,0.597349815030579,26.9978991596639
"4258180825.jpg",0,5,66,39,1,111,3.32432432432432,0.574648701574388,63.5741525423729
"4258446622.jpg",0,10,91,24,0,125,3.112,0.511418016007233,60.0243902439024
"4258644297.jpg",1,0,48,55,4,108,3.56481481481481,0.61557887273973,68.5252100840336
"4259043215.jpg",0,2,62,45,0,109,3.39449541284404,0.527368530639052,64.5529661016949
"4259140344.jpg",1,8,76,14,0,99,3.04040404040404,0.513475391759617,54.6635514018692
"425916994.jpg",2,62,42,4,0,110,2.43636363636364,0.598580472578076,37.575
"4259335567.jpg",1,50,48,2,0,101,2.5049504950495,0.558994854649622,39.9459459459459
"4260146768.jpg",0,2,47,52,1,102,3.50980392156863,0.55837632434446,69.6490825688073
"426081951.jpg",0,0,32,73,1,106,3.70754716981132,0.477433239054235,76.4391891891892
"4261186099.jpg",1,32,63,5,0,101,2.71287128712871,0.571605347479646,45.4
"42614998.jpg",1,22,56,25,3,107,3.06542056074766,0.768127201010196,55.5609243697479
"4262472308.jpg",0,0,33,70,0,103,3.67961165048544,0.468907621509818,70.8600917431193
"4263025475.jpg",0,3,28,65,8,104,3.75,0.634753984910078,72.277027027027
"4264601430.jpg",0,2,30,69,8,109,3.76146788990826,0.607043267858221,73.8869565217391
"4265829347.jpg",0,1,31,68,1,101,3.68316831683168,0.508540914171258,75.6183035714286
"4265877256.jpg",0,37,105,5,0,147,2.78231292517007,0.489856098561148,50.226821192053
"426656293.jpg",0,22,79,3,0,104,2.81730769230769,0.457184780831284,47.7739130434783
"4268587808.jpg",1,5,56,42,2,106,3.36792452830189,0.652109714667755,66.019801980198
"4270305165.jpg",4,47,91,8,0,150,2.68666666666667,0.614551363252953,47.0096153846154
"4270574025.jpg",7,43,48,3,0,101,2.46534653465347,0.671779077311039,39.175
"427196028.jpg",2,52,43,2,0,99,2.45454545454545,0.576278122917761,37.6238317757009
"4273357838.jpg",0,3,59,47,0,109,3.40366972477064,0.546356044118937,64.25
"4275452644.jpg",0,4,52,53,0,109,3.44954128440367,0.569051168240706,66.8526785714286
"4277299546.jpg",1,40,62,4,0,107,2.64485981308411,0.570539903993596,43.5731132075472
"4277539505.jpg",0,4,58,43,0,105,3.37142857142857,0.559139841754603,65.0675675675676
"4278181256.jpg",0,39,59,5,1,104,2.69230769230769,0.608626068135469,45.1913043478261
"4278539127.jpg",0,14,59,30,3,106,3.20754716981132,0.699890891252758,58.4703389830508
"4281546585.jpg",0,7,62,41,1,111,3.32432432432432,0.605462440275833,64.0129310344828
"4281583432.jpg",0,5,73,30,1,109,3.24770642201835,0.546977609785377,62.66875
"4281731487.jpg",0,1,22,65,11,99,3.86868686868687,0.600109932896051,78.625
"4281871655.jpg",8,76,18,0,0,102,2.09803921568627,0.497713662195456,28.9910714285714
"4282135501.jpg",1,15,62,30,0,108,3.12037037037037,0.665822414546109,56.9247787610619
"4285776519.jpg",9,70,24,0,0,103,2.14563106796116,0.549648140396204,29.6370192307692
"4286933249.jpg",0,1,33,72,2,108,3.69444444444444,0.519855000152735,74.4097222222222
"4286953087.jpg",9,57,42,3,0,111,2.35135135135135,0.669445478106506,35.3983050847458
"4287953710.jpg",2,23,74,8,0,107,2.82242990654206,0.579737808534454,51.53125
"4288180189.jpg",0,27,62,15,0,104,2.88461538461538,0.627952325005221,50.5717391304348
"4289036535.jpg",7,58,35,1,0,101,2.2970297029703,0.609008283284317,33.2699115044248
"4290975910.jpg",2,36,54,11,0,103,2.71844660194175,0.677618027171757,48.7430555555556
"4292573500.jpg",0,1,55,54,1,111,3.4954954954955,0.537229828486737,65.4618644067797
"4293785816.jpg",6,36,53,10,0,105,2.63809523809524,0.73541994183085,41.9527027027027
"4294746447.jpg",5,72,32,0,0,109,2.24770642201835,0.529779187103462,33.510593220339
"4295279371.jpg",0,18,74,10,0,102,2.92156862745098,0.520591333800132,49.9260869565217
"4295525241.jpg",3,59,65,3,0,130,2.52307692307692,0.586876961279263,40.4511278195489
"4296403133.jpg",15,67,22,1,0,105,2.08571428571429,0.621943073611393,28.7700892857143
"4296647005.jpg",0,1,44,60,2,107,3.58878504672897,0.548639329374549,72.3428571428571
"4297219009.jpg",2,56,48,2,0,108,2.46296296296296,0.570717304456499,40.8026315789474
"4297599043.jpg",0,6,102,46,1,155,3.27096774193548,0.538271372433303,63.7
"4297818651.jpg",3,62,67,2,0,134,2.50746268656716,0.571849244773144,41.25
"4298067776.jpg",0,1,47,52,3,103,3.55339805825243,0.572715501692198,72.7
"4298186333.jpg",0,2,50,57,2,111,3.53153153153153,0.569207101147486,69.5169491525424
"4298923773.jpg",0,22,69,12,0,103,2.90291262135922,0.569047417073793,54.0044247787611
"4299216840.jpg",83,21,1,2,0,107,1.27102803738318,0.575770090678299,6.68487394957983
"4299510764.jpg",0,0,53,49,2,104,3.50961538461538,0.539600576976746,67.8761061946903
"4299890430.jpg",0,8,66,33,0,107,3.23364485981308,0.575923200663901,62.6148648648649
"4300118450.jpg",0,2,46,55,1,104,3.52884615384615,0.556632223656022,71.3948598130841
"4300400521.jpg",1,32,64,4,0,101,2.7029702970297,0.557576083695231,45.475
"430051470.jpg",0,10,96,35,0,141,3.17730496453901,0.538300074882063,62.2857142857143
"4302524395.jpg",2,62,74,2,0,140,2.54285714285714,0.554529142041311,42.530612244898
"4304984630.jpg",0,5,57,41,2,105,3.38095238095238,0.610500305250229,63.7995689655172
"4305975001.jpg",0,1,27,69,5,102,3.76470588235294,0.548200848288349,73.9977678571429
"4306124216.jpg",25,66,15,0,0,106,1.90566037735849,0.609891510833298,23.0982142857143
"4307315285.jpg",0,5,51,41,0,97,3.37113402061856,0.583087822660281,67.4852941176471
"4309440479.jpg",0,16,105,33,0,154,3.11038961038961,0.554973806267453,58.75
"430961914.jpg",0,1,45,56,2,104,3.56730769230769,0.553267839716467,69.3469827586207
"4310499723.jpg",1,19,73,13,0,106,2.92452830188679,0.580609092452912,52.5086956521739
"4311062470.jpg",0,2,70,36,2,110,3.34545454545455,0.549167236712308,64.5394736842105
"4312794040.jpg",0,7,62,37,2,108,3.31481481481481,0.621246081965842,62.9789915966387
"4313162470.jpg",0,1,57,51,0,109,3.45871559633028,0.518761168407095,67.2079831932773
"4313852687.jpg",0,0,40,64,3,107,3.65420560747664,0.53381510010521,70.327731092437
"4315078660.jpg",0,52,49,6,0,107,2.57009345794393,0.600505283038207,41.6207627118644
"4316201498.jpg",0,6,47,49,4,106,3.4811320754717,0.665205046446965,67.2946428571429
"4316264959.jpg",0,6,57,47,0,110,3.37272727272727,0.588250257377267,65.0423728813559
"4319709983.jpg",0,6,57,40,0,103,3.33009708737864,0.583907552355093,65.466814159292
"4319921272.jpg",4,42,55,3,0,104,2.54807692307692,0.62130160417126,40.7635135135135
"4320399633.jpg",0,8,73,27,0,108,3.17592592592593,0.543933470775587,61.7075471698113
"4321538602.jpg",0,1,54,46,0,101,3.44554455445545,0.519138662107774,64.8478260869565
"432158024.jpg",0,1,25,72,4,102,3.77450980392157,0.524769874035287,74.2543103448276
"4321643395.jpg",0,12,68,32,0,112,3.17857142857143,0.603507551088936,59.8782051282051
"4321708869.jpg",0,24,69,8,0,101,2.84158415841584,0.542819919813684,51.0347222222222
"432256405.jpg",1,24,64,19,0,108,2.93518518518519,0.659554482145832,53.5063559322034
"4323308644.jpg",0,3,56,46,1,106,3.42452830188679,0.568173568509905,64.0840517241379
"4323755897.jpg",0,7,65,36,0,108,3.26851851851852,0.573666376741214,61.4256756756757
"4324984866.jpg",0,6,63,35,0,104,3.27884615384615,0.565285919050108,63.3419811320755
"4324997197.jpg",0,53,48,5,0,106,2.54716981132075,0.587684325235566,42.5369565217391
"4325351330.jpg",1,18,71,9,0,99,2.88888888888889,0.551230328704296,52.3422330097087
"432860543.jpg",0,1,8,87,6,102,3.96078431372549,0.420315031013714,84.0347222222222
"4330138497.jpg",0,1,29,69,7,106,3.77358490566038,0.573759844699016,76.4399038461538
"4331601397.jpg",0,2,62,42,1,107,3.39252336448598,0.545254127107898,65.3919491525424
"4333231936.jpg",4,68,30,1,0,103,2.27184466019417,0.54582505919096,33.7027027027027
"4333476367.jpg",32,47,22,8,0,109,2.05504587155963,0.890639204347508,29.25625
"4335495125.jpg",13,78,13,0,0,104,2,0.502421321667402,25.3040540540541
"4335627943.jpg",0,6,75,22,0,103,3.15533980582524,0.500142755177784,61.6527777777778
"4335962068.jpg",0,21,51,33,0,105,3.11428571428571,0.711367665869033,57.203125
"4336185725.jpg",0,2,51,52,0,105,3.47619047619048,0.538788493096354,68.5894495412844
"4336460350.jpg",0,0,33,68,0,101,3.67326732673267,0.471357844765293,75.3236607142857
"4336745838.jpg",0,10,67,27,1,105,3.18095238095238,0.600976007151834,61.9538834951456
"4336949009.jpg",0,2,43,63,0,108,3.56481481481481,0.534302727522781,68.2411504424779
"433731087.jpg",14,78,10,1,0,103,1.98058252427184,0.523573365540465,24.325
"4337515200.jpg",0,3,62,35,4,104,3.38461538461538,0.612296208343076,64.3685344827586
"4338156096.jpg",0,4,63,40,2,109,3.36697247706422,0.58784840667937,64.421875
"4340329166.jpg",0,0,36,67,3,106,3.68867924528302,0.523053444363363,72.2629310344828
"434108213.jpg",2,59,41,5,0,107,2.45794392523365,0.618585938139312,38.8782608695652
"434127863.jpg",1,11,60,31,2,105,3.20952380952381,0.689135998848141,58.3080357142857
"4343097092.jpg",0,3,55,48,1,107,3.4392523364486,0.569302288861533,66.2826086956522
"4343304474.jpg",1,38,57,10,0,106,2.71698113207547,0.643720095651342,47.0067567567568
"4344642946.jpg",0,0,32,71,2,105,3.71428571428571,0.494474968532781,74.3254310344828
"4345036113.jpg",0,1,25,73,4,103,3.77669902912621,0.522663593583743,76.7101769911504
"4345778112.jpg",0,0,34,65,2,101,3.68316831683168,0.508540914171258,72.925
"4345842908.jpg",0,9,78,20,0,107,3.10280373831776,0.512753930451479,57.2767857142857
"434605634.jpg",0,0,39,61,5,105,3.67619047619048,0.563219421909541,70.0581896551724
"4346944645.jpg",0,3,45,54,2,104,3.52884615384615,0.59048656535823,68.004347826087
"4346999174.jpg",0,2,29,68,3,102,3.70588235294118,0.555587910790175,72.3738532110092
"4347028779.jpg",0,4,68,28,0,100,3.24,0.514830559553826,60.85
"4347235307.jpg",0,2,14,89,7,112,3.90178571428571,0.501525985396883,76.75
"4347675881.jpg",1,31,60,21,0,113,2.89380530973451,0.699015019489249,50.0769230769231
"434815119.jpg",19,77,9,0,0,105,1.9047619047619,0.509973783711732,22.9521739130435
"435179511.jpg",0,0,13,73,13,99,4,0.515078753637713,77.9513274336283
"4352372142.jpg",2,1,37,65,1,106,3.58490566037736,0.630463541158059,71.2723214285714
"4353430545.jpg",23,103,26,0,0,152,2.01973684210526,0.569307639653154,27.2697368421053
"4353485101.jpg",9,63,33,2,0,107,2.26168224299065,0.634487589990163,32.3938053097345
"4353658003.jpg",56,47,6,1,0,110,1.56363636363636,0.642918699145877,15.09375
"4356238035.jpg",0,26,69,11,0,106,2.85849056603774,0.576337851401217,51.504347826087
"4356674628.jpg",0,3,77,29,0,109,3.23853211009174,0.488745229564809,60.7212389380531
"4357293162.jpg",0,2,43,65,1,111,3.58558558558559,0.547198957808492,71.4745762711864
"435823507.jpg",0,1,46,57,0,104,3.53846153846154,0.519952890380548,68.0760869565217
"4358436337.jpg",0,5,48,53,2,108,3.48148148148148,0.61873373074401,64.9201680672269
"4359434065.jpg",0,1,31,71,4,107,3.72897196261682,0.542010468776289,76.1261061946903
"4359682859.jpg",0,0,15,84,6,105,3.91428571428571,0.441027770673792,78.1913043478261
"4359967769.jpg",0,36,69,5,0,110,2.71818181818182,0.544055754391562,46.4115044247788
"4360105019.jpg",11,115,24,0,0,150,2.08666666666667,0.476799546566756,29.4652317880795
"4360193081.jpg",0,2,38,62,0,102,3.58823529411765,0.53311973979568,72.8235294117647
"4360974596.jpg",0,29,76,4,0,109,2.77064220183486,0.502457433666732,48.4201680672269
"4363262095.jpg",0,8,80,19,0,107,3.10280373831776,0.494012822369155,58.0067567567568
"4364606780.jpg",0,3,21,72,15,111,3.89189189189189,0.651590380968001,78.9625
"4364793888.jpg",0,0,44,60,5,109,3.64220183486239,0.569647970888463,72.7330508474576
"4365387751.jpg",0,4,42,59,0,105,3.52380952380952,0.573371239908821,67.2946428571429
"4367292033.jpg",0,7,70,29,0,106,3.20754716981132,0.547148123621374,58.8223684210526
"4367864472.jpg",0,17,79,24,2,122,3.09016393442623,0.629890432039156,57.4327731092437
"4370903350.jpg",1,14,56,37,0,108,3.19444444444444,0.689823671541732,58.54375
"4370988573.jpg",4,59,34,9,0,106,2.45283018867925,0.705516703210162,39.0609243697479
"4371356797.jpg",0,27,72,11,1,111,2.87387387387387,0.604785718883776,49.3409090909091
"4372249937.jpg",3,69,33,1,0,106,2.30188679245283,0.537539567903605,35.3630434782609
"4373157351.jpg",1,9,72,26,0,108,3.13888888888889,0.587380265521398,58.6800847457627
"4373225530.jpg",0,5,63,61,0,129,3.43410852713178,0.570703530197462,68.75
"4374031327.jpg",0,3,66,34,0,103,3.30097087378641,0.520839282280893,62.9142857142857
"4374263037.jpg",0,8,51,42,0,101,3.33663366336634,0.620922341726762,61.6964285714286
"43749901.jpg",3,61,38,4,0,106,2.40566037735849,0.613782990761741,37.3559322033898
"4376625237.jpg",1,45,54,3,0,103,2.57281553398058,0.570550847480092,41.0389908256881
"4376675146.jpg",8,49,43,4,0,104,2.41346153846154,0.691285237843067,38.6169724770642
"4378419360.jpg",0,5,53,41,1,100,3.38,0.599326221011495,62.6857798165138
"4383247323.jpg",5,23,57,17,0,102,2.84313725490196,0.754459980491137,48.3050458715596
"4384734404.jpg",7,57,35,2,0,101,2.31683168316832,0.631358742226746,35.4009433962264
"4385399670.jpg",2,22,73,16,0,113,2.91150442477876,0.63467542497684,50.4294871794872
"4388983100.jpg",5,65,34,1,0,105,2.2952380952381,0.570489154548862,32.5878378378378
"4389152317.jpg",0,0,34,71,1,106,3.68867924528302,0.485272776451698,76.3014705882353
"4389836139.jpg",4,49,44,5,0,102,2.49019607843137,0.656198141399797,37.5357142857143
"4389975585.jpg",0,4,66,34,1,105,3.3047619047619,0.556842221884494,60.2364864864865
"4390875397.jpg",0,16,74,14,0,104,2.98076923076923,0.539341008015854,56.0252293577982
"4391005979.jpg",0,26,80,2,0,108,2.77777777777778,0.460258629718694,47.3157894736842
"4391517237.jpg",0,11,70,21,0,102,3.09803921568627,0.554188442797278,54.8899082568807
"4393459228.jpg",0,1,34,69,2,106,3.67924528301887,0.526392390510218,75.8392857142857
"4394545032.jpg",3,16,74,14,0,107,2.92523364485981,0.624966936173566,51.964953271028
"4395388551.jpg",0,4,62,39,2,107,3.36448598130841,0.589091455315854,63.9495798319328
"4396087406.jpg",0,7,72,29,0,108,3.2037037037037,0.542738973753511,59.4189189189189
"4396643142.jpg",0,1,29,67,6,103,3.75728155339806,0.568210459101958,72.925
"4397008731.jpg",1,18,66,25,1,111,3.06306306306306,0.677955204732038,54.0656779661017
"4397075898.jpg",0,2,33,70,0,105,3.64761904761905,0.518521425656133,71.0884955752212
"439745674.jpg",3,47,51,7,0,108,2.57407407407407,0.658569728973095,41.2875
"4397886158.jpg",0,7,69,32,0,108,3.23148148148148,0.557136897914997,61.1381578947368
"4398385361.jpg",0,0,14,77,14,105,4,0.518874521662771,80.4418103448276
"44009500.jpg",88,21,0,0,0,109,1.19266055045872,0.396210386971541,5.5
"4401185827.jpg",5,33,59,10,0,107,2.69158878504673,0.705921249459935,46.0953389830508
"440297710.jpg",0,13,64,24,1,102,3.12745098039216,0.624128201914296,57.5277777777778
"4404389524.jpg",1,46,54,5,0,106,2.59433962264151,0.598065164259555,42.9932432432432
"4404462627.jpg",0,18,74,14,0,106,2.9622641509434,0.550748897962917,52.8571428571429
"4405802084.jpg",1,34,73,3,0,111,2.7027027027027,0.532482942016064,46.5883620689655
"4406684120.jpg",0,6,81,19,0,106,3.12264150943396,0.472134568966241,59.78125
"4406927427.jpg",2,13,70,15,1,101,3,0.632455532033676,53.1490825688073
"4407707944.jpg",0,2,25,73,3,103,3.74757281553398,0.537212241292896,72.7972972972973
"4407839974.jpg",0,6,60,39,0,105,3.31428571428571,0.577032956569235,61.5
"4408351965.jpg",0,6,64,30,2,102,3.27450980392157,0.599618075558597,61.1681034482759
"4409503429.jpg",8,80,16,1,0,105,2.0952380952381,0.509973783711732,29.1689189189189
"4410900135.jpg",8,81,10,1,0,100,2.04,0.469687194424183,25.8243243243243
"4410907563.jpg",0,52,48,6,1,107,2.58878504672897,0.64359355256743,41.21875
"4411055719.jpg",18,74,13,0,0,105,1.95238095238095,0.543863535997355,24.1163366336634
"4411284601.jpg",0,6,57,40,0,103,3.33009708737864,0.583907552355093,62.6282051282051
"4411449023.jpg",0,4,51,42,0,97,3.39175257731959,0.569296002220576,66.6108490566038
"441241455.jpg",1,46,76,3,0,126,2.64285714285714,0.543533413350616,45
"4413028246.jpg",0,1,45,60,4,110,3.60909090909091,0.57621757080761,70.3445945945946
"4414969933.jpg",0,3,57,37,0,97,3.35051546391753,0.540856518122761,66.8382352941177
"4416477559.jpg",0,1,32,69,3,105,3.7047619047619,0.535720390685605,71.5337837837838
"4418637804.jpg",1,5,41,59,1,107,3.50467289719626,0.649728996853956,70.1216216216216
"4420506536.jpg",0,1,49,54,3,107,3.55140186915888,0.570230752031589,69.13125
"4420983663.jpg",6,76,22,1,0,105,2.17142857142857,0.527277894493955,30.2837837837838
"4422544352.jpg",0,5,55,43,2,105,3.4,0.61394061351492,63.8881578947368
"4422726404.jpg",0,2,47,51,3,103,3.53398058252427,0.591036543453699,68.1049107142857
"4423100872.jpg",40,63,4,0,0,107,1.66355140186916,0.548478603040537,17.1413043478261
"4423467099.jpg",0,19,64,22,0,105,3.02857142857143,0.627221327289334,56.1067961165049
"4423499380.jpg",0,7,66,35,1,109,3.27522935779817,0.591162690414024,59.4491525423729
"4423525827.jpg",2,28,69,6,0,105,2.75238095238095,0.584757549708759,47.7242990654206
"4424481742.jpg",0,1,41,69,1,112,3.625,0.522036897663874,73.0641025641026
"4424741537.jpg",0,9,66,34,1,110,3.24545454545455,0.608598384263196,61.6410256410256
"4425198356.jpg",0,2,62,40,0,104,3.36538461538462,0.522460428337392,66.1911764705882
"4426149096.jpg",0,5,79,54,1,139,3.36690647482014,0.566503193284249,66.7032374100719
"4428546636.jpg",0,23,91,11,0,125,2.904,0.514687503060305,53.3170731707317
"4429141481.jpg",0,1,39,71,2,113,3.65486725663717,0.530665207620599,71.8529411764706
"4429610219.jpg",0,2,21,86,4,113,3.8141592920354,0.509703565221487,74.2628205128205
"4429773001.jpg",0,2,49,60,1,112,3.53571428571429,0.552285528526056,69.75
"4430203972.jpg",0,2,46,50,2,100,3.52,0.577000253838153,67.7638888888889
"4430414110.jpg",0,1,12,81,14,108,4,0.529503382213656,79.3403361344538
"4430662019.jpg",1,33,60,14,0,108,2.80555555555556,0.662173330970994,49.2415254237288
"4432333136.jpg",16,79,8,0,0,103,1.92233009708738,0.478750833477993,23.2908653846154
"4432502474.jpg",0,5,64,32,0,101,3.26732673267327,0.545730503250659,59.506880733945
"4433497740.jpg",0,8,60,34,0,102,3.25490196078431,0.591796635357012,60.7212389380531
"4434357623.jpg",1,1,35,67,7,111,3.7027027027027,0.640945247904071,71.5444915254237
"4435718106.jpg",3,16,70,18,0,107,2.96261682242991,0.657686534912265,55.3529411764706
"4435765484.jpg",0,9,74,18,0,101,3.08910891089109,0.511840012132504,56.7821100917431
"4436002363.jpg",3,22,60,14,0,99,2.85858585858586,0.685269215830776,51.2208737864078
"4436568659.jpg",0,3,60,47,1,111,3.41441441441441,0.563567669058932,67.0705128205128
"443706084.jpg",0,3,67,32,0,102,3.2843137254902,0.514684388158128,61.2943925233645
"443805629.jpg",0,6,67,25,0,98,3.19387755102041,0.530670909055369,59.7721238938053
"4438338527.jpg",0,17,57,27,2,103,3.13592233009709,0.700819459973016,59.3392857142857
"4439151807.jpg",0,0,18,83,10,111,3.92792792792793,0.499303364002136,79.8333333333333
"4441487494.jpg",0,1,54,52,0,107,3.47663551401869,0.52026470752557,69.8986486486486
"4441540278.jpg",0,6,64,35,5,110,3.35454545454545,0.657858126368209,64.2745535714286
"4441586110.jpg",0,6,41,53,2,102,3.5,0.641007869771433,68.464953271028
"4441689311.jpg",0,7,67,39,0,113,3.28318584070796,0.574285682837392,60.8304347826087
"4441990593.jpg",0,0,37,59,4,100,3.67,0.551490175924662,72.1658878504673
"4442175074.jpg",0,0,8,83,14,105,4.05714285714286,0.456335138074813,82.7826086956522
"4443705808.jpg",5,65,26,6,0,102,2.32352941176471,0.662455150073616,34.6513157894737
"4446289911.jpg",4,68,32,1,0,105,2.28571428571429,0.549725206078275,35.03125
"4447897373.jpg",1,23,72,14,0,110,2.9,0.605024830789249,49.88125
"4448002516.jpg",0,1,47,53,4,105,3.57142857142857,0.586009038673119,71.2364864864865
"4448707293.jpg",0,1,22,73,10,106,3.86792452830189,0.57030437484212,74.4809322033898
"4456140613.jpg",0,0,13,95,3,111,3.90990990990991,0.370492290425236,77.4358974358974
"4456369143.jpg",0,10,60,39,1,110,3.28181818181818,0.637250662617026,62.385593220339
"4458082894.jpg",0,22,71,15,0,108,2.93518518518519,0.584426360625035,52.1644736842105
"445846327.jpg",0,0,16,82,9,107,3.93457943925234,0.481174428761569,80.275
"4458877862.jpg",1,38,56,10,0,105,2.71428571428571,0.646206172658864,45.462389380531
"4459598484.jpg",0,3,61,46,1,111,3.40540540540541,0.562112547423126,65.4353448275862
"4460254023.jpg",0,3,37,61,0,101,3.57425742574257,0.55401326073417,69.2916666666667
"4462477090.jpg",2,37,59,5,0,103,2.6504854368932,0.605671525940304,43.8365384615385
"4463196857.jpg",8,58,33,2,0,101,2.28712871287129,0.637755966861406,31.1526548672566
"4463467980.jpg",0,0,19,63,26,108,4.06481481481481,0.645229049356591,80.81875
"4463917829.jpg",0,26,75,9,0,110,2.84545454545455,0.544974768145213,50.1316964285714
"4464186761.jpg",0,0,20,75,6,101,3.86138613861386,0.490503883171113,77.725
"4466660724.jpg",0,1,55,43,1,100,3.44,0.53785958138991,70.0841121495327
"446796521.jpg",4,67,34,1,0,106,2.30188679245283,0.554974239140533,34.9326086956522
"4468108530.jpg",0,13,57,34,0,104,3.20192307692308,0.64431506030669,60.6957547169811
"4468449550.jpg",2,13,62,29,0,106,3.11320754716981,0.680626528133925,58.5290178571429
"4469938423.jpg",3,12,71,22,0,108,3.03703703703704,0.654615902590098,55.5540540540541
"4471526544.jpg",0,8,66,35,0,109,3.24770642201835,0.579846137042889,61.8262711864407
"4472735511.jpg",0,21,69,14,0,104,2.93269230769231,0.578991810008362,51.925
"4473061240.jpg",0,13,52,38,2,105,3.27619047619048,0.700209283209699,60.6081081081081
"4475438101.jpg",0,1,59,47,2,109,3.45871559633028,0.553308401241235,65.9868421052632
"4476029726.jpg",0,8,43,46,5,102,3.47058823529412,0.713461542989927,67.2972972972973
"4476603465.jpg",0,5,52,49,6,112,3.5,0.671156055214024,68.635775862069
"447697089.jpg",0,4,54,46,3,107,3.44859813084112,0.617872870538444,67.8481308411215
"4478081768.jpg",2,36,83,4,0,125,2.712,0.550893702058521,47.0512295081967
"4478237731.jpg",1,9,70,30,3,113,3.2212389380531,0.664595920121181,60.5525210084034
"447977798.jpg",0,15,68,18,0,101,3.02970297029703,0.573680146851091,57.3621495327103
"4480082097.jpg",0,0,25,81,4,110,3.80909090909091,0.478826059576378,76.3782051282051
"4483042022.jpg",0,2,64,41,0,107,3.36448598130841,0.521111355290732,65.7364864864865
"448305008.jpg",0,5,58,48,2,113,3.41592920353982,0.608359382109172,66.3067226890756
"4483151821.jpg",5,62,33,4,0,104,2.34615384615385,0.635048056727989,36.1172566371681
"4484527101.jpg",0,1,60,37,2,100,3.4,0.55048188256318,66.325
"4486733557.jpg",0,8,69,24,0,101,3.15841584158416,0.542819919813684,58.975
"4488104431.jpg",0,48,55,4,0,107,2.58878504672897,0.565573194436278,43.5413043478261
"4488491323.jpg",1,56,39,2,0,98,2.42857142857143,0.556127998320049,37.4932432432432
"4489064763.jpg",1,10,55,32,4,102,3.27450980392157,0.733320979052674,64.3509174311927
"4489102480.jpg",1,11,74,25,0,111,3.10810810810811,0.593163343306675,55.9533898305085
"4490789851.jpg",0,2,25,74,4,105,3.76190476190476,0.5463833805441,77.6188118811881
"4491574274.jpg",0,1,36,69,2,108,3.66666666666667,0.529503382213656,71.3421052631579
"4492079346.jpg",0,13,61,28,2,104,3.18269230769231,0.664851586868538,60.8692660550459
"4492298311.jpg",0,5,35,67,2,109,3.60550458715596,0.608859720872538,67.3466386554622
"4493244545.jpg",0,1,28,75,4,108,3.75925925925926,0.527210439999348,72.2689075630252
"449395753.jpg",1,13,66,18,0,98,3.03061224489796,0.599898301220532,54.4
"4495516735.jpg",0,5,60,43,1,109,3.36697247706422,0.58784840667937,63.8109243697479
"4495630749.jpg",0,1,22,83,4,110,3.81818181818182,0.491800999917243,76.35
"4495910719.jpg",2,36,54,11,0,103,2.71844660194175,0.677618027171757,45.4661016949153
"4496338663.jpg",3,41,53,3,0,100,2.56,0.608359277155375,42.7897196261682
"4497186913.jpg",1,19,82,7,0,109,2.87155963302752,0.511006947680403,51.0110619469027
"4497739993.jpg",0,11,60,37,1,109,3.25688073394495,0.6441139438647,63.5685840707965
"4499122119.jpg",9,73,15,4,0,101,2.13861386138614,0.616923057930193,29.2960526315789
"450063799.jpg",0,12,58,32,0,102,3.19607843137255,0.62993345061479,61.3472222222222
"45015821.jpg",26,69,10,2,0,107,1.88785046728972,0.63434861559577,23.9322033898305
"4501585211.jpg",22,75,10,1,0,108,1.90740740740741,0.572533915855149,22.0995575221239
"4502165045.jpg",0,9,82,19,0,110,3.09090909090909,0.498538313848908,56.6138392857143
"4502409601.jpg",23,61,14,1,0,99,1.92929292929293,0.642897224981,24.628640776699
"450338979.jpg",70,31,2,0,0,103,1.33980582524272,0.515512272504728,7.2787610619469
"450407660.jpg",0,16,63,34,5,118,3.23728813559322,0.735869345771426,61.7115384615385
"4504123530.jpg",0,9,57,45,2,113,3.35398230088496,0.653566506375115,65.0588235294118
"4504355317.jpg",0,0,15,80,7,102,3.92156862745098,0.460010213184165,78.5654205607477
"4504786016.jpg",1,40,60,8,0,109,2.68807339449541,0.619098025302731,45.3163716814159
"4506321902.jpg",0,3,56,37,0,96,3.35416666666667,0.542492622635585,65.0357142857143
"450789020.jpg",0,31,66,7,0,104,2.76923076923077,0.561391634768236,49.6824324324324
"4509028861.jpg",0,11,89,8,0,108,2.97222222222222,0.420465548242144,54.0044247787611
"4510024370.jpg",0,1,40,62,2,105,3.61904761904762,0.543863535997355,71.6725663716814
"4511318356.jpg",0,1,47,52,0,100,3.51,0.522136249101959,72.126213592233
"4512110934.jpg",17,51,33,1,0,102,2.17647058823529,0.709368212920921,30.5183486238532
"4512123861.jpg",0,2,51,79,0,132,3.58333333333333,0.524828822208599,74.2423664122137
"4512474932.jpg",0,2,33,66,2,103,3.66019417475728,0.552239612285735,74.8680555555556
"4513142635.jpg",1,41,56,3,0,101,2.6039603960396,0.567083907738389,42.3973214285714
"4513570407.jpg",0,0,19,75,3,97,3.83505154639175,0.449082684738522,80.4855769230769
"4515471665.jpg",0,5,53,44,2,104,3.41346153846154,0.617080141812204,65.4353448275862
"4515954109.jpg",32,70,5,0,0,107,1.74766355140187,0.533649908982546,20.0651260504202
"451764144.jpg",0,5,56,49,2,112,3.42857142857143,0.610925832839284,63.7139830508475
"4518358107.jpg",3,43,51,2,0,99,2.52525252525253,0.594934987760785,39.8142857142857
"4518414673.jpg",5,38,73,9,0,125,2.688,0.664976351750268,47.0792682926829
"4519546786.jpg",0,10,66,38,0,114,3.24561403508772,0.603256700064703,59.395652173913
"4520096475.jpg",0,15,60,29,2,106,3.16981132075472,0.68273536828607,56.6525423728814
"4520380552.jpg",0,20,69,22,0,111,3.01801801801802,0.617649238233628,55.3940677966102
"4521235979.jpg",8,36,53,9,0,106,2.59433962264151,0.753130632908142,41.5133928571429
"4522459343.jpg",0,0,34,69,4,107,3.7196261682243,0.528336523035191,75.25
"4524543534.jpg",0,9,65,30,2,106,3.23584905660377,0.625671247807053,61.8163716814159
"4524766514.jpg",0,1,23,78,3,105,3.79047619047619,0.494104436469856,79.0344036697248
"4525361026.jpg",0,4,51,41,0,96,3.38541666666667,0.568836146358078,65.8894230769231
"4525459727.jpg",0,1,30,71,4,106,3.73584905660377,0.539874532027984,76.6
"4525595896.jpg",0,15,80,15,0,110,3,0.524623062587002,53.8445945945946
"4525681285.jpg",2,22,72,9,0,105,2.83809523809524,0.590368358344854,47.2297297297297
"4526077589.jpg",0,3,54,48,2,107,3.45794392523365,0.587292698581456,65.1974789915966
"4526456137.jpg",0,1,26,75,2,104,3.75,0.497566895536651,72.5
"452671189.jpg",32,59,15,1,0,107,1.85981308411215,0.679186501894357,23.4665178571429
"452715885.jpg",0,10,70,21,1,102,3.12745098039216,0.574569466497057,57.1987179487179
"4528580529.jpg",0,1,36,71,1,109,3.6605504587156,0.513163454687334,75.5369565217391
"4529654985.jpg",5,80,23,0,0,108,2.16666666666667,0.483368244522832,32.1822033898305
"4530384020.jpg",0,7,64,36,0,107,3.27102803738318,0.575770090678299,63.6214285714286
"4530875549.jpg",0,5,36,56,6,103,3.61165048543689,0.674943856906078,72.1857142857143
"45323583.jpg",70,32,1,0,0,103,1.33009708737864,0.492857803033533,10.025641025641
"4532664267.jpg",5,37,60,9,0,111,2.65765765765766,0.694072245329174,43.7058823529412
"4533734353.jpg",20,58,24,3,0,105,2.0952380952381,0.727532837268552,30.0223214285714
"4535431418.jpg",3,24,56,20,3,106,2.9622641509434,0.803854148129193,51.2823275862069
"4535544675.jpg",0,1,26,88,6,121,3.81818181818182,0.516397779494322,78.9625
"4535634069.jpg",0,7,59,44,0,110,3.33636363636364,0.594736434219807,64.8141025641026
"4537863241.jpg",0,9,73,26,0,108,3.15740740740741,0.549630921823901,60.1378504672897
"4538412115.jpg",41,61,5,0,0,107,1.66355140186916,0.565417281767723,17.7079831932773
"4538779976.jpg",1,27,69,3,1,101,2.76237623762376,0.568304757176731,47.575
"4539089246.jpg",0,3,56,45,0,104,3.40384615384615,0.548948346186761,64.8638392857143
"4539567531.jpg",0,25,70,8,0,103,2.83495145631068,0.544078414522961,48.6584821428571
"4539671181.jpg",0,1,35,72,0,108,3.65740740740741,0.496003411147394,73.0641025641026
"4540896523.jpg",2,53,47,2,0,104,2.47115384615385,0.573809121695014,38.9934210526316
"4541000790.jpg",0,0,17,81,10,108,3.93518518518519,0.498092588850898,79.7765486725664
"4541090785.jpg",0,44,61,3,0,108,2.62037037037037,0.542021011983518,44.5572033898305
"4542216557.jpg",0,0,47,53,2,102,3.55882352941176,0.537200838445943,71.6009615384615
"4542866851.jpg",4,36,62,10,0,112,2.69642857142857,0.682328891058202,45.2563559322034
"4543035277.jpg",0,1,31,68,3,103,3.70873786407767,0.535615240179964,72.8318965517241
"4545054058.jpg",23,73,12,0,0,108,1.89814814814815,0.562700677637197,24.7012711864407
"4548390935.jpg",0,0,33,69,1,103,3.68932038834951,0.485659571999109,76.1261061946903
"4548596684.jpg",1,15,66,23,0,105,3.05714285714286,0.632889761766969,57.070796460177
"4549109010.jpg",0,2,48,53,0,103,3.49514563106796,0.540039693671242,71.125
"4549687373.jpg",0,2,80,30,0,112,3.25,0.47457899787625,60.7948717948718
"4550104555.jpg",0,3,42,51,1,97,3.51546391752577,0.579392678835917,69.4264705882353
"4551121129.jpg",0,0,13,84,9,106,3.9622641509434,0.456164721750019,80.9173913043478
"4551794095.jpg",0,1,41,59,2,103,3.60194174757282,0.548434596262224,72.5
"4555534725.jpg",38,65,5,1,0,109,1.71559633027523,0.594601377819567,18.2960526315789
"4555936051.jpg",0,0,31,73,4,108,3.75,0.513827492052328,74.6953781512605
"4556815018.jpg",0,0,64,37,1,102,3.38235294117647,0.508231600107372,63.4861111111111
"4556962196.jpg",0,3,60,37,0,100,3.34,0.535978289926679,63.4426605504587
"4561013937.jpg",1,17,72,19,0,109,3,0.608580619450185,52.3877118644068
"4562682674.jpg",2,58,44,6,0,110,2.49090909090909,0.63166380771075,39.8928571428571
"4562998069.jpg",0,1,28,72,0,101,3.7029702970297,0.480511278857126,72.1944444444444
"4563172093.jpg",0,2,38,55,4,99,3.61616161616162,0.601139576088797,71.125
"456472871.jpg",0,7,59,35,4,105,3.34285714285714,0.662579043594792,62.5803571428571
"4565000392.jpg",1,12,51,36,0,100,3.22,0.69019101440372,57.2898230088496
"4565683087.jpg",0,2,23,72,10,107,3.8411214953271,0.601092287365109,80.3680555555556
"4567181047.jpg",0,1,43,56,2,102,3.57843137254902,0.552873224323927,69.6490825688073
"4567215412.jpg",1,35,59,8,0,103,2.71844660194175,0.617037128703877,47.6714285714286
"4567762490.jpg",0,1,39,64,6,110,3.68181818181818,0.589383415677403,73.275641025641
"4568018818.jpg",0,0,37,69,1,107,3.66355140186916,0.494191262982657,73.0127118644068
"4568150681.jpg",0,0,29,82,4,115,3.78260869565217,0.491731789246233,74.2543103448276
"4570337647.jpg",1,22,70,9,0,102,2.85294117647059,0.569819475035116,48.6077981651376
"4570575045.jpg",1,9,70,27,0,107,3.14953271028037,0.595640424609829,57.2941176470588
"4571847379.jpg",0,23,70,14,0,107,2.91588785046729,0.584734987983232,53.1517857142857
"4571937568.jpg",0,15,73,17,0,105,3.01904761904762,0.554369919210997,56.2894736842105
"4572287798.jpg",1,20,69,11,1,102,2.91176470588235,0.615041513152086,50.3565217391304
"4572672183.jpg",2,31,60,14,0,107,2.80373831775701,0.679056675552371,50.2203389830508
"4573273622.jpg",0,1,45,54,1,101,3.54455445544554,0.538975926646961,71.7596153846154
"4573303796.jpg",1,44,53,9,0,107,2.65420560747664,0.645781722254856,45.7279411764706
"457397602.jpg",2,34,68,6,0,110,2.70909090909091,0.595787268010937,47.3606194690265
"4574265376.jpg",2,53,46,1,0,102,2.45098039215686,0.556286324530138,40.1875
"4576647416.jpg",0,8,67,29,1,105,3.21904761904762,0.588037027565055,59.3445945945946
"4576844747.jpg",0,4,61,43,0,108,3.36111111111111,0.554646192409083,66.0069444444444
"4577459748.jpg",1,27,63,18,1,110,2.91818181818182,0.69244703943239,50.2226890756302
"4578361888.jpg",0,3,70,32,0,105,3.27619047619048,0.509434794182543,61.3326086956522
"4578563691.jpg",0,1,52,49,1,103,3.48543689320388,0.539863411736181,69.6517857142857
"4578866514.jpg",0,1,19,85,7,112,3.875,0.504484394708602,78.9871794871795
"4578965343.jpg",2,68,42,0,0,112,2.35714285714286,0.51739372599237,36.3771186440678
"4579620271.jpg",0,1,49,61,2,113,3.56637168141593,0.548961782996683,68.1478260869565
"4580698398.jpg",5,64,36,1,0,106,2.31132075471698,0.575089352016914,34.0711206896552
"4582906874.jpg",1,21,61,18,0,101,2.95049504950495,0.653853769948027,54.85
"4583125138.jpg",0,0,42,64,0,106,3.60377358490566,0.491436093467161,71.1608695652174
"4583413420.jpg",0,4,49,44,0,97,3.41237113402062,0.572868828055843,66.9243119266055
"4585004484.jpg",0,13,109,16,0,138,3.02173913043478,0.459568050199534,57.4347826086956
"4585233162.jpg",4,43,45,11,1,104,2.63461538461538,0.763966302155388,43.9717391304348
"4585460509.jpg",0,8,76,26,2,112,3.19642857142857,0.582620450590768,59.3846153846154
"4586207743.jpg",0,10,54,46,0,110,3.32727272727273,0.636923380656854,61.29375
"4586793310.jpg",1,23,75,9,0,108,2.85185185185185,0.560620730989526,50.5693277310924
"4589538888.jpg",1,41,53,6,0,101,2.63366336633663,0.6119276473118,44.8
"4590098379.jpg",0,13,70,17,0,100,3.04,0.549011968370582,55.588785046729
"4591255467.jpg",1,3,76,29,0,109,3.22018348623853,0.533295105663619,60.2101769911504
"4591311320.jpg",0,6,69,70,1,146,3.45205479452055,0.588184720935839,70.0196078431373
"4591422965.jpg",0,2,29,69,3,103,3.70873786407767,0.553616770564526,76.4391891891892
"45917867.jpg",16,79,8,0,0,103,1.92233009708738,0.478750833477993,23.0474137931034
"4594091723.jpg",0,3,44,62,2,111,3.56756756756757,0.581871926264654,71.724358974359
"4594670956.jpg",0,19,66,19,1,105,3.01904761904762,0.635200640333315,54.1418918918919
"4595899816.jpg",0,0,36,64,5,105,3.7047619047619,0.553377905438143,73.2586206896552
"4596719098.jpg",0,18,72,18,0,108,3,0.580041893427398,54.8851351351351
"4597162839.jpg",0,0,28,72,2,102,3.74509803921569,0.481052363502936,74.7297297297297
"4597898813.jpg",1,15,62,31,0,109,3.12844036697248,0.668066827318066,56
"4598047073.jpg",1,12,85,10,0,108,2.96296296296296,0.491534426132475,54.3453389830508
"4598385226.jpg",1,18,71,17,0,107,2.97196261682243,0.605913374548902,54.7806603773585
"459891743.jpg",0,0,39,55,4,98,3.64285714285714,0.560743247565873,71.4594594594595
"4599648667.jpg",16,69,20,0,0,105,2.03809523809524,0.587101903155359,26.7721238938053
"4600229706.jpg",1,23,65,18,0,107,2.93457943925234,0.648234584218584,54.0588235294118
"460024423.jpg",0,0,32,66,3,101,3.71287128712871,0.516461686156221,71.95
"460148364.jpg",1,47,67,10,0,125,2.688,0.627540000010281,45.7378048780488
"4601884206.jpg",8,63,33,3,0,107,2.28971962616822,0.644414986919063,34
"4602499723.jpg",4,35,46,18,0,103,2.75728155339806,0.785481236498798,47.1852678571429
"4602555754.jpg",2,40,56,9,0,107,2.67289719626168,0.65553810439426,46.6985294117647
"460276399.jpg",0,3,63,38,0,104,3.33653846153846,0.53263545017037,64.8097345132743
"4602769821.jpg",0,0,20,82,5,107,3.85981308411215,0.464770142637808,75.3886554621849
"4603364479.jpg",0,4,61,41,1,107,3.36448598130841,0.572853225702578,64.9932432432432
"4603966605.jpg",5,74,29,2,0,110,2.25454545454545,0.565626447164065,33.24375
"4605015781.jpg",0,13,67,25,0,105,3.11428571428571,0.593462553323967,58.3455882352941
"4605356871.jpg",0,3,62,44,2,111,3.40540540540541,0.578059109566084,65.7588495575221
"4605589887.jpg",0,5,69,35,0,109,3.27522935779817,0.54214183659075,62.563025210084
"4605755313.jpg",2,33,54,16,0,105,2.8,0.712525303194425,49.2889908256881
"4605842170.jpg",1,1,53,50,2,107,3.47663551401869,0.604164703154841,67.2079831932773
"4606934450.jpg",0,12,71,21,0,104,3.08653846153846,0.559309159920009,56.5401785714286
"460737356.jpg",1,30,68,2,0,101,2.7029702970297,0.5204719868628,46.225
"4607436163.jpg",0,3,51,55,0,109,3.47706422018349,0.554382042946274,67.9088983050847
"4610304834.jpg",2,49,51,5,0,107,2.55140186915888,0.617872870538444,39.56875
"461078499.jpg",54,55,1,0,0,110,1.51818181818182,0.51991209881294,13.3050847457627
"4611014636.jpg",0,0,34,74,5,113,3.74336283185841,0.530814082699309,73.0452586206897
"46116416.jpg",0,10,32,55,6,103,3.55339805825243,0.750531254196389,68.2090517241379
"4611753437.jpg",3,53,55,2,0,113,2.49557522123894,0.584378390827591,39.9621848739496
"461213420.jpg",57,50,1,0,0,108,1.48148148148148,0.520270984055541,12.48125
"4614592470.jpg",3,58,39,0,0,100,2.36,0.541602560309064,35.2110091743119
"4615199637.jpg",4,64,34,1,0,103,2.31067961165049,0.560621612518976,35.1565420560748
"4617163865.jpg",9,69,19,0,0,97,2.10309278350515,0.530026258832094,28.9044117647059
"4617747913.jpg",1,33,62,8,0,104,2.74038461538462,0.607320908240659,48.0691964285714
"4617763829.jpg",0,1,56,50,1,108,3.47222222222222,0.53753214784685,68.0487288135593
"4619633197.jpg",0,0,22,72,11,105,3.8952380952381,0.553377905438143,77.4054054054054
"4620749659.jpg",0,4,76,63,3,146,3.44520547945205,0.587582093079511,69.1887755102041
"4622287144.jpg",0,3,25,71,3,102,3.72549019607843,0.565630512031092,74.425
"4622900651.jpg",0,1,51,47,0,99,3.46464646464646,0.521245198933135,66.697247706422
"4623510365.jpg",0,6,53,46,4,109,3.44036697247706,0.658719192976323,67.2796610169491
"4625855199.jpg",1,24,80,6,0,111,2.81981981981982,0.525671833305606,49.2307692307692
"4625946312.jpg",5,63,36,3,1,108,2.37037037037037,0.66406553826703,37.1890756302521
"4626592042.jpg",0,36,82,9,0,127,2.78740157480315,0.558198935634539,48.4047619047619
"4626914740.jpg",0,0,51,51,2,104,3.52884615384615,0.538908115251656,69.7991071428571
"4629048299.jpg",34,60,11,2,1,108,1.85185185185185,0.746516080349806,20.6393805309735
"4630540392.jpg",0,7,45,46,10,108,3.5462962962963,0.753611358468224,70.3445945945946
"4631127472.jpg",2,33,62,3,0,100,2.66,0.57243057891483,45.5045871559633
"4631601517.jpg",0,27,79,3,0,109,2.77981651376147,0.478380720942238,47.7986725663717
"4631640521.jpg",0,0,25,69,4,98,3.78571428571429,0.502570711032417,73.716814159292
"463199566.jpg",0,22,67,19,0,108,2.97222222222222,0.618383985800151,54.6635514018692
"4632834953.jpg",0,2,59,50,0,111,3.43243243243243,0.532944165958765,66.2948717948718
"4633306112.jpg",10,62,33,0,0,105,2.21904761904762,0.604167456106596,33.1189320388349
"463426919.jpg",2,68,36,2,0,108,2.35185185185185,0.55222260875729,35.2478991596639
"4634635214.jpg",0,12,51,39,3,105,3.31428571428571,0.711367665869033,62.2652173913043
"463525569.jpg",0,2,47,49,1,99,3.49494949494949,0.560133682544775,69.0435779816514
"4635702029.jpg",1,2,49,47,4,103,3.49514563106796,0.654902872723363,67.8918918918919
"4636057593.jpg",0,4,61,43,0,108,3.36111111111111,0.554646192409083,65.3220338983051
"4637538714.jpg",24,74,9,0,0,107,1.85981308411215,0.539891640610202,23.89375
"4638196012.jpg",0,1,25,82,1,109,3.76146788990826,0.469418130139686,73.7898230088496
"4638688609.jpg",0,0,42,68,3,113,3.65486725663717,0.530665207620599,72.6155462184874
"4638773413.jpg",0,11,57,31,7,106,3.32075471698113,0.750202129096784,61.6617647058824
"4639008494.jpg",8,51,38,3,1,101,2.38613861386139,0.720698231296608,36.5443925233645
"4639050491.jpg",0,5,68,27,1,101,3.23762376237624,0.550427376708048,59.9836448598131
"4640205988.jpg",0,3,43,58,3,107,3.57009345794393,0.600505283038207,71.891592920354
"464118000.jpg",4,49,43,8,0,104,2.52884615384615,0.696129811145627,40.3
"4643295751.jpg",1,26,99,4,0,130,2.81538461538462,0.478768047359399,50.6269230769231
"4643928912.jpg",1,16,71,15,0,103,2.97087378640777,0.585047520771615,53.275
"4644879921.jpg",0,12,70,21,1,104,3.10576923076923,0.589853844506429,57.2767857142857
"4644913731.jpg",1,9,64,34,1,109,3.22935779816514,0.647402609906406,58.68125
"4647260189.jpg",0,5,37,64,1,107,3.57009345794393,0.600505283038207,70.025
"4647732482.jpg",0,2,54,41,4,101,3.46534653465347,0.609333347776791,66.8513513513514
"4650909917.jpg",0,1,51,55,1,108,3.51851851851852,0.537934462211864,69.75
"4651317050.jpg",7,45,55,3,0,110,2.49090909090909,0.660073036624028,39.6848739495798
"4651402324.jpg",0,2,41,56,3,102,3.58823529411765,0.586193310737911,70.1293103448276
"4655744443.jpg",0,2,46,57,1,106,3.5377358490566,0.555055180472421,71.6102941176471
"4656581279.jpg",0,1,41,66,2,110,3.62727272727273,0.53943720092777,71.1596638655462
"4656808355.jpg",0,11,68,24,1,104,3.14423076923077,0.59802700252003,58.104347826087
"4658471909.jpg",15,63,24,1,0,103,2.10679611650485,0.640352558517928,29.2432432432432
"4659357736.jpg",0,39,64,7,0,110,2.70909090909091,0.580184319738758,46.9439655172414
"4663774613.jpg",0,1,32,71,3,107,3.71028037383178,0.532160881376848,75.0120192307692
"466432603.jpg",1,13,76,17,0,107,3.01869158878505,0.566040674770481,54.3355263157895
"4664658605.jpg",0,8,69,29,0,106,3.19811320754717,0.559247986917716,61.3677884615385
"46658329.jpg",0,29,45,25,2,101,3,0.787400787401181,53.7435897435897
"46667675.jpg",3,48,49,7,0,107,2.5607476635514,0.661296184226698,41.8340336134454
"4668385279.jpg",0,1,58,45,1,105,3.43809523809524,0.535720390685605,65.6369565217391
"4668832694.jpg",0,0,54,52,0,106,3.49056603773585,0.502285879874493,68.121359223301
"4668889560.jpg",0,4,51,47,0,102,3.42156862745098,0.570500466583819,66.5619469026549
"4668901744.jpg",0,1,40,65,3,109,3.64220183486239,0.553154853742444,70.9152542372881
"4669146975.jpg",2,46,59,0,0,107,2.53271028037383,0.537600486602462,41.6331775700935
"4669754441.jpg",0,0,26,75,3,104,3.77884615384615,0.481839734247422,73.6717391304348
"4670475171.jpg",0,0,16,83,8,107,3.92523364485981,0.469864183094921,78.1617647058823
"4670590256.jpg",0,4,77,27,0,108,3.21296296296296,0.49390539647944,59.1959459459459
"4671382441.jpg",0,0,30,69,5,104,3.75961538461538,0.530528081075412,74.7478260869565
"4671409819.jpg",0,39,60,12,0,111,2.75675675675676,0.635555822828494,48.2760869565217
"4671787703.jpg",0,4,63,38,0,105,3.32380952380952,0.545880342186223,63.4642857142857
"4672698013.jpg",0,2,34,62,3,101,3.65346534653465,0.573334868368503,71.6261682242991
"4672766619.jpg",0,2,28,71,2,103,3.70873786407767,0.535615240179964,74.5199115044248
"4673438844.jpg",0,1,26,71,6,104,3.78846153846154,0.551662569637779,80.6471962616822
"4673878145.jpg",0,11,61,29,0,101,3.17821782178218,0.606564746815382,61.5518867924528
"4674436980.jpg",0,1,42,67,2,112,3.625,0.539018126356193,71.1602564102564
"4674618399.jpg",0,17,59,32,0,108,3.13888888888889,0.662173330970994,56.4427966101695
"4674790248.jpg",0,2,37,65,1,105,3.61904761904762,0.543863535997354,70.4932432432432
"4676269978.jpg",0,0,24,72,8,104,3.84615384615385,0.535519542113137,81.2429245283019
"4676525770.jpg",0,44,52,10,0,106,2.67924528301887,0.640642085817342,45.6689189189189
"46766983.jpg",17,62,21,2,0,102,2.07843137254902,0.670248579715003,28.4294871794872
"4676944717.jpg",4,54,45,2,0,105,2.42857142857143,0.602193791596495,39.4742990654206
"4679147725.jpg",0,0,48,53,4,105,3.58095238095238,0.568076247268466,70.0200892857143
"4680082599.jpg",0,1,18,79,7,105,3.87619047619048,0.513195833352107,77.6592920353982
"4681215652.jpg",0,6,54,48,0,108,3.38888888888889,0.593316881706884,66.4602803738318
"4681329966.jpg",0,6,38,57,9,110,3.62727272727273,0.714965719446268,72.5
"4682349014.jpg",0,33,55,17,0,105,2.84761904761905,0.676258831606662,48.9934782608696
"4682743182.jpg",6,55,37,3,0,101,2.36633663366337,0.643782141368145,35.3357142857143
"4683130999.jpg",0,5,64,36,1,106,3.31132075471698,0.575089352016914,63.6533018867925
"4683892759.jpg",0,16,74,11,0,101,2.95049504950495,0.517227950206916,52.4275700934579
"468518360.jpg",0,5,55,41,0,101,3.35643564356436,0.575919411304074,64.8807339449541
"468574107.jpg",34,61,6,1,0,102,1.74509803921569,0.608296998034594,18.5596330275229
"4685744038.jpg",0,1,27,62,10,100,3.81,0.614554121031474,75.3199152542373
"4687542962.jpg",0,22,72,13,0,107,2.91588785046729,0.568372309004801,52.2217391304348
"468764619.jpg",1,10,58,32,0,101,3.1980198019802,0.648379549032787,58.6065217391304
"4688027801.jpg",0,18,56,29,0,103,3.10679611650485,0.670273888403067,58.75
"4688672987.jpg",0,12,56,38,0,106,3.24528301886792,0.644557001871267,61.2943925233645
"4688942670.jpg",0,6,56,41,3,106,3.38679245283019,0.640992604028072,65.2065217391304
"4689159899.jpg",10,84,11,0,0,105,2.00952380952381,0.449256610225717,27.2697368421053
"4689181626.jpg",0,29,58,11,0,98,2.81632653061224,0.615050727528389,49.7791262135922
"469009898.jpg",0,6,65,28,0,99,3.22222222222222,0.545024911536171,62.6370192307692
"4690644950.jpg",0,4,53,49,0,106,3.42452830188679,0.568173568509905,68.3995535714286
"4690684792.jpg",0,9,68,33,0,110,3.21818181818182,0.58075904431726,59.4129464285714
"4691973869.jpg",11,56,30,4,0,101,2.26732673267327,0.705564867448924,34
"4692095992.jpg",0,9,75,17,0,101,3.07920792079208,0.503650043518943,56.2
"4692485168.jpg",0,4,52,53,1,110,3.46363636363636,0.585407765473404,66.4889380530973
"4693844054.jpg",0,13,70,19,0,102,3.05882352941176,0.559765322322265,56.1527777777778
"4694563082.jpg",0,3,35,61,7,106,3.67924528301887,0.640642085817342,69.8665254237288
"4696097531.jpg",0,7,60,39,0,106,3.30188679245283,0.588295541547658,64.3567961165049
"4696239138.jpg",0,1,37,70,1,109,3.65137614678899,0.515969902743239,68.9411764705882
"4696642475.jpg",0,1,51,50,4,106,3.5377358490566,0.588371898941911,68.3865546218487
"4697031191.jpg",0,7,66,31,0,104,3.23076923076923,0.561391634768236,62.7941176470588
"4697661900.jpg",1,7,49,44,3,104,3.39423076923077,0.702537277189032,64.0328947368421
"4698449914.jpg",2,47,79,2,0,130,2.62307692307692,0.54652368070547,43.7891791044776
"469890496.jpg",1,13,63,26,1,104,3.125,0.663727339035032,56.7224576271186
"4698931028.jpg",0,3,61,48,0,112,3.40178571428571,0.544585492896532,65.5192307692308
"4699352200.jpg",0,2,42,62,1,107,3.57943925233645,0.550083753101153,71.9345794392523
"4699474732.jpg",1,20,65,16,0,102,2.94117647058824,0.626534226412754,53.3004587155963
"4701833798.jpg",0,4,62,37,0,103,3.32038834951456,0.546173717839859,63.2765486725664
"4702275189.jpg",0,3,45,54,2,104,3.52884615384615,0.59048656535823,71.4925742574257
"470258883.jpg",2,33,59,13,0,107,2.77570093457944,0.677236493557949,47.7745535714286
"4702733058.jpg",0,6,62,34,1,103,3.29126213592233,0.587968719342113,61.9288990825688
"4702824874.jpg",0,31,65,6,0,102,2.75490196078431,0.552873224323927,47.4357142857143
"4704193975.jpg",0,21,64,18,0,103,2.97087378640777,0.61765385762215,52.3581081081081
"4704223777.jpg",0,1,45,51,0,97,3.51546391752577,0.522681429064263,70.6580188679245
"4704686099.jpg",0,23,74,5,0,102,2.82352941176471,0.495759537405347,50.0285714285714
"4704859608.jpg",5,66,31,2,0,104,2.28846153846154,0.585804184173917,34.7279411764706
"4705856366.jpg",0,15,67,24,0,106,3.08490566037736,0.603449205315764,56.8995327102804
"4706726398.jpg",3,42,61,2,0,108,2.57407407407407,0.583314789795751,40.9358407079646
"4707334942.jpg",0,4,46,59,1,110,3.51818181818182,0.58626196013806,70.7693965517241
"4708680413.jpg",0,8,70,28,0,106,3.18867924528302,0.554002020748761,62.1383928571429
"47095522.jpg",0,6,46,51,4,107,3.49532710280374,0.664090124818273,67.4194915254237
"4710464067.jpg",0,0,31,65,5,101,3.74257425742574,0.541358759909446,73.3918918918919
"4711101546.jpg",0,3,67,33,0,103,3.29126213592233,0.516987274868333,61.5504587155963
"4711939216.jpg",3,88,18,3,0,112,2.1875,0.511687721490681,31.5454545454545
"4712201579.jpg",0,1,35,61,5,102,3.68627450980392,0.5798666995481,72.1658878504673
"4713092038.jpg",0,1,29,74,4,108,3.75,0.531705068975115,73.9358407079646
"4714778162.jpg",0,0,67,35,1,103,3.35922330097087,0.502042278745347,65.6642857142857
"4714961173.jpg",0,9,53,44,2,108,3.36111111111111,0.662173330970994,66.2860576923077
"4718032191.jpg",0,9,78,25,0,112,3.14285714285714,0.534522483824849,58.8205128205128
"4718226346.jpg",0,19,73,14,1,107,2.97196261682243,0.590138198161191,51.11875
"4718542749.jpg",0,12,74,22,0,108,3.09259259259259,0.555970769033215,54.8805309734513
"4719295519.jpg",0,31,68,8,0,107,2.78504672897196,0.56681895188049,49.3108108108108
"4719558314.jpg",22,77,10,0,0,109,1.88990825688073,0.532976435120874,23.9247787610619
"4722268334.jpg",0,1,42,63,1,107,3.5981308411215,0.529503382213656,71.0154867256637
"4722272826.jpg",0,4,47,98,4,153,3.66666666666667,0.573539334676404,76.3076923076923
"4722588778.jpg",0,2,28,67,5,102,3.73529411764706,0.578945278424999,72.4508928571429
"4725670933.jpg",0,3,69,33,0,105,3.28571428571429,0.513552591013095,61.2608695652174
"4725890838.jpg",1,19,69,14,1,104,2.95192307692308,0.629066309072309,51.2173913043478
"4726274782.jpg",19,83,12,0,0,114,1.93859649122807,0.520127413241485,24.7794117647059
"4727744330.jpg",0,1,31,79,1,112,3.71428571428571,0.49189047760273,74.2012711864407
"4728497082.jpg",0,0,47,59,1,107,3.57009345794393,0.516010631978924,70.8453389830509
"4728646090.jpg",30,72,9,0,0,111,1.81081081081081,0.564293822779869,21.2964601769912
"4728690118.jpg",0,1,21,74,10,106,3.87735849056604,0.564047113680261,78.8060344827586
"4730475136.jpg",3,23,67,13,1,107,2.86915887850467,0.68795721879841,50.5
"4730781966.jpg",11,64,23,0,0,98,2.12244897959184,0.57910891596084,28.7570093457944
"4731015701.jpg",0,15,77,18,0,110,3.02727272727273,0.549546784229254,54.4078947368421
"4731319039.jpg",4,57,37,1,0,99,2.35353535353535,0.576993108456905,37.2038834951456
"4731330377.jpg",1,27,59,21,0,108,2.92592592592593,0.693140000203647,51.7375
"4732322374.jpg",0,2,17,78,8,105,3.87619047619048,0.549391938265845,75.8445945945946
"4732496293.jpg",0,21,68,10,0,99,2.88888888888889,0.551230328704296,51.025
"4733042196.jpg",0,2,25,83,3,113,3.76991150442478,0.517701816367335,73.6282051282051
"4733189524.jpg",0,15,91,11,1,118,2.98305084745763,0.506083518114321,53.7435897435897
"4735563555.jpg",0,1,54,50,0,105,3.46666666666667,0.520108469949126,68.3623853211009
"473566328.jpg",0,5,46,53,4,108,3.51851851851852,0.648239621691312,71.0114678899083
"4737751146.jpg",0,1,46,53,1,101,3.53465346534653,0.539710226615053,69.8004587155963
"4737850701.jpg",0,13,65,26,3,107,3.17757009345794,0.670301032234131,60.3421052631579
"473881316.jpg",37,64,4,0,0,105,1.68571428571429,0.542683604419273,16.984375
"4738960229.jpg",7,63,29,0,0,99,2.22222222222222,0.563436169819011,32.725
"4739066142.jpg",0,1,20,85,5,111,3.84684684684685,0.489864511847143,75.31875
"4739558783.jpg",0,7,55,40,0,102,3.32352941176471,0.599699012061032,64.3028846153846
"474070389.jpg",0,0,13,81,4,98,3.90816326530612,0.408334174190587,77.5862831858407
"4740901654.jpg",0,27,90,16,1,134,2.93283582089552,0.590625527890505,53.5625
"4742025728.jpg",0,7,64,39,0,110,3.29090909090909,0.580184319738758,62.359375
"4743492963.jpg",0,46,51,3,0,100,2.57,0.555141259664437,40.8876146788991
"4743830608.jpg",0,3,67,55,0,125,3.416,0.541562851920851,68.452
"4745213797.jpg",0,1,26,69,4,100,3.76,0.534090371802868,73.5694444444444
"4746340677.jpg",1,4,94,33,0,132,3.20454545454545,0.520402609313892,62.5916030534351
"4747712670.jpg",1,6,63,34,2,106,3.28301886792453,0.643720095651342,62.1934782608696
"4748697171.jpg",2,48,53,4,0,107,2.55140186915888,0.602410955759534,41.2794117647059
"4748829159.jpg",1,20,72,14,0,107,2.92523364485981,0.594009951308537,53.125
"4750416133.jpg",0,7,50,50,2,109,3.43119266055046,0.643586197816351,65.6016949152542
"4750521580.jpg",0,0,17,79,7,103,3.90291262135922,0.475158654758682,81.0408653846154
"4752962359.jpg",0,5,78,22,0,105,3.16190476190476,0.482856275873249,57.3378378378378
"4757093692.jpg",0,2,47,50,2,101,3.51485148514851,0.576434929304924,72.2429906542056
"4757384229.jpg",3,58,44,2,0,107,2.42056074766355,0.583376366064357,36.6283185840708
"475853335.jpg",16,85,32,1,0,134,2.13432835820896,0.610571589419543,29.1875
"47612135.jpg",0,10,46,45,6,107,3.4392523364486,0.741970478147617,65.5441176470588
"4761802851.jpg",2,27,63,10,0,102,2.79411764705882,0.634615893715864,50.197247706422
"4761960995.jpg",0,18,67,19,0,104,3.00961538461538,0.599274517831503,55.9191176470588
"4764407251.jpg",1,24,55,26,2,108,3.03703703703704,0.760299079444545,56.0743243243243
"4764540278.jpg",0,5,50,53,3,111,3.48648648648649,0.630510108993502,65.4618644067797
"4764809752.jpg",0,14,76,24,0,114,3.08771929824561,0.573167005404584,55.3362068965517
"4765706226.jpg",0,2,34,59,6,101,3.68316831683168,0.615316066250621,72.088785046729
"4765708291.jpg",1,2,34,65,9,111,3.71171171171171,0.679403312906893,70.7754237288136
"4766339964.jpg",0,12,47,45,4,108,3.37962962962963,0.732650961670866,63.7415966386555
"4767640691.jpg",0,36,61,0,0,97,2.62886597938144,0.485617897392632,45.1297169811321
"4769301151.jpg",9,58,34,2,0,103,2.28155339805825,0.648035882088048,35.8679245283019
"4770124841.jpg",0,8,70,36,1,115,3.26086956521739,0.593635196055139,63.8109243697479
"4770169005.jpg",0,0,44,60,4,108,3.62962962962963,0.556903867483925,70.3147321428571
"4770545465.jpg",0,1,37,66,4,108,3.67592592592593,0.560852217090226,71.8185840707965
"4770991170.jpg",0,16,55,30,1,102,3.15686274509804,0.685711281205573,60.925
"4771924563.jpg",0,12,70,18,0,100,3.06,0.547169022692202,55.8738532110092
"4772591404.jpg",1,7,63,35,2,108,3.27777777777778,0.653292642893341,62.7673913043478
"4773063971.jpg",0,18,75,15,0,108,2.97222222222222,0.554646192409083,51.1239495798319
"4773302631.jpg",0,11,57,36,0,104,3.24038461538462,0.630844591938848,59.1880530973451
"4774195402.jpg",0,0,21,83,4,108,3.84259259259259,0.45676712480186,76.1184210526316
"4777018149.jpg",0,1,41,57,2,101,3.59405940594059,0.550966747123312,69.4672897196262
"4777807371.jpg",0,6,70,29,1,106,3.23584905660377,0.561492683961206,58.3783783783784
"4778402744.jpg",0,3,46,50,2,101,3.5049504950495,0.593696258641363,67.675
"4778495597.jpg",0,17,72,18,0,107,3.00934579439252,0.57454374191497,55.0490654205607
"477928479.jpg",0,36,67,6,0,109,2.72477064220183,0.558960007067151,45.577731092437
"477939756.jpg",0,0,34,67,2,103,3.68932038834951,0.505443432059031,73.9241071428571
"4780164434.jpg",0,10,73,22,0,105,3.11428571428571,0.542683604419273,57.8417431192661
"4780450043.jpg",0,1,57,43,2,103,3.44660194174757,0.555333415833489,69.1388888888889
"4781142781.jpg",1,22,57,30,1,111,3.07207207207207,0.734991796017439,56.1631355932203
"4781552174.jpg",0,4,50,47,1,102,3.44117647058824,0.589907349861894,68.2110091743119
"4782504809.jpg",0,6,39,58,0,103,3.50485436893204,0.608337277576797,69.6714285714286
"4782546865.jpg",0,2,55,55,1,113,3.48672566371681,0.55283432431341,67.0693277310924
"4782608700.jpg",2,15,77,18,0,112,2.99107142857143,0.607691477469391,54.5192307692308
"4782637866.jpg",0,1,30,74,1,106,3.70754716981132,0.496981002455262,77.3125
"4782987041.jpg",0,0,19,76,14,109,3.95412844036697,0.550846505152943,79.03125
"4784361629.jpg",1,6,63,29,0,99,3.21212121212121,0.593721010424024,60.9711538461538
"4786690796.jpg",4,67,42,1,0,114,2.35087719298246,0.564157389392544,36.5651260504202
"4787504766.jpg",0,6,72,30,0,108,3.22222222222222,0.535354425937356,62.1513157894737
"4787556835.jpg",0,3,51,53,0,107,3.46728971962617,0.554871343397283,67.9
"4788033646.jpg",0,1,18,88,3,110,3.84545454545455,0.453050084040246,75.59375
"4789129778.jpg",0,5,69,27,0,101,3.21782178217822,0.521612124016296,59.1959459459459
"4791175187.jpg",0,9,61,36,1,107,3.27102803738318,0.622988740592157,61.1764705882353
"4792717107.jpg",0,2,50,51,1,104,3.49038461538462,0.557302663192804,70.4816513761468
"4794011269.jpg",0,0,44,61,1,106,3.59433962264151,0.512292734149835,70.2860169491525
"4794298678.jpg",0,5,59,43,0,107,3.35514018691589,0.570539903993596,65.6383495145631
"4794780770.jpg",0,4,75,32,0,111,3.25225225225225,0.512896737231836,62.1758474576271
"4795531186.jpg",0,0,57,47,1,105,3.46666666666667,0.520108469949126,66.0337837837838
"4796228876.jpg",0,1,43,62,2,108,3.60185185185185,0.545839228920306,72.2436440677966
"4800263969.jpg",0,13,75,15,0,103,3.01941747572816,0.523573365540465,54.9719626168224
"4801184295.jpg",0,4,37,63,4,108,3.62037037037037,0.622289901377863,72.7972972972973
"4801726337.jpg",0,13,72,16,0,101,3.02970297029703,0.537688488709856,55.1824324324324
"4803889024.jpg",1,21,64,22,0,108,2.99074074074074,0.662695858833699,55.7429906542056
"4804088480.jpg",0,5,53,41,0,99,3.36363636363636,0.579488610839561,66.2216981132076
"4804146129.jpg",4,43,51,4,0,102,2.53921568627451,0.639795273992229,39.8819444444444
"4804146646.jpg",0,2,20,74,4,100,3.8,0.53181602347831,76.0981308411215
"4804414192.jpg",0,4,60,41,0,105,3.35238095238095,0.554369919210997,64.421875
"4805041131.jpg",0,11,63,27,0,101,3.15841584158416,0.595527887967083,57.3876146788991
"4805501528.jpg",1,3,60,46,1,111,3.38738738738739,0.605597693810476,64.9724576271186
"4806036650.jpg",46,43,11,3,0,103,1.71844660194175,0.772283039247223,17.7972972972973
"4806110659.jpg",0,3,68,27,2,100,3.28,0.55194788218315,63.9158878504673
"480626798.jpg",15,84,11,0,0,110,1.96363636363636,0.487029429008762,25.3340336134454
"4806281586.jpg",0,17,66,22,0,105,3.04761904761905,0.610500305250229,57.5485436893204
"4806591146.jpg",1,13,74,19,0,107,3.03738317757009,0.581559932907514,57.7794117647059
"4808255488.jpg",0,2,31,72,0,105,3.66666666666667,0.512660231362364,75.25
"4809080599.jpg",0,0,24,85,2,111,3.8018018018018,0.443535789676545,76.5783898305085
"4814084144.jpg",0,5,66,35,0,106,3.28301886792453,0.547804570316512,63.0367647058824
"4815901200.jpg",0,1,23,61,21,106,3.9622641509434,0.675059479592961,81.0818965517241
"4819833644.jpg",19,88,6,0,0,113,1.88495575221239,0.458105812585534,23.6008403361345
"4819847439.jpg",19,63,22,3,0,107,2.08411214953271,0.702038747077514,28.5743243243243
"4820110338.jpg",0,13,77,12,0,102,2.99019607843137,0.497421032873425,54.9305555555556
"482147713.jpg",0,4,32,68,1,105,3.62857142857143,0.576079970028582,73.8082524271845
"4822559131.jpg",1,24,65,16,0,106,2.90566037735849,0.640361533105917,51.9347826086956
"4822674187.jpg",0,11,96,10,0,117,2.99145299145299,0.425394877320422,55.6474358974359
"4822965011.jpg",0,4,59,39,2,104,3.375,0.594268743756413,63.3728448275862
"4824776407.jpg",0,2,29,74,0,105,3.68571428571429,0.506007861642441,76.6509433962264
"4826544292.jpg",5,53,51,4,0,113,2.47787610619469,0.642224720527115,39.0217391304348
"4828138245.jpg",1,68,40,2,0,111,2.38738738738739,0.5422373041587,36.6125
"4828896285.jpg",0,2,45,64,11,122,3.68852459016393,0.656587310328597,75.8
"4830054430.jpg",0,5,39,61,1,106,3.54716981132075,0.603672498276344,73.5377358490566
"4830420359.jpg",0,12,74,21,0,107,3.08411214953271,0.551524393943865,58.3849557522124
"4831070004.jpg",59,42,3,0,0,104,1.46153846153846,0.556044925946993,11.9294871794872
"483164670.jpg",3,49,56,2,0,110,2.51818181818182,0.58626196013806,42.0384615384615
"4835256174.jpg",0,0,15,85,7,107,3.92523364485981,0.44933776385605,79.7433035714286
"4835865863.jpg",0,11,74,17,0,102,3.05882352941176,0.52319523667414,56.6875
"483591009.jpg",0,3,66,34,0,103,3.30097087378641,0.520839282280893,62.8349514563107
"4837135935.jpg",0,3,59,38,1,101,3.36633663366337,0.560763270502406,63.6845794392523
"4837286609.jpg",0,0,22,77,5,104,3.83653846153846,0.484929720122209,76.885775862069
"4838893362.jpg",1,13,65,24,0,103,3.0873786407767,0.62789402310039,58.75
"4840518597.jpg",0,15,59,26,1,101,3.12871287128713,0.658230451082805,56.1766055045872
"4841257153.jpg",1,17,70,19,0,107,3,0.614295116833951,54.6949152542373
"4842717407.jpg",0,3,66,33,0,102,3.29411764705882,0.518723400494089,62.5066964285714
"4843346384.jpg",0,14,60,32,0,106,3.16981132075472,0.639519136512629,58.9579831932773
"4843845900.jpg",1,22,69,12,0,104,2.88461538461538,0.596229126278775,50.9380530973451
"4845155288.jpg",0,6,67,28,2,103,3.25242718446602,0.589423889579224,62.1383928571429
"4845527109.jpg",1,1,29,75,8,114,3.7719298245614,0.624501042876592,73.3130434782609
"4845803922.jpg",1,68,41,1,0,111,2.37837837837838,0.52317308198155,36.475
"4845997437.jpg",0,32,61,12,0,105,2.80952380952381,0.621648523240333,49.6518691588785
"4846003639.jpg",1,11,94,19,0,125,3.048,0.52141247371149,57.9385245901639
"4847778477.jpg",0,2,34,72,0,108,3.64814814814815,0.517268433265179,74.4174311926605
"4847844430.jpg",0,1,45,54,1,101,3.54455445544554,0.538975926646961,71.3805309734513
"4847954914.jpg",1,20,91,17,0,129,2.96124031007752,0.564622395599398,54.49609375
"4848345613.jpg",0,1,36,78,4,119,3.71428571428571,0.539033302056925,75.7435897435897
"484860366.jpg",18,58,23,8,0,107,2.19626168224299,0.806100002416112,30.425
"4850291252.jpg",1,59,43,1,0,104,2.42307692307692,0.534123139365797,37.7566964285714
"4851066149.jpg",6,69,36,1,0,112,2.28571428571429,0.576234615453057,34.6875
"4851467262.jpg",0,4,50,42,4,100,3.46,0.642281287696639,66.243119266055
"485174290.jpg",0,1,45,58,0,104,3.54807692307692,0.5191443238415,67.2972972972973
"4851762296.jpg",1,12,66,19,0,98,3.05102040816327,0.598493796393481,51.5951327433628
"4852617544.jpg",0,0,46,58,0,104,3.55769230769231,0.499065594399243,72.2063106796116
"4852968688.jpg",0,6,65,32,0,103,3.25242718446602,0.55516199017241,61.2544642857143
"4854909641.jpg",11,55,38,5,0,109,2.3394495412844,0.722908009698259,35.71875
"4855511701.jpg",0,30,65,6,0,101,2.76237623762376,0.550427376708048,48.625
"4856036467.jpg",0,2,34,57,8,101,3.7029702970297,0.641007869771433,71.9797297297297
"4857542718.jpg",0,0,32,66,6,104,3.75,0.553014685807209,74.0304347826087
"4858031538.jpg",2,48,52,7,0,109,2.58715596330275,0.641338432272291,43.9868421052632
"4858527470.jpg",0,29,71,7,1,108,2.81481481481481,0.582424005682537,48.50625
"486068453.jpg",5,42,57,9,0,113,2.61946902654867,0.698449610499626,43.3879310344828
"486170909.jpg",0,13,74,16,1,104,3.04807692307692,0.563963224241827,56.5401785714286
"4862383971.jpg",0,3,63,40,0,106,3.34905660377358,0.535278349133619,65.7547169811321
"4862615903.jpg",0,5,52,45,1,103,3.40776699029126,0.601255112144644,66.7809734513274
"4863093063.jpg",2,43,57,3,0,105,2.58095238095238,0.584757549708759,41.3173913043478
"4864265547.jpg",0,0,64,42,0,106,3.39622641509434,0.491436093467161,66.55
"4866523929.jpg",0,5,52,53,2,112,3.46428571428571,0.614077663729416,65.5192307692308
"4867071134.jpg",0,5,56,40,3,104,3.39423076923077,0.629659628052651,64.3685344827586
"4867659714.jpg",0,9,66,32,0,107,3.21495327102804,0.583225212708778,61.0630841121495
"4867994945.jpg",30,75,5,0,0,110,1.77272727272727,0.518627173527317,21.025641025641
"4868050690.jpg",0,0,27,83,1,111,3.76576576576577,0.446296985404337,72.593220338983
"4868558209.jpg",3,43,52,4,0,102,2.55882352941176,0.622570993395229,41.15
"4868895324.jpg",0,3,30,65,3,101,3.67326732673267,0.584960013865719,72.475
"4870809935.jpg",0,0,17,86,7,110,3.90909090909091,0.460264274812733,78.885593220339
"4871159312.jpg",0,5,48,44,0,97,3.4020618556701,0.589134142450331,67.7004716981132
"4871407891.jpg",0,8,68,33,0,109,3.22935779816514,0.571434639062975,61.6165254237288
"4871444135.jpg",0,1,40,61,4,106,3.64150943396226,0.572191763481324,72.7972972972973
"4871847706.jpg",0,1,27,69,8,105,3.8,0.578459492631407,72.5743243243243
"4872116932.jpg",1,37,58,3,0,99,2.63636363636364,0.561603852219212,44.8428571428571
"4873047491.jpg",0,0,35,70,7,112,3.75,0.561529442963871,74.5448717948718
"4875935356.jpg",0,18,78,29,1,126,3.1031746031746,0.630293456470747,58.6829268292683
"4875993491.jpg",0,4,56,42,1,103,3.38834951456311,0.58129351549086,63.4426605504587
"4877994171.jpg",1,15,65,21,2,104,3.07692307692308,0.678266031553529,54.2905405405405
"487860600.jpg",50,62,0,0,0,112,1.55357142857143,0.499356084729624,15.8220338983051
"4880270138.jpg",0,3,52,47,3,105,3.47619047619048,0.605983594840749,66.0673913043478
"4881913692.jpg",0,0,29,72,7,108,3.7962962962963,0.542738973753511,72.84375
"4882295000.jpg",0,0,31,70,3,104,3.73076923076923,0.506861066174239,75.25
"4882358476.jpg",0,2,60,45,2,109,3.43119266055046,0.567107222160955,66.1610169491525
"4882465125.jpg",5,73,31,0,0,109,2.23853211009174,0.525270346068951,32.466814159292
"4882952027.jpg",0,9,69,23,0,101,3.13861386138614,0.548264588867401,59.8605769230769
"4883254364.jpg",0,1,44,54,2,101,3.56435643564356,0.555262849183311,68.3258928571429
"4883647933.jpg",0,9,72,25,0,106,3.15094339622642,0.548460231317574,59.5889830508475
"4883939911.jpg",19,87,22,0,0,128,2.0234375,0.567697986553597,26.25
"4885160336.jpg",0,2,30,68,5,105,3.72380952380952,0.58004041794248,72.103813559322
"4885242381.jpg",2,6,48,43,2,101,3.36633663366337,0.717255495304535,64.1013513513514
"4885928195.jpg",0,13,83,9,0,105,2.96190476190476,0.458337495818594,52.2217391304348
"4886153819.jpg",1,6,56,38,1,102,3.31372549019608,0.644556677133118,62.95
"4886277173.jpg",12,69,22,0,0,103,2.09708737864078,0.569047417073793,30.025
"4886518096.jpg",1,25,69,13,0,108,2.87037037037037,0.612831525271193,50.9230769230769
"4886525195.jpg",0,7,80,20,1,108,3.13888888888889,0.519855000152735,59.6991150442478
"4887400905.jpg",0,3,64,33,2,102,3.33333333333333,0.568711124591671,61.45
"4887754576.jpg",0,21,73,10,0,104,2.89423076923077,0.538214762612982,51.0110619469027
"488823133.jpg",1,4,53,36,2,96,3.35416666666667,0.648547635172405,65.3014705882353
"4889658118.jpg",0,2,40,53,1,96,3.55208333333333,0.559507145275228,71.7142857142857
"4889890723.jpg",0,11,63,26,1,101,3.16831683168317,0.617564683748886,58.375
"4890086996.jpg",0,4,76,28,0,108,3.22222222222222,0.499220576299318,59.9911504424779
"4890155523.jpg",0,2,57,85,2,146,3.5958904109589,0.545562248710228,74.7582781456954
"4891468275.jpg",0,1,21,68,16,106,3.93396226415094,0.621348271706714,77.7027027027027
"4891817119.jpg",0,1,39,61,2,103,3.62135922330097,0.544428191746183,71.0513392857143
"4893296719.jpg",0,11,55,38,0,104,3.25961538461538,0.638493255283538,61.6799065420561
"4894150529.jpg",0,2,34,61,2,99,3.63636363636364,0.561603852219212,76.0432692307692
"4895451556.jpg",0,0,26,77,8,111,3.83783783783784,0.531559293546151,76.1588983050847
"489975423.jpg",0,1,40,57,9,107,3.69158878504673,0.635598291216682,71.675
"4900369405.jpg",0,10,66,30,0,106,3.18867924528302,0.587378478571482,59.0369565217391
"4900565313.jpg",1,32,63,9,0,105,2.76190476190476,0.612746175392287,49.4485294117647
"4900640591.jpg",0,4,74,27,1,106,3.23584905660377,0.526477726068939,60.5178571428571
"4901671249.jpg",1,32,66,6,0,105,2.73333333333333,0.57623891056686,47.4357142857143
"4902129359.jpg",0,0,27,69,5,101,3.78217821782178,0.521612124016296,75.625
"4902504109.jpg",30,65,15,0,0,110,1.86363636363636,0.627756639682572,22.7828947368421
"4903384785.jpg",0,9,58,41,0,108,3.2962962962963,0.615367973787818,63.2094594594595
"4903418699.jpg",1,30,59,17,1,108,2.87962962962963,0.706678324322425,49.33125
"4904294830.jpg",0,3,43,65,2,113,3.58407079646018,0.578261923427409,70.1625
"4905609957.jpg",1,29,71,4,0,105,2.74285714285714,0.537597422809103,47.1710526315789
"4905995730.jpg",0,1,16,73,10,100,3.92,0.544578420951158,78.3819444444444
"4906359700.jpg",0,1,25,74,3,103,3.76699029126214,0.508821851314784,74.1021739130435
"4906429431.jpg",0,0,19,74,16,109,3.97247706422018,0.568603155179595,80.2838983050847
"4906735319.jpg",0,0,25,68,6,99,3.80808080808081,0.528315916558584,78.4583333333333
"4906902596.jpg",0,5,74,31,1,111,3.25225225225225,0.547198957808492,61.5723684210526
"4907748522.jpg",0,6,58,47,0,111,3.36936936936937,0.586638000937669,65.3919491525424
"4907901600.jpg",0,3,43,55,3,104,3.55769230769231,0.604624943152366,68.2090517241379
"4908270930.jpg",0,31,65,4,0,100,2.73,0.529054808029367,46.3371559633027
"4908441792.jpg",2,32,66,7,0,107,2.72897196261682,0.607657013763768,46.2193396226415
"4909946838.jpg",0,0,50,61,0,111,3.54954954954955,0.499795207855427,70.4551282051282
"4910377121.jpg",6,79,15,0,0,100,2.09,0.451596494604856,28.3233944954128
"4911877298.jpg",0,14,62,26,0,102,3.11764705882353,0.618111426512505,56.9084821428571
"4911990100.jpg",1,11,106,12,0,130,2.99230769230769,0.457430536026189,55.4375
"4912317009.jpg",0,0,30,69,5,104,3.75961538461538,0.530528081075412,76.2617924528302
"4912437730.jpg",1,1,19,72,11,104,3.875,0.633797309181897,79.2571428571429
"4913587642.jpg",0,0,32,73,6,111,3.76576576576577,0.538600120766873,75.8093220338983
"4915971389.jpg",0,29,62,13,0,104,2.84615384615385,0.619571270013257,52.2970297029703
"4918086314.jpg",0,3,51,51,2,107,3.48598130841122,0.588642281437874,67.0693277310924
"491839128.jpg",7,67,34,0,0,108,2.25,0.565768024851109,34.6292372881356
"4918979865.jpg",0,1,46,57,1,105,3.55238095238095,0.536745040121693,68.0760869565217
"4919695267.jpg",1,20,65,23,1,110,3.02727272727273,0.683475883068022,55.5064102564103
"4920401436.jpg",1,49,82,1,0,133,2.62406015037594,0.516419839762162,44.8125
"4920539113.jpg",0,0,35,72,4,111,3.72072072072072,0.525204222983285,74.6153846153846
"4921474940.jpg",0,5,64,37,1,107,3.31775700934579,0.576229298586476,63.0306603773585
"4921721859.jpg",0,4,50,47,2,103,3.45631067961165,0.606770606735818,70.4696261682243
"4921823031.jpg",0,1,48,57,0,106,3.52830188679245,0.520211443637723,70.4779411764706
"4922516594.jpg",0,44,55,7,0,106,2.65094339622642,0.602256911327458,44.0337837837838
"4922576334.jpg",0,2,55,48,3,108,3.48148148148148,0.587748459794076,68.4601769911504
"4922763994.jpg",0,9,63,28,0,100,3.19,0.580751863770343,58.4415887850467
"4922860865.jpg",3,28,61,11,0,103,2.77669902912621,0.670557842615509,47.0379464285714
"4922892935.jpg",0,0,27,73,4,104,3.77884615384615,0.50158449460463,74.3411016949153
"4923216773.jpg",0,1,39,60,6,106,3.66981132075472,0.59716310467485,75.0290178571429
"4923537063.jpg",0,8,68,23,2,101,3.18811881188119,0.595195283703235,56.3279816513761
"4924398774.jpg",4,26,58,18,0,106,2.84905660377358,0.740559027327312,51.4575892857143
"4925153617.jpg",0,1,52,53,0,106,3.49056603773585,0.520901837363733,69.3228155339806
"4925167261.jpg",0,7,64,35,0,106,3.26415094339623,0.574072946956807,60.968487394958
"4925344781.jpg",0,1,33,68,3,105,3.6952380952381,0.539298146522395,72.8407079646018
"4926447658.jpg",0,6,71,23,0,100,3.17,0.513553671720273,59.9610091743119
"4926787829.jpg",0,17,65,20,1,103,3.04854368932039,0.632124348289149,55.1939655172414
"492751146.jpg",1,17,57,25,0,100,3.06,0.678977246312497,52.9092920353982
"4930262989.jpg",0,9,53,47,2,111,3.37837837837838,0.661321735123259,62.80625
"493128717.jpg",0,1,58,51,0,110,3.45454545454545,0.51822498100965,66.8513513513514
"4931966065.jpg",1,30,62,11,0,104,2.79807692307692,0.629066309072309,49.0441176470588
"4932130784.jpg",1,2,59,47,0,109,3.39449541284404,0.577644460428686,64.6625
"4932950485.jpg",0,36,54,6,0,96,2.6875,0.586021375575652,44.4711538461538
"4933863195.jpg",1,26,71,7,1,106,2.82075471698113,0.598365548590026,48.7162162162162
"4935990245.jpg",0,10,66,24,0,100,3.14,0.568890467169528,57.3621495327103
"4936086328.jpg",0,0,34,70,2,106,3.69811320754717,0.500852821661969,73.1875
"4937662029.jpg",0,2,44,58,0,104,3.53846153846154,0.538301480532277,71.0471698113208
"4938188075.jpg",5,28,51,17,0,101,2.79207920792079,0.778676205918331,47.4418103448276
"494015270.jpg",1,23,59,17,0,100,2.92,0.661800421562119,50.954128440367
"4940371977.jpg",0,2,52,48,2,104,3.48076923076923,0.574215703707125,66.4797297297297
"4940996206.jpg",0,0,54,52,0,106,3.49056603773585,0.502285879874493,69.0067567567568
"4941076531.jpg",0,4,55,44,1,104,3.40384615384615,0.583248864754567,63.8706896551724
"4941401132.jpg",0,0,23,72,10,105,3.87619047619048,0.549391938265845,76.5758928571429
"4941443673.jpg",0,4,66,41,0,111,3.33333333333333,0.544949260913066,63.364406779661
"4942239073.jpg",0,13,86,11,0,110,2.98181818181818,0.468881514772918,52.3252212389381
"494236256.jpg",0,54,44,2,0,100,2.48,0.54085603678359,38.6926605504587
"4943600012.jpg",0,6,48,45,4,103,3.45631067961165,0.668282830654486,69.3798076923077
"49445241.jpg",0,31,66,11,1,109,2.8348623853211,0.631191722178063,50.5
"4944793972.jpg",0,5,74,20,1,100,3.17,0.513553671720273,60.3844339622642
"4945508144.jpg",2,16,75,13,0,106,2.93396226415094,0.589896971222672,51.2051282051282
"4947244.jpg",5,69,31,4,0,109,2.31192660550459,0.619098025302731,36.1818181818182
"4947500856.jpg",0,1,36,68,0,105,3.63809523809524,0.502375310282017,73.3276699029126
"4947572555.jpg",0,1,53,43,3,100,3.48,0.577000253838153,69.9027777777778
"4948021193.jpg",1,4,60,44,2,111,3.37837837837838,0.633232027761389,62.6652542372881
"4948125167.jpg",0,9,44,48,2,103,3.41747572815534,0.679161418403784,63.90625
"4949714700.jpg",0,6,65,30,0,101,3.23762376237624,0.550427376708048,59.6991150442478
"4950276392.jpg",2,54,50,1,0,107,2.46728971962617,0.554871343397283,39.4768907563025
"4950643421.jpg",0,3,59,36,3,101,3.38613861386139,0.599504746098027,63.5067567567568
"4952399474.jpg",0,11,76,24,0,111,3.11711711711712,0.551670829698929,59.8260869565217
"4953282690.jpg",73,25,8,1,0,107,1.41121495327103,0.672271158062704,11.1218487394958
"4953733701.jpg",0,0,12,73,21,106,4.08490566037736,0.55408310410386,82.3114406779661
"4953755434.jpg",0,14,65,22,0,101,3.07920792079208,0.594696028519305,58.45
"4954115704.jpg",0,11,78,44,0,133,3.24812030075188,0.595513720646885,62.8143382352941
"4954209731.jpg",3,31,63,2,0,99,2.64646464646465,0.576993108456905,42.3230088495575
"4955052105.jpg",0,6,67,33,0,106,3.25471698113208,0.553109319337024,61.6195652173913
"4955674278.jpg",0,12,111,29,0,152,3.11184210526316,0.508853302547423,59.1299342105263
"4958359048.jpg",0,0,69,39,0,108,3.36111111111111,0.482561958315932,63.5685840707965
"4958737471.jpg",0,5,62,41,0,108,3.33333333333333,0.563699396261691,66.1438679245283
"4960025889.jpg",1,25,77,6,0,109,2.80733944954128,0.535361840602941,48.7905405405405
"4960147659.jpg",6,50,40,9,0,105,2.4952380952381,0.73541994183085,42.25
"4960586032.jpg",0,18,63,23,0,104,3.04807692307692,0.629066309072309,55.1824324324324
"496109303.jpg",3,35,66,7,0,111,2.69369369369369,0.629470091610869,45.4661016949153
"4961168084.jpg",0,2,39,71,2,114,3.64035087719298,0.550578022610351,73.4166666666667
"4961486371.jpg",1,6,61,40,3,111,3.34234234234234,0.667362454272523,62.7351694915254
"496162577.jpg",4,35,64,7,0,110,2.67272727272727,0.651168193848999,45.3163716814159
"4962117985.jpg",9,67,30,1,0,107,2.21495327102804,0.599182420692982,32.3919491525424
"4962875195.jpg",0,3,32,66,3,104,3.66346153846154,0.584767432371758,74.8119469026549
"4965455693.jpg",1,22,75,6,0,104,2.82692307692308,0.529559400892795,48.9217391304348
"4965802871.jpg",8,44,55,2,0,109,2.46788990825688,0.660650736149587,37.9040178571429
"4965946284.jpg",1,18,100,6,0,125,2.888,0.461693935765438,52.876
"4966132108.jpg",0,20,63,22,0,105,3.01904761904762,0.635200640333315,56.6262376237624
"4966811903.jpg",0,7,56,44,2,109,3.37614678899083,0.635216364796543,62.6
"4967412135.jpg",0,3,49,51,1,104,3.48076923076923,0.574215703707125,67.5789473684211
"4968475623.jpg",0,15,71,29,0,115,3.12173913043478,0.609109590101505,56.7413043478261
"4969822064.jpg",0,10,71,20,0,101,3.0990099009901,0.538608401253629,56.1766055045872
"497163401.jpg",0,0,35,68,3,106,3.69811320754717,0.519520132443754,73.7118644067797
"4972378781.jpg",0,1,28,74,3,106,3.74528301886792,0.517527468876994,74.0304347826087
"4972553952.jpg",0,1,65,42,0,108,3.37962962962963,0.506363110683967,65.5878378378378
"4972615412.jpg",6,59,40,3,0,108,2.37037037037037,0.635295098000753,36.4308035714286
"4973124317.jpg",0,14,59,32,0,105,3.17142857142857,0.642368556700406,56.8781512605042
"497525662.jpg",0,31,102,8,1,142,2.85211267605634,0.531919888099616,51.7287234042553
"4975468754.jpg",0,3,52,44,2,101,3.44554455445545,0.591189437063155,63.7454128440367
"4975653682.jpg",0,0,37,66,4,107,3.69158878504673,0.539238018529624,73.1513157894737
"4975773859.jpg",0,0,21,73,13,107,3.92523364485981,0.561348352805072,78.1964285714286
"4975990286.jpg",0,5,39,48,9,101,3.6039603960396,0.72220783602495,69.1554054054054
"4976142964.jpg",0,17,68,13,0,98,2.95918367346939,0.554612660358259,52.6554054054054
"4976232823.jpg",0,2,32,67,2,103,3.66990291262136,0.549301687074422,74.3774038461538
"4976269857.jpg",0,0,18,90,2,110,3.85454545454545,0.402660045936803,76.8580508474576
"4976501337.jpg",0,6,55,49,0,110,3.39090909090909,0.591925090497635,61.9390756302521
"4978032841.jpg",11,88,11,0,0,110,2,0.449260350337442,25.6800847457627
"4979420600.jpg",0,4,73,33,0,110,3.26363636363636,0.518948703114017,62.4662162162162
"4979581696.jpg",0,4,82,43,0,129,3.30232558139535,0.524473711847033,65.130859375
"4980059014.jpg",0,8,73,22,1,104,3.15384615384615,0.553352198616052,60.2867647058824
"4980829250.jpg",27,56,16,7,0,106,2.02830188679245,0.821816190430408,26.728813559322
"4981035833.jpg",0,0,41,59,2,102,3.61764705882353,0.527353145004104,69.925
"4981184708.jpg",0,12,80,14,0,106,3.0188679245283,0.497252107668146,55.588785046729
"4982428461.jpg",0,5,59,42,0,106,3.34905660377358,0.569752708766225,65.8564356435644
"4982617348.jpg",0,10,84,14,0,108,3.03703703703704,0.472138224769331,56.7453271028037
"498265046.jpg",1,66,42,0,0,109,2.37614678899083,0.505323343966204,36.8875
"4983471695.jpg",0,8,61,38,1,108,3.2962962962963,0.615367973787818,62.4587155963303
"4984086049.jpg",23,62,17,0,0,102,1.94117647058824,0.626534226412754,24.9567307692308
"4985059388.jpg",0,1,28,73,4,106,3.75471698113208,0.531150068556846,75.25
"4985166775.jpg",1,7,59,40,0,107,3.28971962616822,0.629605234124999,60.60625
"4985465789.jpg",0,5,89,37,0,131,3.24427480916031,0.512784300933265,61.6033834586466
"4985988258.jpg",0,18,62,27,0,107,3.08411214953271,0.646054722361008,55.6995798319328
"4986076377.jpg",0,2,49,50,0,101,3.47524752475248,0.540260296633773,69.55
"4986510349.jpg",26,77,8,0,0,111,1.83783783783784,0.531559293546151,21.4152542372881
"4986682017.jpg",51,49,2,0,0,102,1.51960784313725,0.540084191399139,13.5677570093458
"4987072948.jpg",0,6,77,45,0,128,3.3046875,0.554985901076506,65.2321428571429
"4987191446.jpg",16,83,11,1,0,111,1.97297297297297,0.530170803686021,25.1906779661017
"4987318624.jpg",2,44,56,5,0,107,2.5981308411215,0.612138427495947,44.5
"49874259.jpg",0,9,54,45,1,109,3.34862385321101,0.643718174891012,62.4318181818182
"4988320464.jpg",0,2,38,73,0,113,3.6283185840708,0.520897067318328,69.2564102564103
"4989044190.jpg",0,2,55,51,2,110,3.48181818181818,0.570398511614213,67.9705882352941
"4989495161.jpg",0,0,23,78,8,109,3.86238532110092,0.517613646641916,77.2942477876106
"499095228.jpg",0,1,11,66,23,101,4.0990099009901,0.608357633223247,81.9862385321101
"4991407708.jpg",0,2,44,59,4,109,3.59633027522936,0.595029816480527,68.4347826086957
"4991538106.jpg",0,10,57,34,1,102,3.25490196078431,0.640022810698134,60.8692660550459
"4991939718.jpg",0,6,72,24,0,102,3.17647058823529,0.51534405898039,62.6415094339623
"4992884384.jpg",0,1,33,79,0,113,3.69026548672566,0.483285741005166,70.3846153846154
"4994678050.jpg",0,3,57,59,1,120,3.48333333333333,0.564843003893665,70.3
"4995010778.jpg",2,11,59,29,1,102,3.15686274509804,0.700001386691918,57.4864864864865
"4995119944.jpg",0,1,40,63,1,105,3.60952380952381,0.527972138237027,73.6155660377358
"4996107093.jpg",0,1,25,79,1,106,3.75471698113208,0.474317971602474,78.9330357142857
"4996581735.jpg",0,0,13,82,15,110,4.01818181818182,0.506504810048403,78.6470588235294
"4996783204.jpg",0,0,23,77,1,101,3.78217821782178,0.438268419944664,78.5817307692308
"4996914779.jpg",0,20,65,14,1,100,2.96,0.618241233033047,52.525
"4999850616.jpg",2,34,62,5,0,103,2.67961165048544,0.597602927930226,46.0803571428571
"5000010668.jpg",1,11,58,26,1,97,3.15463917525773,0.666774046335023,55.6836283185841
"5000264687.jpg",1,17,71,17,0,106,2.9811320754717,0.601286431633151,52.4576271186441
"500101169.jpg",0,0,33,63,7,103,3.74757281553398,0.572549280385056,74.2012711864407
"5001067426.jpg",0,4,46,57,4,111,3.54954954954955,0.628688949520982,71.724358974359
"50012842.jpg",0,0,31,58,20,109,3.89908256880734,0.679664325215851,78.8636363636364
"5001626870.jpg",31,69,7,0,0,107,1.77570093457944,0.554712422774405,19.675
"5001719293.jpg",5,56,42,3,0,106,2.40566037735849,0.629108240922058,36.9364406779661
"5001805928.jpg",3,40,57,1,0,101,2.55445544554455,0.574025217647317,40.1689189189189
"5001866078.jpg",0,7,74,58,1,140,3.37857142857143,0.593342648440491,65.8051724137931
"5003189524.jpg",0,1,36,62,3,102,3.65686274509804,0.553925648926753,74.725
"5003482891.jpg",0,1,53,52,0,106,3.4811320754717,0.520643047000473,67.4194915254237
"5004699048.jpg",0,0,48,57,3,108,3.58333333333333,0.549000791583107,69.6052631578947
"5005406987.jpg",0,2,55,46,3,106,3.47169811320755,0.588906123488388,67.6991525423729
"5005558786.jpg",0,0,44,53,7,104,3.64423076923077,0.606089955045593,71.7142857142857
"5005908077.jpg",0,3,55,43,5,106,3.47169811320755,0.635573189668175,64.0635593220339
"5007844069.jpg",1,26,60,18,0,105,2.9047619047619,0.672592709134549,52.9029126213592
"500876950.jpg",0,3,37,53,11,104,3.69230769230769,0.697804087966653,73.2413043478261
"5008940426.jpg",0,6,80,26,0,112,3.17857142857143,0.506076334275034,59.8782051282051
"5010052937.jpg",0,1,21,70,8,100,3.85,0.557320429022713,76.9151376146789
"5012894248.jpg",0,3,60,41,1,105,3.38095238095238,0.561264924094064,65.9239130434783
"5013129486.jpg",0,3,55,45,1,104,3.42307692307692,0.569317555905564,68.3623853211009
"5013265495.jpg",0,1,38,67,1,107,3.63551401869159,0.521111355290732,74.2837837837838
"5013613228.jpg",0,1,49,54,1,105,3.52380952380952,0.538788493096354,67
"5014526130.jpg",0,0,67,62,0,129,3.48062015503876,0.50157214077648,69.9154135338346
"5014551340.jpg",0,0,37,67,1,105,3.65714285714286,0.496692356195761,71.8310810810811
"5016016369.jpg",0,0,52,53,2,107,3.53271028037383,0.537600486602462,68.6205357142857
"5016420324.jpg",0,6,54,43,1,104,3.375,0.610387430681514,65.8214285714286
"5016657118.jpg",2,28,92,7,0,129,2.8062015503876,0.545972746856542,49.4454887218045
"501669092.jpg",10,78,17,0,0,105,2.06666666666667,0.505102172959299,27.4441964285714
"5016823142.jpg",1,26,60,11,0,98,2.8265306122449,0.62632145173936,49.2184466019417
"5017205636.jpg",0,8,66,34,0,108,3.24074074074074,0.57794949121826,62.4509345794393
"5017257541.jpg",0,7,60,80,5,152,3.54605263157895,0.639109643398079,72.3259493670886
"5017267795.jpg",0,7,91,36,0,134,3.21641791044776,0.525470649023401,61.6195652173913
"5017618497.jpg",0,2,52,53,2,109,3.5045871559633,0.571285963468144,65.1822033898305
"5018846919.jpg",1,30,69,7,0,107,2.76635514018692,0.575923200663901,47.4158878504673
"5021524796.jpg",0,2,56,45,1,104,3.43269230769231,0.553267839716467,66.7079646017699
"502182808.jpg",0,1,23,76,1,101,3.76237623762376,0.472197307308823,71.7683486238532
"5022600998.jpg",0,0,31,73,3,107,3.73831775700935,0.501628453763451,77.1482300884956
"5022993325.jpg",1,6,39,53,3,102,3.5,0.700070717785704,70.7844036697248
"5023353600.jpg",0,22,73,12,1,108,2.92592592592593,0.591271459134453,52.5442477876106
"502416007.jpg",4,55,43,3,0,105,2.42857142857143,0.61795479759294,38.0871559633027
"5024762120.jpg",0,0,24,71,5,100,3.81,0.506423386569624,76.2162162162162
"5025588176.jpg",0,2,45,59,3,109,3.57798165137615,0.582039485450234,68.2195652173913
"5026427468.jpg",0,5,62,37,1,105,3.32380952380952,0.58004041794248,64.0586956521739
"5027216651.jpg",0,3,55,49,0,107,3.42990654205607,0.551364508625548,66.1897321428571
"5027281781.jpg",0,5,48,55,0,108,3.46296296296296,0.586864405455927,69.0817757009346
"5027882580.jpg",0,0,30,59,18,107,3.88785046728972,0.663425968111645,78.6513157894737
"5028374263.jpg",10,60,27,2,0,99,2.21212121212121,0.643217792054015,30.7160194174757
"5028389463.jpg",1,31,60,13,0,105,2.80952380952381,0.651850001847377,48.8808411214953
"5028571969.jpg",0,6,68,30,0,104,3.23076923076923,0.543822665820023,60.0301724137931
"5032381168.jpg",4,55,39,5,0,103,2.43689320388349,0.651843583315984,38.125
"503291895.jpg",0,7,61,44,0,112,3.33035714285714,0.591050261687119,64.3910256410256
"5032946224.jpg",3,51,51,4,0,109,2.51376146788991,0.61786188824524,40.9915254237288
"503496072.jpg",0,15,61,24,0,100,3.09,0.621093854226216,55.375
"5034975248.jpg",0,13,50,41,4,108,3.33333333333333,0.736244575373126,64.5408653846154
"5035645781.jpg",0,8,76,26,0,110,3.16363636363636,0.53376407404297,57.7875
"5036248276.jpg",0,3,62,34,2,101,3.34653465346535,0.573334868368503,61.3233944954128
"5036262446.jpg",0,1,45,53,1,100,3.54,0.539734315485991,68.2336448598131
"5036806312.jpg",0,47,56,0,0,103,2.54368932038835,0.500523236598486,39.5486725663717
"5037000610.jpg",0,3,34,66,0,103,3.61165048543689,0.54652215405893,69.3571428571429
"5037503230.jpg",0,4,71,32,0,107,3.26168224299065,0.520095212584592,61.9390756302521
"5038562159.jpg",0,0,35,70,1,106,3.67924528301887,0.488869830007768,75.8392857142857
"5038604558.jpg",0,0,16,77,12,105,3.96190476190476,0.517460692000434,78.222972972973
"5040119968.jpg",1,61,38,0,0,100,2.37,0.505624925865573,34.8325688073394
"5040602393.jpg",0,18,61,22,0,101,3.03960396039604,0.631201902392696,56.05
"5040853192.jpg",25,67,12,1,0,105,1.8952380952381,0.618991262579839,23.789603960396
"5041593593.jpg",4,29,51,17,0,101,2.8019801980198,0.761837278953951,47.8986486486486
"5043851130.jpg",7,50,39,6,0,102,2.43137254901961,0.710735275690091,38.5216346153846
"5044457387.jpg",0,5,83,38,2,128,3.2890625,0.563346912740709,64.294
"5047082376.jpg",0,6,54,41,1,102,3.36274509803922,0.60997022628644,66.3653846153846
"5050399849.jpg",0,12,111,7,0,130,2.96153846153846,0.381832508307917,54.5935114503817
"5051600612.jpg",0,8,56,40,5,109,3.38532110091743,0.692663363278589,63.08125
"5053500577.jpg",0,3,57,43,1,104,3.40384615384615,0.566358334015961,65.1584821428571
"5055213857.jpg",0,31,74,6,0,111,2.77477477477477,0.534018806013501,48.8194444444444
"5056056125.jpg",0,7,41,47,3,98,3.46938775510204,0.676621102343975,67.0743243243243
"5056738651.jpg",1,3,37,60,5,106,3.61320754716981,0.670049816441976,70.6050420168067
"5058312922.jpg",0,11,77,15,0,103,3.03883495145631,0.50336768024131,57.1891891891892
"5058695994.jpg",0,1,13,73,20,107,4.04672897196262,0.588941768753835,80.9348739495798
"5059274251.jpg",0,6,62,27,1,96,3.23958333333333,0.575733704281427,62.6370192307692
"5059626281.jpg",1,19,78,11,0,109,2.90825688073395,0.55346190614119,52.3652173913043
"5060000840.jpg",0,2,25,74,2,103,3.7378640776699,0.523209646590323,75.25
"5060158839.jpg",0,13,68,17,0,98,3.04081632653061,0.554612660358259,54.1330275229358
"5060270217.jpg",1,4,72,28,0,105,3.20952380952381,0.549391938265845,59.2478448275862
"5062026548.jpg",4,47,50,4,0,105,2.51428571428571,0.637215784521975,38.5592105263158
"5062110567.jpg",0,25,77,6,0,108,2.82407407407407,0.508409719674872,48.6184210526316
"5062330348.jpg",0,1,58,46,1,106,3.44339622641509,0.535949334478999,68.2195652173913
"5063711541.jpg",1,14,70,24,0,109,3.07339449541284,0.619235221542709,55.5609243697479
"5064165053.jpg",0,1,29,76,8,114,3.79824561403509,0.567244926285394,76.2205882352941
"5064176245.jpg",0,0,25,68,10,103,3.85436893203884,0.567204479335504,75.1756756756757
"5064264405.jpg",0,13,67,28,0,108,3.13888888888889,0.60308139177812,58.9597457627119
"5064418031.jpg",2,48,49,0,0,99,2.47474747474747,0.541038954111446,37.2853982300885
"5064515429.jpg",1,20,104,27,0,152,3.03289473684211,0.58022333172159,57.5178571428571
"5064578225.jpg",0,4,48,48,1,101,3.45544554455446,0.592026223663235,67
"5064823395.jpg",1,44,54,1,0,100,2.55,0.538891492235719,41.2660550458716
"5065354809.jpg",0,3,71,55,0,129,3.4031007751938,0.537926863130593,67.7795275590551
"5066476555.jpg",0,0,19,81,6,106,3.87735849056604,0.472134568966241,75.5296610169491
"5067206886.jpg",8,56,35,1,0,100,2.29,0.624338033278432,32.9103773584906
"5068225832.jpg",0,16,111,10,0,137,2.95620437956204,0.435022195828019,54.5036764705882
"5069309990.jpg",20,74,10,0,0,104,1.90384615384615,0.530967806041971,22.7828947368421
"5070455487.jpg",0,0,50,54,1,105,3.53333333333333,0.520108469949126,68.8491379310345
"5071049710.jpg",0,24,67,15,2,108,2.9537037037037,0.661127036292569,51.0546218487395
"5071912841.jpg",0,4,58,40,3,105,3.4,0.61394061351492,64.2739130434783
"5073500906.jpg",0,9,59,33,1,102,3.25490196078431,0.624361448214029,58.825
"5073566975.jpg",0,9,77,25,0,111,3.14414414414414,0.536772287030998,60.0301724137931
"5073919092.jpg",0,26,74,6,0,106,2.81132075471698,0.518481437371168,47.1852678571429
"5074508109.jpg",0,8,79,14,0,101,3.05940594059406,0.465226443320193,55.6
"507507455.jpg",0,2,43,59,4,108,3.60185185185185,0.594991790013488,72.15625
"5075275205.jpg",0,3,35,82,0,120,3.65833333333333,0.526536699916106,76.00625
"5076506.jpg",0,3,30,67,7,107,3.72897196261682,0.622988740592157,73.3088235294118
"5077869968.jpg",1,50,52,5,0,108,2.56481481481481,0.600204764874847,42.8289473684211
"5078692396.jpg",0,5,40,65,0,110,3.54545454545455,0.584766300632395,66.10625
"5078922181.jpg",0,11,78,20,0,109,3.08256880733945,0.529297934146812,56.171875
"5079448176.jpg",0,0,51,52,5,108,3.57407407407407,0.583314789795751,68.8177966101695
"5081374671.jpg",3,42,52,6,0,103,2.59223300970874,0.648329576135343,44.0752212389381
"5081637571.jpg",0,25,71,11,0,107,2.86915887850467,0.567751476149933,50.9852941176471
"5082407583.jpg",0,11,117,11,1,140,3.01428571428571,0.432255491424218,56.6592465753425
"5082552221.jpg",2,69,41,2,0,114,2.37719298245614,0.554791691389907,36.5603448275862
"5083127743.jpg",0,1,36,63,2,102,3.64705882352941,0.538554332247695,73.975
"5083763203.jpg",0,44,55,4,0,103,2.61165048543689,0.564175777585734,42.7610619469027
"5086754457.jpg",0,2,57,38,1,98,3.38775510204082,0.549276057032683,67.0778301886792
"5090001239.jpg",0,10,58,29,0,97,3.19587628865979,0.606203610901004,59.1216216216216
"5090174589.jpg",5,82,20,0,0,107,2.14018691588785,0.464770142637808,30.49375
"5090549164.jpg",0,3,57,44,2,106,3.42452830188679,0.584695495964266,66.3599137931034
"5090550218.jpg",0,4,65,35,2,106,3.33018867924528,0.580995830051548,64.4955357142857
"5090803058.jpg",0,13,67,23,0,103,3.09708737864078,0.586022871580632,54.3303571428571
"5091406011.jpg",0,2,38,56,4,100,3.62,0.599326221011495,69.4527027027027
"5091924028.jpg",14,66,16,0,0,96,2.02083333333333,0.561561107265258,25.8308823529412
"5092945872.jpg",9,84,15,0,0,108,2.05555555555556,0.470301818647401,28.775
"5094262203.jpg",0,2,42,62,0,106,3.56603773584906,0.534858555837821,68.7331932773109
"5094631896.jpg",0,7,66,26,2,101,3.22772277227723,0.598016523497669,57.993119266055
"5095300668.jpg",0,2,26,76,7,111,3.79279279279279,0.573935649182144,76.0961538461538
"5095808820.jpg",5,65,37,3,0,110,2.34545454545455,0.612355410926592,35.8025210084034
"5096803300.jpg",0,2,63,64,0,129,3.48062015503876,0.531812572626015,69.6052631578947
"5097068931.jpg",0,0,17,84,7,108,3.90740740740741,0.464376519748953,82.7361111111111
"5097561600.jpg",0,2,41,59,9,111,3.67567567567568,0.648945468533544,72.5705128205128
"5097621606.jpg",0,4,61,34,1,100,3.32,0.566399223876658,62.2316513761468
"5098218882.jpg",3,62,34,7,0,106,2.42452830188679,0.661140619111391,39.0934782608696
"5098219464.jpg",10,44,53,2,0,109,2.43119266055046,0.685389487499818,39.0609243697479
"5099738809.jpg",0,2,62,37,2,103,3.37864077669903,0.562147577692258,67.0778301886792
"5101081807.jpg",0,0,27,70,4,101,3.77227722772277,0.507566510298146,72.6766055045872
"5101108569.jpg",2,42,50,10,0,104,2.65384615384615,0.679366220486757,45.1195652173913
"5103528737.jpg",11,62,29,2,0,104,2.21153846153846,0.648719080271491,33.1897321428571
"5104334034.jpg",0,3,44,54,0,101,3.5049504950495,0.558994854649622,68.375
"5105331099.jpg",44,57,5,0,0,106,1.63207547169811,0.574464084800752,15.8058035714286
"5106008666.jpg",0,1,67,32,3,103,3.35922330097087,0.557557153177668,66.5330188679245
"510686957.jpg",0,12,71,24,0,107,3.11214953271028,0.571774840295603,58.1607142857143
"5107410477.jpg",1,9,74,16,0,100,3.05,0.538891492235719,56.1631355932203
"5107763844.jpg",0,5,56,44,0,105,3.37142857142857,0.576079970028582,65.3823529411765
"5113314470.jpg",0,10,74,17,0,101,3.06930693069307,0.514925737219927,55.75
"5114869072.jpg",0,0,34,69,3,106,3.70754716981132,0.515788460368257,74.5133928571429
"5115371206.jpg",0,5,72,25,0,102,3.19607843137255,0.508136094779063,57.3119266055046
"5115968572.jpg",0,6,58,40,1,105,3.34285714285714,0.601737411241741,62.695652173913
"5116959473.jpg",0,1,15,85,5,106,3.88679245283019,0.464363460212572,82.8370535714286
"5117589590.jpg",0,1,45,55,3,104,3.57692307692308,0.569317555905564,69.5108695652174
"5118376207.jpg",0,4,66,30,3,103,3.31067961165049,0.594568985650855,65.05
"5118419705.jpg",0,19,61,22,1,103,3.04854368932039,0.662417449932058,56.222972972973
"5119374431.jpg",1,16,78,6,1,102,2.90196078431373,0.536025045993237,49.825
"5119867805.jpg",0,33,84,4,0,121,2.7603305785124,0.500413052528105,48.36875
"5120849681.jpg",7,56,36,4,0,103,2.35922330097087,0.669421303082274,35.9642857142857
"5121229620.jpg",6,36,65,5,0,112,2.61607142857143,0.660951207999879,43.5413043478261
"5121622263.jpg",0,0,31,78,2,111,3.73873873873874,0.480751527425583,71.614406779661
"5122027937.jpg",0,4,54,47,2,107,3.4392523364486,0.601532164692449,67.3716216216216
"5122879673.jpg",1,18,65,20,3,107,3.05607476635514,0.711519443786014,54.0357142857143
"5124180488.jpg",0,0,13,91,3,107,3.90654205607477,0.376996828983557,82.7567567567568
"5124446081.jpg",0,6,58,36,6,106,3.39622641509434,0.685624432567636,64.0882352941177
"5125398207.jpg",0,4,78,56,0,138,3.3768115942029,0.543077181953011,67.2989130434783
"5125486524.jpg",4,49,49,11,0,113,2.5929203539823,0.715106986770822,42.1806722689076
"5128049833.jpg",1,27,82,9,0,119,2.83193277310924,0.557222648667485,50.2884615384615
"5128108683.jpg",0,1,49,52,0,102,3.5,0.521801904675301,69.85
"5128756378.jpg",0,0,11,81,16,108,4.0462962962963,0.500173040323575,80.1029411764706
"5129080312.jpg",10,79,21,1,0,111,2.11711711711712,0.551670829698929,27.8304347826087
"5129172.jpg",42,60,5,0,0,107,1.65420560747664,0.568061977390618,18.5399159663866
"5129204001.jpg",0,15,69,15,0,99,3,0.553283335172488,54.9655963302752
"5129872416.jpg",0,1,50,48,3,102,3.51960784313725,0.575582221924289,67.2171052631579
"5130720224.jpg",0,0,34,63,4,101,3.7029702970297,0.539343201597008,73.6458333333333
"5130906829.jpg",0,5,72,31,1,109,3.25688073394495,0.55115484355109,61.3783185840708
"513128907.jpg",0,0,7,86,15,108,4.07407407407407,0.44729098817952,80.4495798319328
"5131861392.jpg",0,4,59,44,0,107,3.37383177570093,0.558356153431767,64.525
"5132091056.jpg",8,44,51,4,0,107,2.47663551401869,0.691536358919752,41.0088495575221
"5133576528.jpg",2,56,42,4,0,104,2.46153846153846,0.606166962854181,39.6037735849057
"5134748445.jpg",0,3,64,41,0,108,3.35185185185185,0.535031046610998,64.7627118644068
"5135451445.jpg",0,13,83,13,0,109,3,0.490653381462658,52.8072033898305
"5135908583.jpg",20,74,19,0,0,113,1.99115044247788,0.590029890605415,25.9579831932773
"5135958105.jpg",5,25,61,9,1,101,2.76237623762376,0.723166852828379,47.6995412844037
"5136366226.jpg",0,1,55,69,0,125,3.544,0.515939481322274,70.9897540983606
"5137221601.jpg",0,48,58,6,0,112,2.625,0.587021800783067,42.5320512820513
"513723164.jpg",1,13,73,16,0,103,3.00970873786408,0.568712781692267,56.1216814159292
"5137508075.jpg",0,10,57,33,1,101,3.24752475247525,0.638841773744632,60.775
"5137971670.jpg",6,69,31,0,0,106,2.23584905660377,0.544266860183807,32.7086956521739
"5138080527.jpg",0,4,52,51,0,107,3.4392523364486,0.569302288861533,64.7121848739496
"5138115166.jpg",3,14,48,34,2,101,3.17821782178218,0.804935271981051,58.3644859813084
"5138308179.jpg",1,54,42,7,0,104,2.52884615384615,0.637908152521211,40.9473684210526
"5139553196.jpg",0,2,36,65,4,107,3.66355140186916,0.581863065548848,72.8728813559322
"5140426630.jpg",7,63,35,0,0,105,2.26666666666667,0.57623891056686,32.8214285714286
"5140673192.jpg",0,7,87,17,0,111,3.09009009009009,0.458248633376915,57.5614406779661
"5141696799.jpg",0,2,49,53,2,106,3.5188679245283,0.572897931164701,71.9345794392523
"5142063764.jpg",4,55,61,3,0,123,2.51219512195122,0.605519065483932,40.8181818181818
"5142391146.jpg",1,25,76,6,0,108,2.80555555555556,0.53753214784685,48.4894957983193
"5143292163.jpg",0,10,59,25,1,95,3.17894736842105,0.618490739682324,60.7331730769231
"51433626.jpg",6,49,45,9,0,109,2.52293577981651,0.727709881589845,40.8181818181818
"5143740294.jpg",0,5,73,27,0,105,3.20952380952381,0.513195833352107,58.6782608695652
"5144117619.jpg",5,50,46,9,0,110,2.53636363636364,0.712628842073813,42.8846153846154
"5144938786.jpg",0,0,33,73,2,108,3.71296296296296,0.49390539647944,73.570796460177
"514498047.jpg",0,9,80,20,0,109,3.10091743119266,0.508173091837234,56.2455357142857
"5146023515.jpg",0,5,73,57,3,138,3.42028985507246,0.601841386128366,68.375
"5146611755.jpg",0,31,64,8,0,103,2.77669902912621,0.576195072410062,48.6495327102804
"5147986874.jpg",0,3,46,54,1,104,3.50961538461538,0.57445951478755,70.4779411764706
"5149778996.jpg",1,26,66,16,0,109,2.88990825688073,0.64319010410903,51.1239495798319
"5149825714.jpg",0,6,67,36,1,110,3.29090909090909,0.580184319738758,62.3274336283186
"5150554440.jpg",1,25,71,11,0,108,2.85185185185185,0.593025110417193,48.4557522123894
"5150999709.jpg",4,49,47,7,0,107,2.53271028037383,0.677366668762141,41.5567226890756
"5153880006.jpg",0,0,38,59,1,98,3.62244897959184,0.507983807730595,74.9357142857143
"5153889058.jpg",0,2,62,48,2,114,3.43859649122807,0.564982382359804,65.3076923076923
"5155188582.jpg",1,15,61,21,0,98,3.04081632653061,0.640849425789569,55.7224770642202
"5156974621.jpg",5,68,25,3,0,101,2.25742574257426,0.594196353851732,33.8443396226415
"5157059497.jpg",0,3,74,30,0,107,3.25233644859813,0.497037600489617,61.896186440678
"5158391010.jpg",0,5,68,32,0,105,3.25714285714286,0.537597422809103,60.5022123893805
"5158556376.jpg",0,3,52,49,2,106,3.47169811320755,0.588906123488388,67.445945945946
"5158846580.jpg",4,53,41,2,0,100,2.41,0.604611904907235,38.004854368932
"5158869275.jpg",0,36,108,8,0,152,2.81578947368421,0.507180919580455,50.9729299363057
"5159845899.jpg",0,2,69,36,0,107,3.31775700934579,0.506525918819812,64.225
"5162032167.jpg",1,20,80,4,0,105,2.82857142857143,0.489449118459151,48.1959459459459
"5164262533.jpg",1,3,55,42,2,103,3.39805825242718,0.631521751061341,64.3716814159292
"5165838001.jpg",0,0,43,67,1,111,3.62162162162162,0.50549802722489,71.724358974359
"5166185394.jpg",0,4,67,31,1,103,3.28155339805825,0.549821285191929,62.8
"5166352802.jpg",0,25,89,14,0,128,2.9140625,0.547396756166327,53.8392857142857
"5166736586.jpg",0,1,22,77,11,111,3.88288288288288,0.567910664209189,79.2692307692308
"5167059215.jpg",0,0,25,68,5,98,3.79591836734694,0.516913593718044,75.7798165137615
"516784418.jpg",0,2,39,61,8,110,3.68181818181818,0.634364786408574,73.031512605042
"5168340748.jpg",0,4,52,48,2,106,3.45283018867925,0.603672498276344,64.343220338983
"5168834860.jpg",0,0,9,71,30,110,4.19090909090909,0.566584075487033,86.3205128205128
"5170784567.jpg",1,27,73,5,0,106,2.77358490566038,0.539541584397163,47.0263157894737
"5170785709.jpg",1,4,62,35,0,102,3.2843137254902,0.586607142989058,65.5212264150943
"5170858607.jpg",1,4,57,41,0,103,3.33980582524272,0.603151820679722,65.3794642857143
"5170894682.jpg",0,15,59,28,0,102,3.12745098039216,0.639795273992229,59.9911504424779
"5172023888.jpg",0,4,78,27,0,109,3.21100917431193,0.492036480419085,60.6081081081081
"5172112194.jpg",3,66,58,2,0,129,2.45736434108527,0.572927677836398,39.001968503937
"5172565267.jpg",0,49,49,7,0,105,2.6,0.61394061351492,41.6858974358974
"5172812012.jpg",0,8,97,16,0,121,3.06611570247934,0.442258167252316,56.61875
"5173344304.jpg",0,5,58,42,2,107,3.38317757009346,0.608816665608245,62.7710084033613
"517369320.jpg",0,5,101,25,0,131,3.15267175572519,0.45528152647562,60
"5174677992.jpg",0,29,69,9,0,107,2.81308411214953,0.568527411288765,47.845652173913
"5174701484.jpg",2,8,82,15,0,107,3.02803738317757,0.540054922525507,56.171875
"5175429795.jpg",0,0,35,70,0,105,3.66666666666667,0.473665466715671,74.795871559633
"5176288733.jpg",0,0,37,59,4,100,3.67,0.551490175924662,73.45
"5176681750.jpg",0,3,48,54,2,107,3.51401869158878,0.588642281437874,67.1386554621849
"5177150402.jpg",4,48,48,4,0,104,2.5,0.638566355433217,41.6029411764706
"517716589.jpg",0,0,21,75,14,110,3.93636363636364,0.563040121556243,80.353813559322
"5177309012.jpg",0,2,46,59,3,110,3.57272727272727,0.581978449569343,66.175
"5177662225.jpg",0,9,52,47,2,110,3.38181818181818,0.663350104495566,66.1538461538462
"5179986164.jpg",0,24,60,14,0,98,2.89795918367347,0.617440608911778,50.9805825242718
"5180032640.jpg",0,2,60,42,3,107,3.42990654205607,0.584584185920639,68.2
"5180679952.jpg",0,8,71,24,1,104,3.17307692307692,0.565038149623763,58.5366379310345
"518080817.jpg",0,9,64,30,0,103,3.20388349514563,0.583418312593989,61.722972972973
"5182390374.jpg",0,20,72,8,0,100,2.88,0.517960257435673,50.0540540540541
"5183223776.jpg",0,2,39,59,5,105,3.63809523809524,0.606436779693949,69.3771186440678
"5183838812.jpg",1,52,48,6,0,107,2.55140186915888,0.617872870538444,42.3886554621849
"5184506144.jpg",0,1,17,70,19,107,4,0.614295116833951,81.5588235294118
"5184701000.jpg",20,69,20,0,0,109,2,0.608580619450185,24.5304347826087
"5185255513.jpg",0,0,57,71,3,131,3.58778625954198,0.538805359570648,72.8125
"5186117445.jpg",13,101,26,0,0,140,2.09285714285714,0.521431739139176,28.7601351351351
"5186392915.jpg",6,30,63,3,0,102,2.61764705882353,0.645534817753356,41.5688073394495
"5187199880.jpg",0,5,57,42,1,105,3.37142857142857,0.592535991395376,64.345652173913
"5188165911.jpg",0,0,27,75,5,107,3.79439252336449,0.509130182355242,76.1184210526316
"518876891.jpg",7,71,31,0,0,109,2.22018348623853,0.55038367367073,33.2373949579832
"5189289022.jpg",0,2,21,68,11,102,3.86274509803922,0.614014797871709,77.3486842105263
"5189402195.jpg",0,30,63,11,0,104,2.81730769230769,0.603620517915844,50.5
"5189469288.jpg",9,76,36,0,0,121,2.22314049586777,0.569906473405727,32.5317796610169
"5189916555.jpg",0,23,63,16,0,102,2.93137254901961,0.617561540150167,50.875
"5190438831.jpg",0,7,72,30,0,109,3.21100917431193,0.54557809121954,59.9978991596639
"5190675640.jpg",0,3,37,67,3,110,3.63636363636364,0.586190824791061,68.8177966101695
"5191833722.jpg",11,60,30,4,0,105,2.25714285714286,0.693771346567932,33.5373831775701
"5192051586.jpg",0,18,98,14,0,130,2.96923076923077,0.497099518033221,54.2888888888889
"5192151844.jpg",0,1,42,56,0,99,3.55555555555556,0.51946248164932,71.5833333333333
"5192516842.jpg",1,31,60,11,0,103,2.78640776699029,0.636326550722794,47.5796460176991
"5193757906.jpg",0,12,67,26,2,107,3.16822429906542,0.636707054887574,59.575
"5193876375.jpg",3,59,41,2,0,105,2.4,0.58177447388274,38.7650862068966
"5195185160.jpg",0,0,48,51,2,101,3.54455445544554,0.538975926646961,69.4444444444444
"5195283750.jpg",0,1,61,33,2,97,3.37113402061856,0.546191122472749,66.9191176470588
"5195745450.jpg",1,18,55,19,5,98,3.09183673469388,0.787619860868547,56.4036697247706
"5196364865.jpg",0,0,50,51,1,102,3.51960784313725,0.521429720673115,70.0663716814159
"5197308883.jpg",0,5,41,53,7,106,3.58490566037736,0.688240330785719,69.3072033898305
"5197338148.jpg",0,3,36,54,3,96,3.59375,0.60833032924036,72.6571428571429
"5197644731.jpg",0,12,70,21,0,103,3.0873786407767,0.561978230624793,56.5707547169811
"5197869977.jpg",26,70,8,0,0,104,1.82692307692308,0.547586189382175,21.2844036697248
"5198260109.jpg",0,5,68,25,2,100,3.24,0.570663268185859,59.5138888888889
"5198400630.jpg",0,14,64,23,1,102,3.1078431372549,0.627849744670753,58.4326923076923
"5199036142.jpg",10,74,24,2,0,110,2.16363636363636,0.598580472578076,31.04375
"5200236444.jpg",0,6,57,42,2,107,3.37383177570093,0.622280718155662,65.7364864864865
"5200584536.jpg",0,34,65,6,0,105,2.73333333333333,0.559303596287842,46.1924778761062
"5202282320.jpg",0,1,22,71,6,100,3.82,0.538985204347068,76.8421052631579
"5204128955.jpg",0,24,66,15,2,107,2.95327102803738,0.664222876468738,51.1292372881356
"5204782737.jpg",0,30,69,3,0,102,2.73529411764706,0.505934496371339,48.2367256637168
"5204945276.jpg",0,2,39,67,3,111,3.63963963963964,0.568775283838287,70.3559322033898
"5205048751.jpg",0,5,60,47,2,114,3.40350877192982,0.605568528975214,63.6282608695652
"5205821036.jpg",2,41,55,6,0,104,2.625,0.626091280295562,42.1769911504425
"5206995557.jpg",1,33,64,8,0,106,2.74528301886792,0.602555206002175,47.2297297297297
"5209102120.jpg",0,0,34,72,3,109,3.71559633027523,0.510840685451281,71.5128205128205
"5209744209.jpg",2,15,87,23,0,127,3.03149606299213,0.603389998312652,56.8511904761905
"5209757780.jpg",0,11,70,25,0,106,3.13207547169811,0.57030437484212,58.1207627118644
"5209944633.jpg",5,62,33,5,0,105,2.36190476190476,0.652271320431824,36.9671052631579
"5211888253.jpg",12,73,19,0,0,104,2.06730769230769,0.544423148479607,28.7775229357798
"5212354067.jpg",10,59,58,0,0,127,2.37795275590551,0.629047325272766,37.1935483870968
"5212639990.jpg",0,3,64,32,0,99,3.29292929292929,0.520057399746535,60.4908256880734
"5212871853.jpg",1,12,68,28,0,109,3.12844036697248,0.625106175147288,59.3289473684211
"5213032846.jpg",17,83,13,0,0,113,1.9646017699115,0.516326369996713,25.2478260869565
"5215794269.jpg",0,2,37,63,1,103,3.61165048543689,0.54652215405893,71.0093457943925
"5215856083.jpg",0,3,45,60,1,109,3.54128440366972,0.569797073880386,71.0526315789474
"5216419230.jpg",0,1,36,56,5,98,3.66326530612245,0.591065394031015,71.8310810810811
"5216478650.jpg",0,1,50,53,0,104,3.5,0.521387245906701,66.7027027027027
"5216870847.jpg",0,14,87,10,0,111,2.96396396396396,0.465694553190626,52.7434210526316
"5216894561.jpg",0,4,74,31,0,109,3.24770642201835,0.512003387263685,59.5530973451327
"5217550500.jpg",17,64,25,2,0,108,2.11111111111111,0.674409860868105,29.7193396226415
"5217753146.jpg",0,6,67,36,0,109,3.27522935779817,0.558960007067151,59.5961538461538
"5217952997.jpg",0,1,50,58,1,110,3.53636363636364,0.536336070311266,66.0294117647059
"5219241121.jpg",0,1,46,60,4,111,3.6036036036036,0.576498510276074,68.8877118644068
"5219276400.jpg",0,10,71,28,0,109,3.1651376146789,0.569498828859231,58.4033613445378
"5219524859.jpg",0,38,65,5,0,108,2.69444444444444,0.554646192409083,46.3384955752212
"5219577819.jpg",2,29,57,14,0,102,2.81372549019608,0.685498909978302,46.0066964285714
"52196600.jpg",1,23,58,23,2,107,3.01869158878505,0.739470851240429,53.8970588235294
"5221875216.jpg",0,39,63,7,0,109,2.70642201834862,0.582185414870968,47.9830508474576
"5222301193.jpg",7,72,29,3,0,111,2.25225225225225,0.61004423786638,33.0375
"5222918882.jpg",0,0,24,79,6,109,3.8348623853211,0.500254777086597,74.76875
"5223615087.jpg",0,0,30,69,5,104,3.75961538461538,0.530528081075412,74.4676724137931
"5224064761.jpg",0,8,33,60,2,103,3.54368932038835,0.668282830654486,71.6802884615385
"5224316825.jpg",13,62,32,1,0,108,2.19444444444444,0.647905804468655,30.9158878504673
"5224440098.jpg",3,29,65,10,0,107,2.76635514018692,0.652707557566527,49.9889380530973
"5225674723.jpg",0,1,47,51,2,101,3.53465346534653,0.557931114666382,70.5138888888889
"5226685642.jpg",2,33,61,8,0,104,2.72115384615385,0.630252388483334,44.5540540540541
"522689278.jpg",1,22,66,21,2,112,3.00892857142857,0.703857270982589,55.8589743589744
"5227449110.jpg",0,0,30,70,7,107,3.78504672897196,0.549923448929572,74.9726890756303
"5227846365.jpg",2,56,46,1,0,105,2.43809523809524,0.553377905438143,38.5919811320755
"5228772358.jpg",0,3,57,44,2,106,3.42452830188679,0.584695495964266,67.7783018867924
"5229829828.jpg",0,13,75,13,0,101,3,0.509901951359279,53.5200892857143
"5230623311.jpg",12,54,30,1,0,97,2.20618556701031,0.660462974137223,30.8867924528302
"5230942989.jpg",0,4,68,31,0,103,3.2621359223301,0.523209646590323,59.8648648648649
"523099326.jpg",1,8,34,50,9,102,3.56862745098039,0.802345619727813,67
"5231173987.jpg",10,72,19,1,0,102,2.1078431372549,0.56123736608591,28.6261467889908
"5231773522.jpg",37,52,17,3,0,109,1.87155963302752,0.771013251449659,22.3185840707965
"523281293.jpg",0,4,59,40,0,103,3.3495145631068,0.554990511561316,63.8157894736842
"5233144595.jpg",0,1,24,68,5,98,3.78571428571429,0.542046522901578,75.472972972973
"5233563523.jpg",0,3,46,52,1,102,3.5,0.575919411304074,67.8481308411215
"5233564371.jpg",1,12,64,33,2,112,3.20535714285714,0.686266736380275,60.0897435897436
"5233734612.jpg",0,16,59,27,1,103,3.12621359223301,0.666857006903712,57.65
"5235142622.jpg",0,8,74,18,0,100,3.1,0.502518907629606,55.0995575221239
"5235250770.jpg",0,4,50,50,1,105,3.45714285714286,0.588815163445454,65.8950892857143
"5235352004.jpg",0,46,51,6,0,103,2.61165048543689,0.597921394740962,42.6880530973451
"5236193983.jpg",0,2,26,77,3,108,3.75,0.531705068975115,76.9320388349515
"5236886996.jpg",0,1,36,65,2,104,3.65384615384615,0.535519542113137,73.0401785714286
"5237114997.jpg",6,76,25,0,0,107,2.17757009345794,0.510513690836126,31.8508403361345
"5238246589.jpg",0,2,35,61,3,101,3.64356435643564,0.575919411304074,73.375
"5239610533.jpg",6,50,38,5,0,99,2.42424242424242,0.686471443449481,38.5069444444444
"5240635967.jpg",0,1,41,59,2,103,3.60194174757282,0.548434596262224,71.7142857142857
"5240740919.jpg",1,5,70,29,1,106,3.22641509433962,0.590125392130061,61.2544642857143
"5241841036.jpg",0,0,23,84,5,112,3.83928571428571,0.475594865605671,77.51875
"5243003019.jpg",0,41,65,0,0,106,2.61320754716981,0.48932907842281,43.8580508474576
"5243954323.jpg",1,43,99,10,0,153,2.77124183006536,0.567737105883197,49.4423076923077
"524406040.jpg",3,60,37,2,0,102,2.37254901960784,0.578861440139363,38.4305555555556
"5245617824.jpg",0,26,60,13,0,99,2.86868686868687,0.616879319499211,49.2663551401869
"5247748944.jpg",2,27,61,19,0,109,2.88990825688073,0.698403596853466,51.8865546218487
"5248353672.jpg",2,55,42,4,0,103,2.46601941747573,0.607397759985128,40.3224299065421
"5248435224.jpg",0,12,72,23,0,107,3.10280373831776,0.565261326094706,58.825
"5248577035.jpg",1,37,61,3,0,102,2.64705882352941,0.556635202786152,43.8851351351351
"5249052587.jpg",1,11,77,21,0,110,3.07272727272727,0.570032848065116,57.6313559322034
"5250131819.jpg",2,59,44,0,0,105,2.4,0.529876618439831,38.0441176470588
"5250684478.jpg",1,19,63,19,0,102,2.98039215686275,0.644556677133118,52.3
"5250708423.jpg",3,49,46,8,0,106,2.55660377358491,0.677251991918114,42.4133663366337
"5251074570.jpg",1,23,51,31,1,107,3.07476635514019,0.761093237779179,53.31875
"5251948512.jpg",0,2,72,80,1,155,3.51612903225806,0.538815906080325,71.3860759493671
"525227728.jpg",0,1,27,72,8,108,3.80555555555556,0.571247746200316,76.9978813559322
"5252606224.jpg",0,9,59,36,1,105,3.27619047619048,0.627805060619293,63.3155339805825
"5253482286.jpg",0,4,82,23,0,109,3.1743119266055,0.468331093257745,58.5420168067227
"5254421603.jpg",0,3,29,70,5,107,3.7196261682243,0.595492384238558,71.1961206896552
"5254718076.jpg",6,36,52,8,0,102,2.6078431372549,0.719692766477997,41.1548672566372
"5255413716.jpg",0,9,70,20,0,99,3.11111111111111,0.53239713749995,58.5957943925234
"52568944.jpg",14,64,24,1,0,103,2.11650485436893,0.6309185782866,29.0215517241379
"5257060848.jpg",7,42,44,9,0,102,2.53921568627451,0.753494415511456,43.929203539823
"5257307362.jpg",0,32,63,6,0,101,2.74257425742574,0.559525966270282,44.2212389380531
"5257312652.jpg",0,1,18,80,4,103,3.84466019417476,0.480140534030996,78.9428571428571
"5258392332.jpg",0,2,51,45,2,100,3.47,0.576562435842158,67.675
"5258646457.jpg",0,4,39,54,2,99,3.54545454545455,0.610665867299156,67.9407894736842
"526016794.jpg",3,36,60,8,0,107,2.68224299065421,0.652977662091876,45.1703539823009
"526020496.jpg",0,13,82,12,0,107,2.99065420560748,0.4855521483138,54.925
"5260460290.jpg",1,21,67,16,0,105,2.93333333333333,0.624294473580849,51.2366071428571
"5261084727.jpg",0,2,37,56,3,98,3.61224489795918,0.585611902399049,68.2411504424779
"5261188573.jpg",0,0,85,23,0,108,3.21296296296296,0.411310327528164,59.3289473684211
"5261364718.jpg",0,3,75,22,0,100,3.19,0.464823198711732,61.6527777777778
"5263912639.jpg",20,72,9,1,0,102,1.91176470588235,0.564685861613648,23.1216814159292
"5265556048.jpg",0,0,42,64,4,110,3.65454545454545,0.549167236712308,70.4663865546218
"526555735.jpg",1,29,56,16,0,102,2.85294117647059,0.680667389784052,50.197247706422
"5266123407.jpg",0,0,37,70,6,113,3.72566371681416,0.554974060053702,74.0409482758621
"5266542779.jpg",0,5,58,37,0,100,3.32,0.566399223876658,64.5022935779816
"5267121563.jpg",0,4,45,59,1,109,3.52293577981651,0.586835996321222,68.109243697479
"526762082.jpg",0,3,51,57,2,113,3.51327433628319,0.584243165003537,67.8319327731092
"5269040313.jpg",55,45,5,0,0,105,1.52380952380952,0.589902829273897,12.2433628318584
"5269333343.jpg",0,0,22,76,4,102,3.82352941176471,0.475368844930275,79.15
"5270171351.jpg",3,47,50,1,0,101,2.48514851485149,0.576434929304924,41.1041666666667
"5270848965.jpg",0,2,52,47,3,104,3.49038461538462,0.591118608959406,67.515625
"5271307677.jpg",0,22,89,16,0,127,2.95275590551181,0.547117521929384,54.7559523809524
"5272496469.jpg",15,51,37,5,0,108,2.2962962962963,0.764385517784867,34.9491150442478
"5274473740.jpg",0,3,37,62,7,109,3.6697247706422,0.639082760993639,73.9216101694915
"5274682163.jpg",9,85,16,1,0,111,2.08108108108108,0.50695409753,28.8081896551724
"5275524338.jpg",0,3,32,68,2,105,3.65714285714286,0.568881686843911,74.8680555555556
"5276281329.jpg",0,18,72,13,0,103,2.95145631067961,0.549128378445065,54.0044247787611
"527633229.jpg",1,20,66,18,0,105,2.96190476190476,0.634335047416547,53.9059633027523
"5276579774.jpg",0,10,81,13,0,104,3.02884615384615,0.471657493988539,54.198275862069
"5276700957.jpg",5,42,56,9,0,112,2.61607142857143,0.700650093420784,42.1800847457627
"5277411499.jpg",1,61,43,0,0,105,2.4,0.511408311956759,36.7991071428571
"5277615188.jpg",0,0,16,82,4,102,3.88235294117647,0.429001088116482,78.9858490566038
"5277655082.jpg",2,26,67,7,0,102,2.77450980392157,0.595475727034352,47.425
"5279252148.jpg",0,26,60,18,0,104,2.92307692307692,0.649006824388667,50.7946428571429
"5279579302.jpg",37,66,5,0,0,108,1.7037037037037,0.55128158687148,19.094537815126
"5286251169.jpg",0,4,59,35,2,100,3.35,0.592461054424762,62.1559633027523
"5286481593.jpg",0,1,58,42,3,104,3.45192307692308,0.572506118885479,65.6004464285714
"5286800940.jpg",0,8,65,22,2,97,3.18556701030928,0.600865641304563,59.3
"5286915372.jpg",0,1,43,55,6,105,3.62857142857143,0.60854718003592,70.4137931034483
"5288273177.jpg",0,8,74,21,1,104,3.14423076923077,0.547159819941693,58.3608490566038
"5288290650.jpg",0,0,39,58,4,101,3.65346534653465,0.555619358272486,74.0818584070797
"528858440.jpg",9,52,46,6,0,113,2.43362831858407,0.718084085241145,36.5826086956522
"5289133619.jpg",0,17,70,10,0,97,2.92783505154639,0.525345574368521,52.0608108108108
"528938817.jpg",5,64,52,1,0,122,2.40163934426229,0.58436708809262,38.0909090909091
"528982659.jpg",5,43,52,7,0,107,2.57009345794393,0.688341588258772,42.6919642857143
"5289896585.jpg",0,1,31,71,2,105,3.7047619047619,0.517460692000434,75.0943396226415
"5290105717.jpg",41,61,4,1,0,107,1.67289719626168,0.595196193031854,17.3513513513514
"5290554591.jpg",0,5,52,44,2,103,3.41747572815534,0.61873165403042,67.3716216216216
"5291504812.jpg",0,7,67,31,1,106,3.24528301886792,0.582463091080284,60.2364864864865
"5292219744.jpg",6,77,20,0,0,103,2.13592233009709,0.486051390999508,29.9115044247788
"5292802931.jpg",6,48,47,6,0,107,2.49532710280374,0.691918740126146,40.4077669902913
"5293191802.jpg",0,3,62,38,1,104,3.35576923076923,0.555960975629318,65.0848214285714
"5293214322.jpg",0,1,37,64,6,108,3.69444444444444,0.587380265521398,72.0609243697479
"5293957533.jpg",0,6,50,52,2,110,3.45454545454545,0.630077374546118,64.0189075630252
"5294012475.jpg",0,1,27,72,4,104,3.75961538461538,0.530528081075412,74.6099137931034
"5294769560.jpg",0,2,53,66,1,122,3.54098360655738,0.54768545270158,71.4318181818182
"5296875210.jpg",1,4,37,62,3,107,3.57943925233645,0.659293263369166,69.0105042016807
"5297588508.jpg",2,13,63,23,0,101,3.05940594059406,0.660632759984211,53.1283185840708
"5298103951.jpg",2,39,62,2,0,105,2.60952380952381,0.563219421909541,40.9121621621622
"5298580335.jpg",1,27,68,7,0,103,2.78640776699029,0.571384377285334,47.107476635514
"5298734322.jpg",0,3,63,31,0,97,3.28865979381443,0.519590441409504,64.9779411764706
"5300293470.jpg",0,14,71,18,0,103,3.03883495145631,0.558750884494407,57.0848623853211
"5300926101.jpg",0,8,60,29,1,98,3.23469387755102,0.605831122196543,59.5675675675676
"5301312418.jpg",3,24,64,17,0,108,2.87962962962963,0.693327242564508,51.4662162162162
"5302119756.jpg",0,1,38,62,1,102,3.61764705882353,0.527353145004104,72.8407079646018
"5304364574.jpg",0,6,66,32,0,104,3.25,0.553014685807209,62.5855263157895
"5305142351.jpg",0,5,36,59,8,108,3.64814814814815,0.687876521396193,71.9646017699115
"5305438208.jpg",1,39,62,10,0,112,2.72321428571429,0.632595417843793,45.885593220339
"5306390584.jpg",0,5,68,28,2,103,3.2621359223301,0.576690440094974,61.6486486486486
"5306558367.jpg",4,53,60,2,1,120,2.525,0.634610977242732,41.6207627118644
"53065971.jpg",19,80,6,1,0,106,1.89622641509434,0.515091213060161,23.5826271186441
"5306806108.jpg",0,3,43,61,2,109,3.56880733944954,0.583205898414645,69.7731092436975
"5306814937.jpg",0,2,32,72,1,107,3.67289719626168,0.528002661059965,74.5199115044248
"5306909990.jpg",68,35,0,0,0,103,1.33980582524272,0.475959259630989,8.29807692307692
"5308397567.jpg",0,0,23,75,3,101,3.8019801980198,0.469463565789679,74.0389908256881
"5308844734.jpg",0,1,27,73,4,105,3.76190476190476,0.528492222557749,74.8816964285714
"5309326426.jpg",0,0,37,64,2,103,3.66019417475728,0.515512272504728,71.0884955752212
"5309442831.jpg",0,2,33,68,1,104,3.65384615384615,0.535519542113137,73.5131578947368
"5309538408.jpg",0,16,66,25,0,107,3.08411214953271,0.616158141412052,57.7094594594595
"5310130081.jpg",0,1,33,68,1,103,3.66990291262136,0.512363793752346,74.734375
"5310307882.jpg",0,14,73,13,1,101,3.00990099009901,0.556687515666563,53.0733944954128
"5311906994.jpg",0,1,53,49,1,104,3.48076923076923,0.539341008015854,69.1361607142857
"5312388504.jpg",0,2,66,59,2,129,3.47286821705426,0.56009931289913,68.763358778626
"5314378959.jpg",20,70,12,2,0,104,1.96153846153846,0.62197738108714,23.8684210526316
"531477784.jpg",55,50,2,0,0,107,1.50467289719626,0.53858360321749,13.1323529411765
"5314923965.jpg",3,26,57,18,0,104,2.86538461538462,0.724839350231836,49.7289719626168
"5314968272.jpg",0,6,61,41,1,109,3.3394495412844,0.596598125893161,63.4955752212389
"5315386438.jpg",0,29,74,11,0,114,2.84210526315789,0.573437814304837,50.4300847457627
"5316693478.jpg",0,8,72,23,0,103,3.14563106796116,0.531512215385263,58.3157894736842
"5317045814.jpg",0,0,49,51,2,102,3.53921568627451,0.53900474156975,66.6215596330275
"5318008559.jpg",1,18,67,22,2,110,3.05454545454545,0.68852139988414,54.5210084033613
"5318152871.jpg",0,27,64,8,0,99,2.80808080808081,0.565627115880903,50.0240384615385
"5318520232.jpg",1,40,54,10,0,105,2.6952380952381,0.652271320431824,47.4563106796116
"531889120.jpg",0,3,38,60,5,106,3.63207547169811,0.622215269716858,69.1673728813559
"5320165275.jpg",0,1,49,52,1,103,3.51456310679612,0.539863411736181,70.7964601769911
"5320512069.jpg",7,36,55,15,0,113,2.69026548672566,0.780105830935081,46.6594827586207
"5320573901.jpg",4,81,22,0,0,107,2.16822429906542,0.46552833260779,31.7121848739496
"5321706893.jpg",0,9,84,17,0,110,3.07272727272727,0.482901986542997,57.1419491525424
"5323028515.jpg",0,30,69,12,0,111,2.83783783783784,0.596055832353443,50.29375
"5323106663.jpg",0,20,71,15,1,107,2.97196261682243,0.605913374548902,54.445652173913
"5323234112.jpg",1,19,68,12,0,100,2.91,0.587667878442863,51.5760869565217
"5324909950.jpg",1,3,44,58,2,108,3.52777777777778,0.633316936990578,69.0986842105263
"5325140020.jpg",1,26,60,21,1,109,2.95412844036697,0.712134520959991,53.203781512605
"5325398566.jpg",0,10,76,21,0,107,3.10280373831776,0.530833794818814,57.2817796610169
"5326008096.jpg",0,5,64,33,2,104,3.30769230769231,0.592459462820778,64.5970873786408
"5327737580.jpg",0,14,81,8,0,103,2.94174757281553,0.460716465025955,52.3982300884956
"5328075993.jpg",0,2,58,48,1,109,3.44036697247706,0.551617027987488,66.4054054054054
"5328147958.jpg",0,40,60,5,0,105,2.66666666666667,0.566138517072298,45.7652173913043
"5328853523.jpg",0,9,86,27,0,122,3.14754098360656,0.524949917289101,58.6818181818182
"5329486988.jpg",0,1,44,56,3,104,3.58653846153846,0.567922067043096,70.7566964285714
"5329734345.jpg",1,8,63,33,0,105,3.21904761904762,0.619878281801423,61.5743243243243
"5333075930.jpg",0,2,35,64,1,102,3.62745098039216,0.543577599321548,70.975
"5333965568.jpg",0,1,27,71,4,103,3.75728155339806,0.532585617115547,78.2291666666667
"5334294455.jpg",0,2,46,61,0,109,3.54128440366972,0.536313032067666,68.2195652173913
"5335866018.jpg",0,7,83,16,1,107,3.10280373831776,0.494012822369155,58.1331775700935
"5337216786.jpg",0,3,74,52,0,129,3.37984496124031,0.533177363337186,66.806640625
"5337507620.jpg",0,10,52,41,2,105,3.33333333333333,0.674631903431942,63.2433035714286
"5338193826.jpg",0,16,75,16,0,107,3,0.549442255794756,54.1418918918919
"5339188116.jpg",0,1,49,47,5,102,3.54901960784314,0.607338797915389,68.3258928571429
"5341341783.jpg",8,72,23,0,0,103,2.14563106796116,0.531512215385263,28.7700892857143
"5341393819.jpg",0,3,34,59,6,102,3.66666666666667,0.634539410932373,71.575
"5342778275.jpg",0,16,69,17,0,102,3.00980392156863,0.571520432475467,55.4646017699115
"5342791481.jpg",5,64,29,0,0,98,2.24489795918367,0.538444198063998,33.243119266055
"5343739846.jpg",5,34,54,17,0,110,2.75454545454545,0.768489088775049,46.16875
"5344616817.jpg",0,4,78,30,1,113,3.24778761061947,0.526629672189905,58.5384615384615
"5346690387.jpg",1,20,64,17,0,102,2.95098039215686,0.635227424470831,51.9864864864865
"5347056182.jpg",31,69,2,0,0,102,1.7156862745098,0.495073771488337,17.7270642201835
"5347293716.jpg",0,3,50,47,0,100,3.44,0.55632270266002,63.5183486238532
"5348237812.jpg",5,55,46,4,0,110,2.44545454545455,0.643761361511764,38.0135135135135
"5349969174.jpg",2,65,31,2,0,100,2.33,0.551490175924662,36.025
"5350540236.jpg",0,1,50,51,2,104,3.51923076923077,0.557051342926048,69.3571428571429
"5352670374.jpg",0,4,54,47,1,106,3.42452830188679,0.584695495964266,66.6915887850467
"5352866440.jpg",0,0,14,77,15,106,4.00943396226415,0.525452784682713,79.3050847457627
"5353332977.jpg",0,57,44,3,0,104,2.48076923076923,0.557051342926048,40.2236842105263
"5353881693.jpg",0,17,73,17,0,107,3,0.566352113954854,55.65625
"5354068609.jpg",0,8,55,33,1,97,3.27835051546392,0.624871120732726,62.9142857142857
"5354173860.jpg",0,4,42,84,0,130,3.61538461538462,0.548212251440713,75.3139534883721
"535434144.jpg",0,2,24,74,4,104,3.76923076923077,0.543822665820023,74.35
"5354698.jpg",0,4,18,73,14,109,3.88990825688073,0.657428344796833,77.7045454545455
"5354741393.jpg",0,3,77,22,0,102,3.18627450980392,0.460958797515768,59.2847222222222
"535787632.jpg",1,48,47,3,0,99,2.52525252525253,0.577528766726489,38.5995575221239
"5358352176.jpg",2,48,50,2,0,102,2.50980392156863,0.575835132469745,40.6605504587156
"5358640896.jpg",0,2,46,51,2,101,3.52475247524752,0.576091301894771,68.275
"5359127660.jpg",0,3,48,49,1,101,3.47524752475248,0.576091301894771,67.7891304347826
"5359274053.jpg",8,84,12,0,0,104,2.03846153846154,0.438954559496156,28.0572033898305
"5359786621.jpg",0,3,39,55,2,99,3.56565656565657,0.59180830048486,71.5919811320755
"5360175600.jpg",0,0,31,73,6,110,3.77272727272727,0.536024970476325,75.6183035714286
"5360940013.jpg",2,63,41,0,0,106,2.36792452830189,0.522365894352903,35.0668103448276
"5361947887.jpg",0,2,66,34,2,104,3.34615384615385,0.553352198616052,62.9121621621622
"5362095529.jpg",0,2,25,69,6,102,3.77450980392157,0.578609852395438,75.3986486486486
"5362140571.jpg",18,74,7,0,0,99,1.88888888888889,0.492575258704219,21.1330275229358
"5362664790.jpg",0,3,71,29,2,105,3.28571428571429,0.549725206078275,61.9174107142857
"5363058682.jpg",32,70,3,0,0,105,1.72380952380952,0.509434794182543,20.2991071428571
"5363150332.jpg",2,19,56,24,1,102,3.02941176470588,0.737347162924021,55.2032710280374
"5363442288.jpg",0,2,33,69,2,106,3.66981132075472,0.547230222522522,73.8221153846154
"5363486044.jpg",2,10,75,18,0,105,3.03809523809524,0.587101903155359,55.7299107142857
"5364140480.jpg",0,7,47,44,2,100,3.41,0.652810551509101,61.4513274336283
"5364427287.jpg",0,0,42,62,2,106,3.62264150943396,0.524682764719683,69.2564102564103
"5365003071.jpg",0,2,48,54,4,108,3.55555555555556,0.601141178518743,67.20625
"5365082886.jpg",0,2,48,45,0,95,3.45263157894737,0.541244056576509,67.7208737864078
"5367389511.jpg",0,19,53,30,2,104,3.14423076923077,0.729653052687707,58.8973214285714
"5369434001.jpg",44,56,7,0,0,107,1.65420560747664,0.60035844227723,16.984375
"5370538873.jpg",0,23,61,16,0,100,2.93,0.623690547459154,50.1381578947368
"5370637046.jpg",0,2,36,62,1,101,3.61386138613861,0.547179989212014,68.9151785714286
"5370690667.jpg",0,3,52,46,3,104,3.47115384615385,0.60670574383033,66.7920168067227
"537074410.jpg",6,50,41,4,0,101,2.42574257425743,0.668528752612262,39.2146226415094
"5371908851.jpg",0,6,57,39,0,102,3.32352941176471,0.582955336941826,66.2699115044248
"537232636.jpg",3,46,52,3,0,104,2.52884615384615,0.60670574383033,40.2960526315789
"5375536055.jpg",0,2,51,56,1,110,3.50909090909091,0.554306816398272,67.9871794871795
"5376223041.jpg",0,0,44,57,4,105,3.61904761904762,0.561264924094064,68.0405405405405
"5376228237.jpg",11,81,33,0,0,125,2.176,0.568869847351577,31.8360655737705
"5377492041.jpg",0,10,68,27,1,106,3.17924528301887,0.598365548590026,58.6113445378151
"5378235552.jpg",0,0,60,51,1,112,3.47321428571429,0.5191785165493,67.8461538461538
"5378725814.jpg",0,8,83,19,0,110,3.1,0.487457361108726,57.3628318584071
"5378902324.jpg",0,2,51,77,1,131,3.58778625954198,0.538805359570648,73.125
"5379331695.jpg",0,10,67,24,1,102,3.15686274509804,0.592779959162309,58.825
"5380064296.jpg",0,10,83,11,0,104,3.00961538461538,0.451431215022774,53.25
"5382638405.jpg",0,42,54,9,0,105,2.68571428571429,0.625027471923707,44.8589743589744
"5382913872.jpg",1,58,44,4,0,107,2.47663551401869,0.588342641672244,39.6673913043478
"5384624254.jpg",0,2,55,51,1,109,3.46788990825688,0.553922165602138,67.5593220338983
"5384977865.jpg",0,28,64,16,1,109,2.90825688073395,0.660264879559006,51.11875
"5385663967.jpg",0,8,42,53,1,104,3.45192307692308,0.651805672575877,68.4009433962264
"5385761239.jpg",0,29,60,10,1,100,2.83,0.636515133481927,48.9862385321101
"5386032677.jpg",0,33,69,10,0,112,2.79464285714286,0.587227304658007,47.9830508474576
"5387093344.jpg",0,13,60,36,0,109,3.21100917431193,0.639348547139874,60.5915178571429
"5391319632.jpg",6,66,34,2,0,108,2.2962962962963,0.599988461871291,34.8761061946903
"5393136028.jpg",0,18,72,14,0,104,2.96153846153846,0.556044925946993,55.140625
"539361542.jpg",0,0,27,72,5,104,3.78846153846154,0.515263659967445,74.1831896551724
"5394502414.jpg",4,36,50,13,0,103,2.69902912621359,0.738771522115224,46.3349514563107
"5394508968.jpg",0,6,54,47,0,107,3.38317757009346,0.593118713070191,67.1571428571429
"5394548782.jpg",2,33,59,9,1,104,2.75,0.679091340353924,46.890625
"539524376.jpg",4,57,35,5,0,101,2.40594059405941,0.650818220731137,38.0864485981308
"5395790450.jpg",7,64,33,0,0,104,2.25,0.570300550978694,32.8676470588235
"5395880951.jpg",0,43,61,4,0,108,2.63888888888889,0.554646192409083,43.7058823529412
"5396644364.jpg",0,1,47,79,0,127,3.61417322834646,0.504696106810793,73.798
"5397802120.jpg",0,1,36,56,7,100,3.69,0.614554121031474,71.5337837837838
"5398457925.jpg",1,59,44,3,0,107,2.45794392523365,0.571003318097878,39.325
"5398576953.jpg",0,2,83,61,1,147,3.41496598639456,0.534348116674939,68.1148648648649
"5398610144.jpg",0,20,58,27,0,105,3.06666666666667,0.668906493791096,56.1037735849057
"5399180378.jpg",2,3,48,49,3,105,3.45714285714286,0.693771346567932,69.8589108910891
"5399186343.jpg",0,13,59,34,1,107,3.21495327102804,0.659159518918379,60.0672268907563
"5399327452.jpg",0,2,66,30,1,99,3.3030303030303,0.524006259787845,63.325
"5399475116.jpg",0,1,41,63,1,106,3.60377358490566,0.528776580473741,72.671875
"5400709579.jpg",0,0,49,56,0,105,3.53333333333333,0.501280411827603,69.2570754716981
"5401046644.jpg",2,16,72,19,0,109,2.99082568807339,0.630922499848828,52.6902654867257
"540261908.jpg",0,18,69,10,0,97,2.91752577319588,0.533660767185475,52.4275700934579
"5402750878.jpg",2,68,29,2,0,101,2.30693069306931,0.54300228834556,34.8389830508475
"5402777838.jpg",8,73,22,0,0,103,2.13592233009709,0.524844396909281,30.7297297297297
"5403603296.jpg",0,0,35,57,7,99,3.71717171717172,0.589714632481972,74.4174311926605
"5404092797.jpg",0,1,41,71,1,114,3.63157894736842,0.51975416065431,70.0581896551724
"5406869186.jpg",0,12,73,12,0,97,3,0.5,55.4660194174757
"5407049859.jpg",0,1,38,57,7,103,3.67961165048544,0.613789135296507,72.6486486486486
"5407907045.jpg",1,25,62,12,1,101,2.87128712871287,0.658230451082805,48.1637168141593
"5407931669.jpg",0,3,39,65,0,107,3.57943925233645,0.550083753101153,73.6308411214953
"5408161730.jpg",6,79,23,0,0,108,2.15740740740741,0.496003411147394,31.8326271186441
"5408602889.jpg",0,1,37,72,2,112,3.66964285714286,0.526562759572247,70.1730769230769
"5409637634.jpg",0,3,39,53,3,98,3.57142857142857,0.609207699080171,66.7079646017699
"5409793551.jpg",0,7,66,32,0,105,3.23809523809524,0.563706987508198,62.9150485436893
"5409841653.jpg",0,0,50,56,3,109,3.56880733944954,0.55053799406453,69.6125
"5409949181.jpg",0,5,41,61,2,109,3.55045871559633,0.615934077342428,69.703781512605
"5411857475.jpg",0,6,71,19,0,96,3.13541666666667,0.494598011502732,58.0428571428571
"5412162988.jpg",0,1,34,66,5,106,3.70754716981132,0.568489747481794,75.0402542372881
"5413723205.jpg",0,0,27,74,10,111,3.84684684684685,0.55919094475368,76.783185840708
"5414089487.jpg",0,0,27,93,5,125,3.824,0.476275875598817,80.4146341463415
"5414221487.jpg",0,1,33,61,7,102,3.72549019607843,0.599618075558597,72.775
"5414222209.jpg",0,4,24,66,9,103,3.77669902912621,0.655774334017359,77.9740566037736
"5416465084.jpg",1,20,99,7,0,127,2.88188976377953,0.4816336819872,52.0590551181102
"5416851305.jpg",2,36,66,8,0,112,2.71428571428571,0.6213697660012,46.825
"5417875149.jpg",3,52,47,3,0,105,2.47619047619048,0.605983594840749,39.0540540540541
"5418130754.jpg",29,74,6,0,0,109,1.78899082568807,0.528334113133193,21.313025210084
"5419570020.jpg",0,3,60,38,2,103,3.37864077669903,0.579325247371913,66.7053571428571
"5419962760.jpg",1,0,41,59,2,103,3.59223300970874,0.584722042292587,69.7991071428571
"5420001635.jpg",0,0,19,72,13,104,3.94230769230769,0.554363504117592,79.6594827586207
"5420375203.jpg",0,0,40,62,0,102,3.6078431372549,0.490642390492787,74.2382075471698
"5421015027.jpg",0,3,64,46,0,113,3.38053097345133,0.539817827584925,66.0294117647059
"5421157000.jpg",0,16,80,6,0,102,2.90196078431373,0.456196152044242,52.3415178571429
"5421731776.jpg",0,11,83,15,0,109,3.03669724770642,0.489266372662459,56.3728813559322
"5422446412.jpg",0,1,27,75,3,106,3.75471698113208,0.512906206123813,78.5647321428571
"5422890420.jpg",1,21,72,13,0,107,2.90654205607477,0.591332206864279,51.3030973451327
"5423246371.jpg",0,1,50,54,1,106,3.5188679245283,0.538624917208215,68.3107476635514
"5423639636.jpg",1,6,83,35,0,125,3.216,0.562023992140848,62.5423387096774
"5423986833.jpg",1,16,78,7,0,102,2.8921568627451,0.505550630992575,49.75
"5424903451.jpg",0,8,39,56,2,105,3.4952380952381,0.666849791698734,68.5218446601942
"5426014939.jpg",2,22,57,18,1,100,2.94,0.722229992188196,50.7291666666667
"5426100555.jpg",1,18,57,19,3,98,3.05102040816327,0.737402084775165,55.357476635514
"5427956048.jpg",0,2,59,43,0,104,3.39423076923077,0.529118505469683,63.9152173913043
"5430352868.jpg",0,2,40,58,3,103,3.60194174757282,0.583091924701258,71.0884955752212
"5430572465.jpg",0,2,43,58,1,104,3.55769230769231,0.554363504117592,69.9203539823009
"5431342278.jpg",11,75,16,4,0,106,2.12264150943396,0.627964666714226,29.8050847457627
"5432792987.jpg",3,73,25,1,0,102,2.23529411764706,0.510803494181496,32.2219827586207
"5433364879.jpg",10,73,25,0,0,108,2.13888888888889,0.554646192409084,30.2563025210084
"5433512452.jpg",1,9,53,42,2,107,3.32710280373832,0.697376497953383,61.5231092436975
"5434458853.jpg",0,9,46,47,3,105,3.41904761904762,0.69033091815214,67
"5434982423.jpg",1,85,49,2,0,137,2.37956204379562,0.530418631300868,38.0684931506849
"5435410945.jpg",0,3,28,71,5,107,3.72897196261682,0.591928308030625,76.75
"5436025882.jpg",0,3,51,49,2,105,3.47619047619048,0.589902829273897,65.025641025641
"5436078668.jpg",0,0,16,85,10,111,3.94594594594595,0.483130658740711,78.2563559322034
"5436442410.jpg",0,1,49,57,2,109,3.55045871559633,0.552540237048483,70.0394736842105
"5437097825.jpg",0,2,52,45,3,102,3.48039215686275,0.592534281196727,69.4591346153846
"5437565452.jpg",0,5,59,40,1,105,3.35238095238095,0.588037027565055,62.7635135135135
"5437634548.jpg",2,9,60,34,0,105,3.2,0.670820393249937,57.9324324324324
"5438123525.jpg",1,51,49,4,0,105,2.53333333333333,0.589436932534684,41.2543103448276
"5438275650.jpg",0,14,90,44,2,150,3.22666666666667,0.625484152521811,63.1394230769231
"5438289269.jpg",0,13,72,15,0,100,3.02,0.531436019125767,56.425
"5441628490.jpg",0,0,24,71,4,99,3.7979797979798,0.494454925202593,78.0504587155963
"5442770752.jpg",0,23,67,10,0,100,2.87,0.562372319964831,50.4243119266055
"5443109303.jpg",1,12,65,32,0,110,3.16363636363636,0.642918699145877,57.1419491525424
"5443343893.jpg",0,7,61,33,0,101,3.25742574257426,0.577121570321794,59.265625
"5443561588.jpg",1,36,60,6,0,103,2.68932038834951,0.594568985650855,42.1763392857143
"5443888755.jpg",1,17,56,29,1,104,3.11538461538462,0.714723007079242,56.3029661016949
"5444850191.jpg",0,4,53,47,1,105,3.42857142857143,0.586009038673119,67.2334905660377
"5445781988.jpg",0,2,37,97,1,137,3.70802919708029,0.502355977921063,76.1599264705882
"5445842177.jpg",0,5,55,41,1,102,3.37254901960784,0.595720191934298,63.2837837837838
"5446222117.jpg",0,0,39,61,5,105,3.67619047619048,0.563219421909541,72.2629310344828
"5446650089.jpg",0,9,58,34,2,103,3.28155339805825,0.648035882088048,60.7935779816514
"5447010296.jpg",0,11,73,15,0,99,3.04040404040404,0.513475391759617,56.8276699029126
"5447287552.jpg",0,1,44,50,1,96,3.53125,0.54198708471697,70.4441747572816
"5447567442.jpg",0,4,51,51,3,109,3.48623853211009,0.61786188824524,66.3125
"5447858710.jpg",0,1,62,43,0,106,3.39622641509434,0.510447894510187,64.7760869565217
"5448376373.jpg",0,0,15,77,11,103,3.96116504854369,0.50336768024131,82.9551886792453
"5449529114.jpg",1,2,33,67,8,111,3.71171171171171,0.665888161335703,72.3804347826087
"545103098.jpg",73,32,1,0,0,106,1.32075471698113,0.488869830007768,8.34110169491525
"5451071783.jpg",0,4,70,28,0,102,3.23529411764706,0.510803494181496,59.5323275862069
"5451526397.jpg",0,4,57,44,1,106,3.39622641509434,0.580299516801763,63.6282608695652
"5453819984.jpg",0,1,59,47,2,109,3.45871559633028,0.553308401241235,64.8326271186441
"5453875819.jpg",0,4,78,46,0,128,3.328125,0.534029032800667,64.6698473282443
"5454031554.jpg",0,0,21,76,4,101,3.83168316831683,0.470516884515169,75.6319444444444
"5454884110.jpg",0,0,18,81,6,105,3.88571428571429,0.466457305208545,79.8419811320755
"5454942480.jpg",0,1,71,35,0,107,3.31775700934579,0.487545466503333,63.0847457627119
"5455599246.jpg",1,5,81,21,0,108,3.12962962962963,0.513237708723683,58.981308411215
"5456329601.jpg",1,9,57,37,3,107,3.29906542056075,0.703293509020748,61.3844537815126
"5456373866.jpg",11,54,39,3,0,107,2.31775700934579,0.694970215747321,34.2946428571429
"5457535055.jpg",0,3,63,41,0,107,3.35514018691589,0.536451240088433,64.3986486486486
"5458340790.jpg",1,9,63,29,1,103,3.19417475728155,0.642578330117777,61.3233944954128
"5458771275.jpg",0,5,74,28,1,108,3.23148148148148,0.540101781364678,61.4236111111111
"5459231907.jpg",0,2,33,67,2,104,3.66346153846154,0.550561530172921,73.6
"5459372516.jpg",0,4,65,61,1,131,3.45038167938931,0.571283850476818,68.41796875
"5459749774.jpg",0,29,94,7,0,130,2.83076923076923,0.500208662482628,49.7556390977444
"5460394455.jpg",0,1,25,78,3,107,3.77570093457944,0.501100886444381,75.765625
"5461710344.jpg",0,16,83,7,0,106,2.91509433962264,0.460184735747802,52.225
"5462153314.jpg",0,2,34,66,5,107,3.69158878504673,0.589390714392975,72.3772321428571
"5462654627.jpg",1,0,22,80,4,107,3.80373831775701,0.539728309297855,77.0434782608696
"5463672195.jpg",0,9,72,23,1,105,3.15238095238095,0.568076247268466,58.6788793103448
"5463929157.jpg",5,44,55,2,0,106,2.50943396226415,0.620986665279237,40.6294642857143
"5464134286.jpg",0,13,65,23,1,102,3.11764705882353,0.618111426512505,56.0252293577982
"5464519026.jpg",2,28,56,18,0,104,2.86538461538462,0.711318921382213,48.55
"5465127384.jpg",0,8,59,36,2,105,3.3047619047619,0.637359479593036,63.5986842105263
"5466371904.jpg",0,0,10,67,30,107,4.18691588785047,0.584885751164282,85.35625
"5467862729.jpg",0,1,29,71,7,108,3.77777777777778,0.569199032800311,74.9579646017699
"5468320493.jpg",0,1,49,54,0,104,3.50961538461538,0.521297714310625,67.6629464285714
"5468530650.jpg",0,1,51,54,0,106,3.5,0.520988072251728,70.609375
"5468577486.jpg",1,40,49,10,0,100,2.68,0.664845998724669,42.25
"5468605223.jpg",0,14,51,41,1,107,3.27102803738318,0.694589514422808,63.15
"5468768534.jpg",0,3,41,58,1,103,3.55339805825243,0.572715501692198,69.75
"5469380265.jpg",2,9,68,27,0,106,3.13207547169811,0.633591000689354,59.4639423076923
"5470588240.jpg",0,0,27,72,6,105,3.8,0.526234811584217,75.9070796460177
"5471871046.jpg",5,66,37,2,0,110,2.32727272727273,0.592136404274997,35.0951327433628
"5473035889.jpg",0,2,34,71,4,111,3.69369369369369,0.568775283838287,73.1346153846154
"5474201544.jpg",1,3,59,41,2,106,3.37735849056604,0.624161611988117,65.0630434782609
"5474715935.jpg",0,4,51,45,2,102,3.44117647058824,0.606459117846457,65.5
"5476657075.jpg",0,2,57,42,0,101,3.3960396039604,0.530645039942749,66.1674311926605
"5477401446.jpg",0,20,64,20,0,104,3,0.623176952849756,53.2978260869565
"5478338784.jpg",0,2,44,53,3,102,3.55882352941176,0.589907349861894,69.8986486486486
"5478338919.jpg",0,1,31,76,2,110,3.71818181818182,0.509214509003966,70.6743697478992
"5478757587.jpg",0,0,45,54,0,99,3.54545454545455,0.500463606960979,69.0817757009346
"5479353117.jpg",0,17,67,18,0,102,3.00980392156863,0.588589487618462,53.6319444444444
"5479751565.jpg",0,0,54,45,1,100,3.47,0.521361853052351,64.7702702702703
"5480071347.jpg",0,2,38,68,0,108,3.61111111111111,0.526553479694317,69.2632743362832
"5480462577.jpg",0,25,71,7,0,103,2.8252427184466,0.531870256662233,49.3214285714286
"5480500661.jpg",2,10,79,15,0,106,3.00943396226415,0.560531771647295,52.8783783783784
"5480545191.jpg",15,67,30,0,0,112,2.13392857142857,0.622339898935421,31.3205128205128
"5480693901.jpg",0,1,41,71,6,119,3.6890756302521,0.578541403227582,74.474358974359
"5480778835.jpg",0,20,57,28,3,108,3.12962962962963,0.737418997200124,56.4621848739496
"5480952207.jpg",0,20,66,17,1,104,2.99038461538462,0.630844591938848,54.5441176470588
"5481249377.jpg",1,71,35,3,0,110,2.36363636363636,0.554005808058726,36.2878151260504
"5482033930.jpg",0,2,48,53,1,104,3.50961538461538,0.557302663192804,68.6205357142857
"5482786130.jpg",0,0,31,69,8,108,3.78703703703704,0.564543085877154,76.5413043478261
"5483050895.jpg",0,1,48,51,1,101,3.51485148514851,0.540626699047293,70.4059633027523
"5483224233.jpg",0,4,68,26,0,98,3.22448979591837,0.508294342945169,62.3543689320388
"5483273817.jpg",0,14,69,19,0,102,3.04901960784314,0.569478673883198,56.3407079646018
"5483514140.jpg",0,0,28,76,8,112,3.82142857142857,0.540508364550718,74.760593220339
"5483567910.jpg",0,2,46,59,0,107,3.53271028037383,0.537600486602462,71.640625
"5483697378.jpg",0,28,61,17,0,106,2.89622641509434,0.646297075773007,53.8147321428571
"5483904990.jpg",1,18,74,15,0,108,2.9537037037037,0.586200489757354,53.1013513513514
"5484179033.jpg",0,2,57,41,2,102,3.42156862745098,0.570500466583819,65.425
"5484776927.jpg",0,2,29,72,4,107,3.72897196261682,0.559145126770676,76.5641592920354
"5485090581.jpg",2,47,51,4,0,104,2.54807692307692,0.605473539981414,42.1691176470588
"5485536219.jpg",1,55,67,5,1,129,2.61240310077519,0.616315634427937,43.3543307086614
"5485752257.jpg",0,0,22,77,5,104,3.83653846153846,0.484929720122209,75.9736842105263
"5487306011.jpg",0,10,96,22,0,128,3.09375,0.493062101788885,59.330078125
"5487766524.jpg",1,26,64,16,0,107,2.88785046728972,0.649050144932248,50.0805084745763
"5487845072.jpg",0,39,61,4,0,104,2.66346153846154,0.550561530172921,44.7608695652174
"5489335291.jpg",0,0,31,69,9,109,3.79816513761468,0.573808209566535,76.4911504424779
"5489747456.jpg",1,15,81,8,0,105,2.91428571428571,0.502192992979594,50.0695652173913
"5490633123.jpg",0,5,81,24,0,110,3.17272727272727,0.485743370706337,58.3157894736842
"5491791732.jpg",0,0,16,88,7,111,3.91891891891892,0.449952222415894,79.7944915254237
"5492807512.jpg",0,7,65,35,0,107,3.26168224299065,0.571929019842775,63.0367647058824
"5492904052.jpg",4,34,44,18,0,100,2.76,0.792897766857032,43.5641592920354
"5493295509.jpg",0,1,47,54,5,107,3.58878504672897,0.598004086375219,70.3
"5494503911.jpg",0,1,30,61,9,101,3.77227722772277,0.61451099451209,72.6009174311927
"5494614015.jpg",0,6,60,40,0,106,3.32075471698113,0.578127845662116,65.1397058823529
"5494859211.jpg",5,80,15,1,0,101,2.11881188118812,0.475123746257147,29.6415094339623
"549547230.jpg",0,24,72,7,0,103,2.83495145631068,0.525750395161586,48.1428571428571
"5495551820.jpg",0,34,64,6,0,104,2.73076923076923,0.561391634768236,46.9847826086957
"5495773051.jpg",0,10,65,31,0,106,3.19811320754717,0.592328919576578,62.5803571428571
"5496213154.jpg",0,1,28,67,3,99,3.72727272727273,0.531040215591192,73.4766355140187
"5496219084.jpg",0,0,18,75,6,99,3.87878787878788,0.479641176951153,81.0555555555556
"5498003598.jpg",0,3,52,46,0,101,3.42574257425743,0.55401326073417,64.1272321428571
"5498162547.jpg",0,27,61,19,0,107,2.92523364485981,0.65446124435812,53.1517857142857
"5498204974.jpg",7,65,27,2,0,101,2.23762376237624,0.602470162771322,33.688679245283
"5500159889.jpg",14,43,42,4,0,103,2.3495145631068,0.763232776972177,35.725
"5500570132.jpg",0,5,69,27,1,102,3.23529411764706,0.548200848288349,63.9855769230769
"5501090896.jpg",0,2,74,30,0,106,3.26415094339623,0.484067818791518,61.7563559322034
"5502038719.jpg",0,3,58,40,1,102,3.38235294117647,0.563653528279349,65.05
"5502130313.jpg",0,20,70,15,1,106,2.97169811320755,0.608785632297317,52.9264705882353
"5503696409.jpg",1,15,69,17,0,102,3,0.597022314125993,55.1698113207547
"5503983536.jpg",0,4,56,50,1,111,3.43243243243243,0.581871926264654,66.4889380530973
"5504474324.jpg",0,15,76,10,0,101,2.95049504950495,0.497518595104995,54.2430555555556
"5505340753.jpg",0,41,62,6,0,109,2.67889908256881,0.575434360013665,46.4789915966387
"5505953336.jpg",36,67,8,0,0,111,1.74774774774775,0.579474189063099,20.2731092436975
"5506212777.jpg",0,12,89,39,0,140,3.19285714285714,0.573973009309879,62.2295918367347
"5506716444.jpg",0,9,59,39,1,108,3.2962962962963,0.630372375623148,61.775
"5507113852.jpg",0,6,88,54,0,148,3.32432432432432,0.549783089152975,66.5147058823529
"5507499346.jpg",17,80,15,1,0,113,2,0.566946709513841,26.4432773109244
"5508053398.jpg",0,0,39,71,1,111,3.65765765765766,0.495351032473584,73.6853448275862
"5508282751.jpg",0,2,26,76,4,108,3.75925925925926,0.544648911528659,74.3092105263158
"5508551413.jpg",9,76,15,0,0,100,2.06,0.488659266552757,26.3785714285714
"5511460602.jpg",1,33,64,7,0,105,2.73333333333333,0.592690518974322,46.1616379310345
"5511925995.jpg",0,1,28,72,8,109,3.79816513761468,0.573808209566535,73.1525423728814
"5512214624.jpg",5,55,38,1,0,99,2.35353535353535,0.594415015348761,36.0435779816514
"5512989538.jpg",0,2,45,64,3,114,3.59649122807018,0.575599698746193,69.3469827586207
"5513320745.jpg",0,2,57,41,2,102,3.42156862745098,0.570500466583819,67.7139423076923
"5513852883.jpg",0,3,65,36,0,104,3.31730769230769,0.526288028433379,62.7276785714286
"5513962677.jpg",0,3,53,46,3,105,3.46666666666667,0.605530070819498,67
"5514669907.jpg",0,0,27,75,6,108,3.80555555555556,0.519855000152735,75.45625
"5514988242.jpg",0,8,77,44,0,129,3.27906976744186,0.572504696842722,62.5958646616541
"5517184431.jpg",0,4,61,44,2,111,3.3963963963964,0.592057725675758,67
"5517232825.jpg",0,3,50,55,3,111,3.52252252252252,0.600709381358208,67.0717391304348
"5517472829.jpg",0,1,25,80,5,111,3.8018018018018,0.519086957504491,75.739406779661
"5519011400.jpg",0,20,75,18,0,113,2.98230088495575,0.582211008707259,54.14375
"5519858461.jpg",0,4,63,64,1,132,3.46969696969697,0.572117987342759,69.8557692307692
"5519904752.jpg",3,67,36,2,0,108,2.34259259259259,0.566379500873785,36.4264705882353
"5520092588.jpg",0,26,70,10,0,106,2.84905660377358,0.565558347462529,49.9978260869565
"5522198347.jpg",1,44,56,9,0,110,2.66363636363636,0.639341299892415,43.625
"5524014245.jpg",0,9,67,34,0,110,3.22727272727273,0.585122756807303,60.9598214285714
"5525531268.jpg",1,34,69,9,0,113,2.76106194690265,0.601699027207627,47.9446902654867
"5525979481.jpg",0,35,69,3,0,107,2.70093457943925,0.517886730367843,46.375
"552629141.jpg",10,72,24,1,0,107,2.14953271028037,0.579585706260149,30.5379464285714
"5526408007.jpg",0,10,77,18,0,105,3.07619047619048,0.513195833352107,56.0245535714286
"5527632049.jpg",0,4,52,71,2,129,3.55038759689922,0.585785267691977,70.7027559055118
"5527745877.jpg",0,0,11,78,23,112,4.10714285714286,0.542884236944945,84.4166666666667
"5527892107.jpg",0,1,63,38,2,104,3.39423076923077,0.547159819941693,63.8325892857143
"5528731780.jpg",0,2,48,57,1,108,3.52777777777778,0.554646192409084,68.8877118644068
"5529240672.jpg",0,4,74,24,2,104,3.23076923076923,0.543822665820023,60.4441964285714
"5529298204.jpg",0,5,53,52,2,112,3.45535714285714,0.613487928868563,66.65625
"5529999885.jpg",0,6,69,31,0,106,3.23584905660377,0.544266860183807,61.0334821428571
"5530039463.jpg",0,25,75,10,0,110,2.86363636363636,0.549850233608661,50.5
"5530579735.jpg",1,54,58,2,0,115,2.5304347826087,0.55126233336141,42.1065217391304
"5531191792.jpg",5,46,55,2,0,108,2.5,0.619013384421902,40.5377358490566
"5531274580.jpg",0,2,43,56,0,101,3.53465346534653,0.539710226615053,66.4701834862385
"5532612839.jpg",0,6,70,27,0,103,3.20388349514563,0.53061605522096,59.3392857142857
"5533176494.jpg",0,42,54,4,0,100,2.62,0.564613034553648,43.1061320754717
"5533236075.jpg",0,3,50,51,3,107,3.50467289719626,0.604602345155841,70.225
"5533853499.jpg",0,8,83,36,0,127,3.22047244094488,0.547916484001732,63.1369047619048
"5534328979.jpg",1,30,61,14,0,106,2.83018867924528,0.654241809282682,50.3526785714286
"5534680063.jpg",0,0,43,50,2,95,3.56842105263158,0.538963378121674,71.8389423076923
"5535054309.jpg",1,69,39,1,0,110,2.36363636363636,0.519831884032117,37.0762711864407
"5535937496.jpg",1,20,75,6,0,102,2.84313725490196,0.521708883566678,49.1121495327103
"5536150022.jpg",25,66,11,0,0,102,1.86274509803922,0.580870219248152,23.2056074766355
"5536240490.jpg",1,27,67,9,0,104,2.80769230769231,0.592459462820778,48.9934782608696
"5536386046.jpg",0,3,31,66,6,106,3.70754716981132,0.616703697195639,72.5233050847458
"5536798233.jpg",0,4,66,30,1,101,3.27722772277228,0.549887477238537,61.1401869158879
"5536900966.jpg",0,1,27,73,6,107,3.78504672897196,0.549923448929572,73.9327731092437
"5537272633.jpg",4,68,34,0,0,106,2.28301886792453,0.530134160578282,34.0736607142857
"5537911913.jpg",0,6,67,65,1,139,3.43884892086331,0.591180444187227,69.234375
"5538586634.jpg",0,0,22,75,10,107,3.88785046728972,0.5377644641834,77.9766949152542
"5538859369.jpg",0,3,49,50,2,104,3.49038461538462,0.591118608959406,66.775
"5539522093.jpg",0,3,43,51,0,97,3.49484536082474,0.561317485553077,70.6844660194175
"5540094499.jpg",0,3,44,54,1,102,3.51960784313725,0.575582221924289,72.2146226415094
"5540702638.jpg",0,1,37,67,0,105,3.62857142857143,0.504920840276033,72.7056074766355
"5541438392.jpg",5,36,49,16,0,106,2.71698113207547,0.777722156056752,45.7457627118644
"5542509126.jpg",0,0,35,67,5,107,3.7196261682243,0.545900545979958,73.9977678571429
"5543037671.jpg",0,6,63,32,1,102,3.27450980392157,0.5828720754493,63.7475961538462
"5543296873.jpg",0,5,37,58,3,103,3.57281553398058,0.635578195117856,69.4092920353982
"5543308408.jpg",0,0,21,81,4,106,3.83962264150943,0.460575053659996,76.7625
"5544109408.jpg",0,10,96,25,0,131,3.11450381679389,0.505982994150925,59.072265625
"5544820783.jpg",0,46,59,3,0,108,2.60185185185185,0.545839228920306,42.8289473684211
"5545551375.jpg",0,2,69,32,0,103,3.29126213592233,0.497662535498233,64.4791666666667
"5546833927.jpg",1,10,91,36,1,139,3.18705035971223,0.596710127035223,62.1734693877551
"5546979604.jpg",0,1,45,58,2,106,3.57547169811321,0.551156588371817,72.8928571428571
"5547599151.jpg",1,50,49,5,0,105,2.55238095238095,0.604167456106596,41.627358490566
"5550230387.jpg",0,6,98,35,1,140,3.22142857142857,0.523791615751682,62.0051020408163
"5551470289.jpg",0,9,78,19,0,106,3.09433962264151,0.507623818098411,57.925
"5552453199.jpg",0,0,72,37,0,109,3.3394495412844,0.475709674265305,62.94375
"5552904756.jpg",0,2,43,62,3,110,3.6,0.577879705586241,70.9851694915254
"5553150523.jpg",2,14,73,14,0,103,2.96116504854369,0.592805395722569,54.2430555555556
"5554016525.jpg",0,1,16,82,8,107,3.90654205607477,0.505306002570194,82.0878378378378
"5554413140.jpg",1,0,32,67,7,107,3.73831775700935,0.619440535744331,73.5168067226891
"5554551412.jpg",8,70,28,1,1,108,2.23148148148148,0.635499383904956,32.1747787610619
"5554808879.jpg",0,0,23,75,8,106,3.85849056603774,0.52442584014798,79.554347826087
"5557351990.jpg",4,54,44,5,0,107,2.46728971962617,0.648914289327425,40.2057522123894
"5557571977.jpg",0,33,67,10,0,110,2.79090909090909,0.591925090497635,49.8599137931034
"5558342101.jpg",1,6,56,39,2,104,3.33653846153846,0.662601183671924,61.896186440678
"5559771526.jpg",0,17,69,20,0,106,3.02830188679245,0.592935348114805,54.2436974789916
"5560114332.jpg",6,41,40,12,3,102,2.65686274509804,0.873086003262783,44.65
"5561303733.jpg",8,56,41,0,0,105,2.31428571428571,0.609449400220044,34.8561320754717
"5561541116.jpg",2,35,63,8,0,108,2.71296296296296,0.627276056415265,45.3163716814159
"5561556380.jpg",0,9,65,34,0,108,3.23148148148148,0.58973273657517,59.9911504424779
"5561903765.jpg",0,13,76,22,0,111,3.08108108108108,0.558164770966344,56.1410256410256
"5562631980.jpg",0,0,35,68,3,106,3.69811320754717,0.519520132443754,73.3297413793103
"5562990409.jpg",0,0,37,68,1,106,3.66037735849057,0.49544193745306,72.2369565217391
"5563391138.jpg",1,32,56,11,0,100,2.77,0.649086382011771,46.8669724770642
"5564289750.jpg",0,0,20,85,4,109,3.85321100917431,0.447745134047106,81.3097345132743
"5564570846.jpg",0,1,40,58,1,100,3.59,0.533617348619284,72.7522935779816
"5564762599.jpg",0,0,21,82,5,108,3.85185185185185,0.46993367626719,77.7323008849557
"5564925519.jpg",9,51,40,3,0,103,2.35922330097087,0.683909880143301,36.2211538461538
"5565514955.jpg",1,33,53,13,1,101,2.8019801980198,0.707386768044159,45.9587155963303
"5565922078.jpg",0,4,63,59,0,126,3.43650793650794,0.558512764345192,68.8333333333333
"5566203819.jpg",0,56,41,4,0,101,2.48514851485149,0.576434929304924,38.6597222222222
"556649487.jpg",0,10,70,24,1,105,3.15238095238095,0.584757549708759,60.0022321428571
"5568534829.jpg",0,9,62,26,0,97,3.17525773195876,0.577536241257322,58.3080357142857
"5569285371.jpg",0,0,47,61,2,110,3.59090909090909,0.529764610103801,70.6050420168067
"5569562301.jpg",9,45,43,7,0,104,2.46153846153846,0.749408529533402,39.2299107142857
"5569876905.jpg",0,34,62,11,0,107,2.78504672897196,0.614725546724555,48.4025423728814
"5570837854.jpg",0,15,72,17,0,104,3.01923076923077,0.557051342926048,55.8296460176991
"5571612935.jpg",0,1,67,39,0,107,3.35514018691589,0.500044081992592,64.2733050847458
"5571768533.jpg",1,19,70,23,0,113,3.01769911504425,0.640623313725387,54.6961206896552
"5571835679.jpg",7,66,36,1,0,110,2.28181818181818,0.592488426423846,34.1375
"5572325411.jpg",0,3,31,75,4,113,3.70796460176991,0.577578317651807,74.5625
"5572898913.jpg",26,68,12,0,0,106,1.86792452830189,0.586766306984033,22.3616071428571
"5573315618.jpg",1,37,60,10,0,108,2.73148148148148,0.635499383904956,47.0336134453782
"5573453953.jpg",1,19,63,22,0,105,3.00952380952381,0.657723903017621,55.9495412844037
"5573505825.jpg",0,0,36,66,4,106,3.69811320754717,0.537539567903605,74.2888349514563
"5573708083.jpg",1,12,70,22,0,105,3.07619047619048,0.599603043290984,54.5135135135135
"5574048372.jpg",0,3,59,41,3,106,3.41509433962264,0.599490649330181,64.6118421052632
"5575057872.jpg",0,10,72,21,0,103,3.10679611650485,0.540744246734931,57.3504464285714
"5575661562.jpg",0,0,19,71,8,98,3.88775510204082,0.515385013948375,75.6150442477876
"5577238906.jpg",0,0,32,75,3,110,3.73636363636364,0.500958214435604,72.1737288135593
"5577299644.jpg",0,23,72,18,1,114,2.97368421052632,0.630500943074245,52.0065217391304
"5577977748.jpg",7,93,10,0,0,110,2.02727272727273,0.393970401465676,28.2884615384615
"5578143578.jpg",0,1,55,84,2,142,3.61267605633803,0.530603718102097,72.4438775510204
"5580400310.jpg",1,11,71,25,0,108,3.11111111111111,0.601141178518743,56.9247787610619
"5580904626.jpg",0,0,29,68,1,98,3.71428571428571,0.476239565461901,72.8598130841121
"5581852297.jpg",5,82,16,4,0,107,2.17757009345794,0.563229972671935,29.4625
"5583866722.jpg",1,49,50,2,0,102,2.51960784313725,0.55811550238036,40.875
"5585956743.jpg",0,6,54,40,0,100,3.34,0.589812502307969,62.4930555555556
"5586376319.jpg",1,10,61,29,2,103,3.20388349514563,0.676774693892692,61.7853773584906
"5586890749.jpg",0,3,43,52,2,100,3.53,0.593823427145025,69.475
"558820165.jpg",0,6,64,40,2,112,3.33928571428571,0.608551247089857,63.9679487179487
"5588234773.jpg",21,65,17,2,0,105,2,0.665062171761176,25.3644859813084
"5588363134.jpg",1,7,62,36,0,106,3.25471698113208,0.618158875474536,64.3482142857143
"5588569639.jpg",0,0,37,62,4,103,3.67961165048544,0.546173717839859,73.7898230088496
"5588623277.jpg",1,1,32,65,4,103,3.67961165048544,0.613789135296507,76.0432692307692
"5588665887.jpg",1,2,55,75,2,135,3.55555555555556,0.594334780107787,71.7640845070423
"5589406824.jpg",1,45,53,1,0,100,2.54,0.539734315485991,40.6605504587156
"5590179803.jpg",0,12,61,28,0,101,3.15841584158416,0.612089425939163,57.475
"5590319772.jpg",1,50,45,5,0,101,2.53465346534653,0.609333347776791,40.2638888888889
"5592031827.jpg",1,11,71,13,0,96,3,0.542896714030637,55.3058252427184
"5592040758.jpg",0,3,43,65,2,113,3.58407079646018,0.578261923427409,69.1673728813559
"5592471041.jpg",0,1,67,38,1,107,3.36448598130841,0.521111355290732,66.2567567567568
"5592815589.jpg",0,4,74,21,1,100,3.19,0.506423386569624,62.3642857142857
"5593028853.jpg",0,9,60,33,1,103,3.25242718446602,0.621800778289325,61.8341121495327
"5593982816.jpg",0,6,53,41,0,100,3.35,0.592461054424762,61.9910714285714
"5594109805.jpg",0,2,38,61,3,104,3.625,0.577700496864656,74.0389908256881
"5594332636.jpg",0,1,40,59,1,101,3.59405940594059,0.53250761162226,69.6490825688073
"5594349841.jpg",0,2,41,61,1,105,3.58095238095238,0.550890055709716,73.0707547169811
"5594639206.jpg",0,7,61,34,0,102,3.26470588235294,0.578945278424999,60.475
"5594665184.jpg",0,6,50,47,2,105,3.42857142857143,0.633323693776651,65.6004464285714
"5596136215.jpg",1,13,64,35,0,113,3.17699115044248,0.65778427444467,57.3869565217391
"5596270310.jpg",0,9,65,30,1,105,3.21904761904762,0.604167456106596,60.8714285714286
"5597029310.jpg",2,38,55,5,0,100,2.63,0.613896316057269,43.3
"5597221402.jpg",0,10,72,26,0,108,3.14814814814815,0.560620730989526,58.1554054054054
"5597328203.jpg",0,34,61,13,0,108,2.80555555555556,0.633316936990578,48.5287610619469
"5598111719.jpg",0,9,62,25,1,97,3.18556701030928,0.600865641304563,58.5928571428571
"5599500585.jpg",0,18,64,21,0,103,3.02912621359223,0.61765385762215,53.8147321428571
"5599655175.jpg",0,2,32,59,13,106,3.78301886792453,0.676189843462999,76.3879310344828
"5599685670.jpg",0,6,57,39,2,104,3.35576923076923,0.621902331025801,62.6148648648649
"560054684.jpg",26,64,11,0,0,101,1.85148514851485,0.589680228833584,21.0573394495413
"5601711871.jpg",0,0,33,74,4,111,3.73873873873874,0.517190165689244,74.271186440678
"5602088551.jpg",0,2,57,50,2,111,3.46846846846847,0.569207101147486,67.2115384615385
"5602195949.jpg",0,1,48,59,2,110,3.56363636363636,0.550683857210433,71.5833333333333
"5602472061.jpg",0,6,60,37,1,104,3.31730769230769,0.595524131992075,60.8310810810811
"5602672763.jpg",0,7,60,37,4,108,3.35185185185185,0.660144628939776,61.6375
"5602815566.jpg",0,7,51,37,5,100,3.4,0.696310623822791,66.7729357798165
"5604745238.jpg",9,98,20,0,0,127,2.08661417322835,0.471802051026785,27.0095419847328
"5605845677.jpg",3,30,70,5,0,108,2.71296296296296,0.59673450828806,46.2302631578947
"5606263347.jpg",23,77,6,0,0,106,1.83962264150943,0.500224567718486,21.1586956521739
"5606634799.jpg",0,1,56,43,1,101,3.43564356435644,0.536951423951151,68.8252212389381
"5606693622.jpg",1,11,58,44,0,114,3.2719298245614,0.66897210438684,61.5231092436975
"5607542951.jpg",0,30,70,7,0,107,2.78504672897196,0.549923448929572,48.6418918918919
"5609386026.jpg",2,21,52,29,0,104,3.03846153846154,0.749408529533402,56.7079207920792
"5610005411.jpg",0,0,47,59,1,107,3.57009345794393,0.516010631978924,69.0798319327731
"5611311337.jpg",10,68,24,3,0,105,2.19047619047619,0.636928297124296,31.472972972973
"5611315745.jpg",1,49,52,4,0,106,2.55660377358491,0.586842863355548,42.5446428571429
"561215186.jpg",0,1,66,40,0,107,3.36448598130841,0.502681927350329,63.4955752212389
"5612537234.jpg",0,1,33,65,6,105,3.72380952380952,0.58004041794248,72.5705128205128
"5613119527.jpg",0,46,54,5,1,106,2.63207547169811,0.622215269716858,42.6694915254237
"5613166397.jpg",2,59,44,2,0,107,2.42990654205607,0.568217164383648,38.5195652173913
"5615226673.jpg",9,71,20,4,0,104,2.18269230769231,0.634974551541479,30.9936440677966
"5616548747.jpg",0,3,20,77,2,102,3.76470588235294,0.529832228036428,75.475
"5617741019.jpg",0,0,40,62,1,103,3.62135922330097,0.507135454975797,71.7879464285714
"5617865491.jpg",0,18,70,15,0,103,2.97087378640777,0.56804291952612,53.9110576923077
"5619348479.jpg",3,52,47,5,0,107,2.50467289719626,0.635043183432864,41.2285714285714
"5619807447.jpg",0,5,47,46,4,102,3.48039215686275,0.655976215411352,64.7293577981651
"5621762674.jpg",0,1,15,76,13,105,3.96190476190476,0.553377905438143,81.3207547169811
"5621947330.jpg",0,1,54,79,0,134,3.58208955223881,0.510027383352818,74.3815789473684
"5622280405.jpg",2,67,37,2,0,108,2.36111111111111,0.554646192409083,37.2584033613445
"5622618497.jpg",0,1,35,69,2,107,3.67289719626168,0.528002661059965,72.1302521008403
"5623266706.jpg",0,0,47,53,1,101,3.54455445544554,0.520091385724615,67.8918918918919
"5625316207.jpg",0,2,87,39,1,129,3.30232558139535,0.509360063627494,64.357421875
"5625825104.jpg",0,3,55,44,3,105,3.44761904761905,0.604167456106596,67.146017699115
"5626243539.jpg",6,33,54,12,0,105,2.68571428571429,0.750823723477264,44.6592920353982
"5627315065.jpg",0,0,26,83,2,111,3.78378378378378,0.45538006914116,73.8397435897436
"56278886.jpg",3,39,54,6,0,102,2.61764705882353,0.645534817753356,42.4615384615385
"5627914510.jpg",0,1,58,40,6,105,3.48571428571429,0.621943073611393,68.0023364485981
"5628057241.jpg",0,5,47,56,0,108,3.47222222222222,0.587380265521398,69.4672897196262
"5628498882.jpg",0,2,40,58,2,102,3.58823529411765,0.569052385423217,69.972972972973
"5628676220.jpg",0,2,34,69,1,106,3.65094339622642,0.535278349133619,71.2364864864865
"5628766419.jpg",1,30,60,8,0,99,2.75757575757576,0.607620133261797,47.2961165048544
"5628885328.jpg",0,3,50,49,0,102,3.45098039215686,0.556286324530138,69.4092920353982
"5629171325.jpg",1,12,42,51,2,108,3.37962962962963,0.745297940707132,62.325
"562942809.jpg",42,70,14,1,0,127,1.79527559055118,0.658745593366971,21.2027559055118
"5630657407.jpg",0,3,51,50,3,107,3.49532710280374,0.604602345155841,66.7203389830509
"5630751358.jpg",0,0,19,88,7,114,3.89473684210526,0.467878303756674,77.3125
"5631242230.jpg",1,8,57,41,0,107,3.28971962616822,0.644414986919063,62.8357142857143
"5631644954.jpg",2,30,73,8,0,113,2.76991150442478,0.597746505598947,48.0818965517241
"5631740117.jpg",0,1,16,73,8,98,3.89795918367347,0.527389914606065,77.2212389380531
"5632060967.jpg",0,0,68,39,1,108,3.37962962962963,0.506363110683967,65.4487179487179
"5633412794.jpg",0,3,37,57,4,101,3.61386138613861,0.615959366025113,72.025
"563363297.jpg",1,42,65,4,0,112,2.64285714285714,0.56723039565094,44.224358974359
"5634507491.jpg",2,28,54,19,0,103,2.87378640776699,0.72327701484673,50.9459459459459
"5634844318.jpg",0,39,63,2,0,104,2.64423076923077,0.519863111757694,43.9622641509434
"563494328.jpg",18,80,11,0,0,109,1.93577981651376,0.514155714952664,25.68125
"5635139040.jpg",0,3,64,65,0,132,3.46969696969697,0.544779441880924,69.1875
"5636641388.jpg",0,10,62,34,3,109,3.27522935779817,0.66488037956473,62.6540178571429
"5637731734.jpg",0,0,34,72,5,111,3.73873873873874,0.534478704596811,74.4469026548673
"5642132751.jpg",0,20,64,20,0,104,3,0.623176952849756,54.0138888888889
"5642698379.jpg",0,39,70,3,0,112,2.67857142857143,0.523575471284966,45.8175675675676
"5643675511.jpg",42,58,7,1,0,108,1.69444444444444,0.633316936990578,16.3108108108108
"5643887824.jpg",0,4,50,44,6,104,3.5,0.668282830654486,69.304054054054
"5643888483.jpg",1,22,57,26,0,106,3.0188679245283,0.703476158941766,53.3243243243243
"5644548369.jpg",0,1,18,84,6,109,3.87155963302752,0.492554141246547,75.86875
"5644640425.jpg",0,4,42,53,1,100,3.51,0.594503442743895,68.1353211009174
"5644717504.jpg",1,31,70,7,0,109,2.76146788990826,0.575729530261347,46.5575221238938
"5645210616.jpg",0,1,26,67,1,95,3.71578947368421,0.498148868946522,75.9639423076923
"5645276165.jpg",0,6,50,46,3,105,3.43809523809524,0.649316349410456,63.5810810810811
"5645356042.jpg",0,4,39,57,2,102,3.55882352941176,0.606459117846457,72.25
"5645503965.jpg",0,17,71,14,0,102,2.97058823529412,0.553224254977911,53.5642857142857
"5645568177.jpg",2,16,65,21,1,105,3.02857142857143,0.685805854691887,56.2972972972973
"5645669819.jpg",0,19,69,18,0,106,2.99056603773585,0.593541157057616,57.4241071428571
"5645990670.jpg",0,32,63,5,0,100,2.73,0.547814758929522,45.2775229357798
"5646094610.jpg",1,12,61,25,0,99,3.11111111111111,0.637099436202841,56.5911214953271
"5646137718.jpg",0,44,58,11,0,113,2.70796460176991,0.63641596809796,45.1617647058824
"5646738672.jpg",0,6,60,39,0,105,3.31428571428571,0.577032956569235,62.1383928571429
"5647215115.jpg",0,4,52,41,0,97,3.38144329896907,0.567217238092253,65.8434579439252
"5647243489.jpg",1,9,68,23,0,101,3.11881188118812,0.587998787632616,56.3819444444444
"564783596.jpg",0,2,47,55,2,106,3.5377358490566,0.571956180504146,66.510593220339
"5648003529.jpg",0,0,26,77,3,106,3.78301886792453,0.47818539901495,75.4709821428571
"5649238461.jpg",3,29,61,10,0,103,2.75728155339806,0.663709412812857,48.6584821428571
"5650073370.jpg",0,2,27,58,17,104,3.86538461538462,0.697536473733238,76.5897435897436
"5650628470.jpg",1,10,80,20,0,111,3.07207207207207,0.551225275045787,56.260775862069
"5651165439.jpg",0,2,21,82,1,106,3.77358490566038,0.483696458691754,79.997641509434
"5651460875.jpg",0,0,45,60,1,106,3.58490566037736,0.513956168750047,69.6517857142857
"5651646348.jpg",0,3,49,52,0,104,3.47115384615385,0.556632223656022,69.1838235294118
"5652034742.jpg",0,5,62,34,0,101,3.28712871287129,0.55383451794496,63.90625
"5652671086.jpg",4,56,40,0,0,100,2.36,0.559942276967326,37.2282608695652
"5655651548.jpg",6,80,27,0,0,113,2.1858407079646,0.509703565221487,32.364224137931
"5656494008.jpg",0,2,36,66,1,105,3.62857142857143,0.541670188774122,69.2297297297297
"5656752407.jpg",0,0,24,80,2,106,3.79245283018868,0.451810772275623,77.1869565217391
"5657214180.jpg",0,2,40,86,2,130,3.67692307692308,0.531421738174505,75.9645669291339
"5657622409.jpg",0,4,52,47,1,104,3.43269230769231,0.587316144781357,68.2452830188679
"5657790806.jpg",0,12,73,27,1,113,3.15044247787611,0.600910602723262,58.8193277310924
"5657799294.jpg",7,64,31,5,0,107,2.31775700934579,0.667268875131512,33.3429203539823
"5658520618.jpg",1,2,82,22,0,107,3.16822429906542,0.485370531644527,60.5022123893805
"5659520017.jpg",0,21,70,12,0,103,2.9126213592233,0.561978230624793,51.2710280373832
"5660004991.jpg",8,45,45,9,0,107,2.51401869158878,0.756911375153002,40.2394957983193
"5660186741.jpg",2,66,44,1,0,113,2.38938053097345,0.541717314238842,37.3970588235294
"5660281772.jpg",34,61,6,0,0,101,1.72277227722772,0.567781857427448,18.7571428571429
"5661464368.jpg",0,0,18,74,11,103,3.93203883495146,0.528819178895071,77.4598214285714
"5663852709.jpg",0,17,77,10,1,105,2.95238095238095,0.543863535997354,51.3608695652174
"5664036497.jpg",0,1,32,64,7,104,3.74038461538462,0.591118608959406,73.6
"5664282389.jpg",0,3,52,48,4,107,3.49532710280374,0.620009613067607,67.6875
"5664632199.jpg",1,15,64,28,0,108,3.10185185185185,0.654814160906468,59.5602678571429
"5665181716.jpg",0,6,55,66,3,130,3.50769230769231,0.625630272545108,71.833984375
"5665436785.jpg",0,0,44,60,1,105,3.59047619047619,0.513195833352107,71.2672413793103
"5666081630.jpg",0,3,45,58,4,110,3.57272727272727,0.612695816428967,68.7522123893805
"5666479112.jpg",0,1,63,46,0,110,3.40909090909091,0.512154193837384,65.6858407079646
"5667464271.jpg",0,0,30,75,0,105,3.71428571428571,0.453920649501602,74.1176470588235
"5667961686.jpg",0,1,36,99,2,138,3.73913043478261,0.487872602523692,77.298275862069
"5669528587.jpg",1,4,60,38,0,103,3.31067961165049,0.594568985650855,63.5428571428571
"5669648365.jpg",0,5,71,21,1,98,3.18367346938776,0.524589948367337,59.052752293578
"5670774641.jpg",0,1,46,55,0,102,3.52941176470588,0.520964116757892,66.9243119266055
"5670925520.jpg",0,0,28,71,6,105,3.79047619047619,0.531602043450486,76.9305555555556
"5671199285.jpg",8,58,36,3,0,105,2.32380952380952,0.657723903017621,34.7432432432432
"5671296107.jpg",0,19,67,19,0,105,3,0.604470524826989,52.5067567567568
"5671373340.jpg",0,1,58,48,0,107,3.4392523364486,0.51720530016433,68.6205357142857
"5671581323.jpg",0,1,33,69,0,103,3.66019417475728,0.496130083713671,74.0277777777778
"5673447503.jpg",0,4,70,26,0,100,3.22,0.504124403437697,59.8853211009174
"5673514295.jpg",0,0,47,59,3,109,3.59633027522936,0.546356044118937,70.327731092437
"5674214513.jpg",0,2,27,81,0,110,3.71818181818182,0.49086738771988,71.95
"5674445474.jpg",0,2,57,44,0,103,3.40776699029126,0.53204918694708,67.8088235294118
"5676561526.jpg",0,21,53,39,0,113,3.15929203539823,0.714222500363356,57.9873949579832
"5677087869.jpg",0,0,24,74,2,100,3.78,0.462317395019238,77.0665137614679
"5677116051.jpg",0,6,28,66,9,109,3.71559633027523,0.695111809808002,74.4180672268908
"5678053727.jpg",0,6,56,46,0,108,3.37037037037037,0.589512591204502,63.0483193277311
"5678174838.jpg",0,4,69,33,0,106,3.27358490566038,0.526136300789146,63.2794117647059
"5679411319.jpg",0,3,41,61,3,108,3.59259259259259,0.596516946936129,70.7754237288136
"5679420644.jpg",0,2,41,64,2,109,3.60550458715596,0.561386323439955,73.5848623853211
"5679431462.jpg",0,1,31,70,6,108,3.75,0.565768024851109,72.593220338983
"5680237187.jpg",0,0,16,82,6,104,3.90384615384615,0.451947904232781,79.0066964285714
"5680314396.jpg",0,35,65,8,0,108,2.75,0.582052443280648,48.4025423728814
"5680571645.jpg",11,66,26,0,0,103,2.14563106796116,0.584233484589436,31.027027027027
"5680623261.jpg",0,1,63,43,0,107,3.39252336448598,0.509476411693017,65.8851351351351
"5681154520.jpg",0,3,54,46,1,104,3.43269230769231,0.57054603512134,66.325
"5681342957.jpg",0,1,32,66,3,102,3.69607843137255,0.541161488064193,75.025
"5681482199.jpg",0,11,65,31,0,107,3.18691588785047,0.600798856892478,61.3382352941176
"5681785926.jpg",0,5,58,35,1,99,3.32323232323232,0.586032715327688,61.9883177570093
"5681801478.jpg",1,34,66,8,0,109,2.74311926605505,0.599439085416844,46.6351351351351
"5682574149.jpg",1,20,70,8,0,99,2.85858585858586,0.553469594506218,51.3402777777778
"5682778748.jpg",2,37,58,5,0,102,2.64705882352941,0.607658365839589,43.0602678571429
"5683735781.jpg",0,7,74,25,0,106,3.16981132075472,0.525025135238804,60.9872881355932
"5683736894.jpg",6,83,20,3,0,112,2.17857142857143,0.556926664981405,32.3919491525424
"5684082265.jpg",0,4,44,52,5,105,3.55238095238095,0.650161997282695,69.2632743362832
"5684508410.jpg",0,0,14,89,8,111,3.94594594594595,0.443904941458864,80.0042372881356
"5684894057.jpg",0,8,67,24,1,100,3.18,0.575246982529323,60.325
"5684960466.jpg",22,61,20,1,0,104,2,0.668282830654486,26.1355140186916
"5685134916.jpg",0,3,65,30,2,100,3.31,0.563090318750649,63.6697247706422
"5685822958.jpg",0,0,15,77,12,104,3.97115384615385,0.511170952903096,79.6696428571429
"5685877023.jpg",0,25,64,16,0,105,2.91428571428571,0.621943073611393,52.7098214285714
"5687490427.jpg",0,46,63,3,0,112,2.61607142857143,0.541028978163236,44.2948717948718
"5689072971.jpg",0,29,65,4,0,98,2.74489795918367,0.523887618581513,46.1857798165138
"5690703973.jpg",2,41,58,4,0,105,2.60952380952381,0.596387169276516,44.6764705882353
"5690945868.jpg",0,0,32,72,4,108,3.74074074074074,0.518271216306465,74.9630434782609
"5690961665.jpg",0,0,23,72,5,100,3.82,0.50010099990003,76.9151376146789
"5691962850.jpg",0,0,18,91,3,112,3.86607142857143,0.413631156455523,77.9294871794872
"5692339429.jpg",0,0,37,64,4,105,3.68571428571429,0.542683604419273,72.0217391304348
"5692807668.jpg",2,51,50,2,0,105,2.4952380952381,0.573850180189942,38.0891304347826
"5692933688.jpg",0,2,31,65,6,104,3.72115384615385,0.598651085134435,72.9342105263158
"5692969991.jpg",0,1,31,70,2,104,3.70192307692308,0.5191443238415,71.9054054054054
"5693602630.jpg",0,37,54,8,1,100,2.73,0.649086382011771,44.2212389380531
"5694228883.jpg",0,0,39,65,2,106,3.65094339622642,0.517180134966139,71.4478260869565
"5695511111.jpg",0,1,56,52,0,109,3.46788990825688,0.519415756892612,64.4348739495798
"5698690184.jpg",0,4,51,46,0,101,3.41584158415842,0.570391562572121,69.4127358490566
"5699749992.jpg",0,5,48,52,0,105,3.44761904761905,0.588037027565055,67.5689655172414
"5699762014.jpg",0,2,49,52,0,103,3.48543689320388,0.539863411736181,68.4121621621622
"5700146083.jpg",0,3,33,55,9,100,3.7,0.674199862463242,73.0550458715596
"5700224418.jpg",2,35,41,26,2,106,2.91509433962264,0.852089024281494,50.8716216216216
"5700592133.jpg",0,0,34,69,2,105,3.6952380952381,0.502375310282017,75.9129464285714
"5700803236.jpg",0,2,54,46,0,102,3.43137254901961,0.536025045993237,63.9724770642202
"5701016184.jpg",3,34,58,15,0,110,2.77272727272727,0.712394732723844,45.0924369747899
"5701314350.jpg",0,1,29,70,4,104,3.74038461538462,0.539600576976746,75.5420353982301
"570171486.jpg",0,8,49,45,5,107,3.4392523364486,0.702791873073172,64.4131355932203
"5702257196.jpg",1,26,88,11,0,126,2.86507936507937,0.556462751359688,51.5060975609756
"5705716016.jpg",2,61,41,4,0,108,2.43518518518519,0.600204764874847,38.8241525423729
"5706720351.jpg",5,84,19,2,0,110,2.16363636363636,0.516290095668838,30.2563025210084
"5706891854.jpg",0,3,51,49,1,104,3.46153846153846,0.573239422405291,66.2633928571429
"5707035849.jpg",0,5,64,45,1,115,3.36521739130435,0.582349066095764,65.5897435897436
"5707149624.jpg",0,0,38,91,0,129,3.70542635658915,0.457628069082747,76.3206106870229
"5707373155.jpg",0,24,66,20,0,110,2.96363636363636,0.634299045718579,53.25
"5707521864.jpg",0,6,52,43,4,105,3.42857142857143,0.662993544131796,65.6128318584071
"5708496664.jpg",0,7,69,35,0,111,3.25225225225225,0.563567669058932,62.2544247787611
"5709659001.jpg",28,68,8,0,0,104,1.80769230769231,0.558724676052145,21.0573394495413
"5711022887.jpg",0,3,68,35,0,106,3.30188679245283,0.519520132443754,63.1260869565217
"5712901839.jpg",1,30,59,12,0,102,2.80392156862745,0.645459628792906,50.197247706422
"5713375255.jpg",6,58,33,3,0,100,2.33,0.636515133481927,32.5398230088496
"5714331882.jpg",0,5,68,27,3,103,3.27184466019417,0.597284291315768,61.975
"5715854575.jpg",1,31,72,6,0,110,2.75454545454545,0.561556873137655,46.8581081081081
"5716274912.jpg",0,3,51,44,1,99,3.43434343434343,0.574307323005264,69.2785714285714
"5717976598.jpg",4,55,48,3,0,110,2.45454545454545,0.615344516561022,38.0192307692308
"5718858871.jpg",0,3,48,48,0,99,3.45454545454545,0.558290526239082,69.9575471698113
"5719070301.jpg",5,54,49,1,0,109,2.42201834862385,0.597736130028704,37.2545871559633
"5719459427.jpg",0,4,36,69,1,110,3.60909090909091,0.57621757080761,71.9054054054054
"5719653094.jpg",43,59,6,0,0,108,1.65740740740741,0.58264682938731,17.2920168067227
"5720139957.jpg",0,17,66,19,0,102,3.01960784313725,0.596697049969938,54.3014705882353
"5720446079.jpg",1,40,74,5,0,120,2.69166666666667,0.562046580403633,46.5148305084746
"5723599109.jpg",0,16,81,12,0,109,2.96330275229358,0.507838657387166,55.0265486725664
"5724255636.jpg",2,37,65,4,0,108,2.65740740740741,0.58264682938731,44.6071428571429
"5724656586.jpg",0,5,51,52,3,111,3.47747747747748,0.630250265541711,65.1281512605042
"5725492383.jpg",0,4,80,42,1,127,3.31496062992126,0.544828317236808,63.8064516129032
"5726241150.jpg",0,0,22,77,6,105,3.84761904761905,0.495769649925795,76.0391304347826
"5726507119.jpg",2,49,45,11,0,107,2.60747663551402,0.697123596223234,41.8340336134454
"5727031782.jpg",0,5,49,51,0,105,3.43809523809524,0.587101903155359,67.9611650485437
"5727760730.jpg",0,11,65,32,0,108,3.19444444444444,0.60308139177812,59.3445945945946
"5727908818.jpg",0,14,80,11,0,105,2.97142857142857,0.489449118459151,53.2254464285714
"5730689688.jpg",0,1,34,66,5,106,3.70754716981132,0.568489747481794,72.2689075630252
"5731936449.jpg",0,6,53,46,3,108,3.42592592592593,0.644222398814764,65.4802631578947
"5732196042.jpg",0,3,41,60,3,107,3.58878504672897,0.598004086375219,69.9203539823009
"5732256845.jpg",2,64,34,1,0,101,2.33663366336634,0.534363691183678,36.1626213592233
"5734064610.jpg",1,23,66,10,0,100,2.85,0.592461054424762,49.6674311926606
"5734560437.jpg",1,16,70,23,2,112,3.08035714285714,0.673011155512311,57.3397435897436
"5734758076.jpg",0,2,54,46,0,102,3.43137254901961,0.536025045993237,65.7663551401869
"5737344773.jpg",0,0,54,54,2,110,3.52727272727273,0.536880061249071,68.6638655462185
"5737901450.jpg",0,1,14,89,7,111,3.91891891891892,0.46972206743863,76.2727272727273
"5739537678.jpg",0,28,69,9,0,106,2.82075471698113,0.565637774237369,46.1282051282051
"5740000928.jpg",0,0,50,58,1,109,3.55045871559633,0.517941769430268,69.0105042016807
"5740846112.jpg",0,18,68,17,1,104,3.00961538461538,0.615262077045495,55.8035714285714
"5741757504.jpg",0,17,71,17,0,105,3,0.571771874896866,52.4369565217391
"5741853020.jpg",0,0,15,84,9,108,3.94444444444444,0.470301818647401,77.3125
"5743028880.jpg",3,6,56,37,1,103,3.2621359223301,0.713472110129211,62.3197115384615
"5745624995.jpg",1,10,79,15,0,105,3.02857142857143,0.527277894493955,55.7828947368421
"5746249801.jpg",0,2,47,56,1,106,3.52830188679245,0.555621439639331,68.7934782608696
"5746784745.jpg",1,39,82,3,0,125,2.696,0.527073478381244,46.375
"5747013682.jpg",9,78,14,0,0,101,2.04950495049505,0.476995547647195,28.075
"5748221179.jpg",0,6,73,24,0,103,3.1747572815534,0.513106350364809,60.8672566371681
"5748620149.jpg",0,10,81,15,0,106,3.04716981132075,0.485642931178632,56.9821428571429
"5748824865.jpg",1,47,57,2,0,107,2.5607476635514,0.552482734186941,42.1026785714286
"5748929912.jpg",2,37,62,5,0,106,2.66037735849057,0.599790319755959,43.9831932773109
"5748977191.jpg",0,11,72,28,0,111,3.15315315315315,0.575218507070427,59.4491525423729
"57501165.jpg",1,26,59,18,2,106,2.94339622641509,0.728078863850355,51.8983050847458
"5750644508.jpg",0,8,65,31,0,104,3.22115384615385,0.573809121695014,62.0045871559633
"5751931658.jpg",1,27,62,12,0,102,2.83333333333333,0.630626489276257,49.3646788990826
"5752124692.jpg",0,1,27,72,1,101,3.72277227722772,0.492317212398432,76.525
"5752256334.jpg",0,12,76,16,0,104,3.03846153846154,0.519952890380548,55.6381578947368
"5756343761.jpg",0,1,30,74,5,110,3.75454545454545,0.544974768145213,75.7702702702703
"5756631011.jpg",0,7,76,23,0,106,3.15094339622642,0.512555740619193,59.1959459459459
"5756854423.jpg",6,32,62,6,0,106,2.64150943396226,0.678775918495346,42.6216216216216
"5759402144.jpg",0,0,23,74,0,97,3.76288659793814,0.42752182878696,77.9740566037736
"5761420767.jpg",0,20,98,20,0,138,3,0.540343226958299,56.7586206896552
"5761873238.jpg",2,40,58,6,0,106,2.64150943396226,0.620117949537605,42.5446428571429
"5762320263.jpg",1,67,39,0,0,107,2.35514018691589,0.500044081992592,36.1491596638655
"5763062464.jpg",0,1,38,66,2,107,3.64485981308411,0.536451240088433,73.7767857142857
"5763573511.jpg",2,43,56,8,0,109,2.64220183486239,0.645826140172365,44.7457983193277
"5764115414.jpg",0,1,40,62,5,108,3.65740740740741,0.58264682938731,71.7142857142857
"5764514076.jpg",19,95,36,2,0,152,2.13815789473684,0.630876003027171,29.0079617834395
"5765377670.jpg",0,0,42,64,3,109,3.64220183486239,0.536154617344946,69.8665254237288
"5765859594.jpg",0,0,29,75,1,105,3.73333333333333,0.465474668125631,74.1021739130435
"5766806996.jpg",21,80,10,0,0,111,1.9009009009009,0.52144824470725,23.61875
"5768167934.jpg",0,1,13,70,29,113,4.12389380530973,0.628671265488227,83.6410256410256
"5770080490.jpg",0,2,59,47,1,109,3.43119266055046,0.55053799406453,65.6134453781513
"5771711136.jpg",0,4,71,27,1,103,3.24271844660194,0.532585617115547,59.9181415929204
"5771887382.jpg",9,92,8,0,0,109,1.99082568807339,0.396638954308265,26.0966386554622
"5773170451.jpg",0,5,57,38,1,101,3.34653465346535,0.590519154039163,62.5464601769912
"5773721595.jpg",0,14,70,18,0,102,3.03921568627451,0.561496737908777,57.070796460177
"5775598450.jpg",0,0,21,68,15,104,3.94230769230769,0.588348405414552,81.5321100917431
"5777168643.jpg",0,0,54,57,0,111,3.51351351351351,0.502084108579879,65.5897435897436
"5777912776.jpg",0,1,36,64,1,102,3.63725490196078,0.522545477414006,70.9357798165138
"5780359774.jpg",0,0,46,54,3,103,3.58252427184466,0.551722291692297,69.1172566371681
"5780360656.jpg",0,1,28,73,1,103,3.71844660194175,0.493436841184705,77.125
"5782679543.jpg",0,9,67,27,1,104,3.19230769230769,0.592459462820778,59.6826086956522
"5782924074.jpg",0,1,32,71,6,110,3.74545454545455,0.565626447164065,74.6906779661017
"5782928744.jpg",0,7,64,36,1,108,3.28703703703704,0.59673450828806,62.3402777777778
"5783124720.jpg",3,78,21,2,0,104,2.21153846153846,0.515263659967445,30.7961165048544
"5784134624.jpg",2,48,53,6,0,109,2.57798165137615,0.627953436314134,41.0512820512821
"5784673341.jpg",0,7,48,54,1,110,3.44545454545455,0.629348922873686,64.45625
"5785719824.jpg",10,74,19,0,0,103,2.0873786407767,0.525931407525415,28.9583333333333
"5786083032.jpg",0,20,59,26,1,106,3.07547169811321,0.685886471343711,56.1155462184874
"5786468844.jpg",0,5,35,57,6,103,3.62135922330097,0.673249434508532,69.75
"5786557550.jpg",0,2,68,38,1,109,3.34862385321101,0.533613585898434,65.3919491525424
"5788614098.jpg",0,11,68,27,0,106,3.15094339622642,0.582154501341495,58.972972972973
"5788815207.jpg",0,2,47,48,1,98,3.48979591836735,0.56064943857357,67
"5789601551.jpg",1,21,69,18,0,109,2.95412844036697,0.62930474718677,53.5663716814159
"5790219836.jpg",0,9,65,31,1,106,3.22641509433962,0.606049170846951,61.2330097087379
"5791107273.jpg",0,23,57,21,0,101,2.98019801980198,0.663026364782004,52.046875
"5791949308.jpg",4,80,21,0,0,105,2.16190476190476,0.462514231045288,29.2652173913043
"5793101915.jpg",0,2,29,72,10,113,3.79646017699115,0.614690573078936,75.8
"5794649659.jpg",0,13,46,39,2,100,3.3,0.717740562565273,60.1371681415929
"5794758875.jpg",1,17,62,17,1,98,3,0.658019521535379,49.5508849557522
"5795183898.jpg",0,1,55,50,1,107,3.47663551401869,0.538092269434313,67.4304347826087
"5796436033.jpg",0,8,56,42,1,107,3.33644859813084,0.628624212574419,60.74375
"5796747370.jpg",0,1,37,65,2,105,3.64761904761905,0.536745040121693,72.5
"5796923587.jpg",0,2,51,41,1,95,3.43157894736842,0.55835304127497,67.3928571428571
"5797735856.jpg",1,43,52,12,0,108,2.69444444444444,0.676139859078185,43.9
"5798200461.jpg",0,0,41,59,5,105,3.65714285714286,0.568881686843911,71.2326086956522
"5798775388.jpg",2,28,68,8,0,106,2.77358490566038,0.606049170846951,49.8370535714286
"5799422140.jpg",1,33,67,4,0,105,2.7047619047619,0.553377905438143,44.777027027027
"5802112389.jpg",0,2,52,52,1,107,3.48598130841122,0.555665264741086,69.75
"5802569891.jpg",0,18,71,17,0,106,2.99056603773585,0.577272453936332,53.7584033613445
"5803562101.jpg",0,3,54,41,0,98,3.38775510204082,0.549276057032683,65.1834862385321
"5803914327.jpg",0,46,60,4,0,110,2.61818181818182,0.558205154187778,43.2905405405405
"5804026649.jpg",0,0,21,77,9,107,3.88785046728972,0.519925662388535,77.7457983193277
"5804325450.jpg",0,14,56,35,1,106,3.21698113207547,0.676189843462999,59.7075892857143
"5804399322.jpg",0,0,34,65,4,103,3.70873786407767,0.535615240179964,72.8826086956522
"5805622077.jpg",0,11,59,32,0,102,3.20588235294118,0.618817705272534,61.2091346153846
"5805954950.jpg",0,0,42,61,3,106,3.63207547169811,0.54029042803915,72.8470873786408
"5807050277.jpg",0,16,68,17,0,101,3.00990099009901,0.574370081131503,52.9977064220183
"5807238153.jpg",0,8,75,24,0,107,3.14953271028037,0.528503374933567,59.9952830188679
"5807318968.jpg",0,21,77,10,0,108,2.89814814814815,0.52844003921284,51.5487288135593
"5808715060.jpg",0,8,70,26,1,105,3.19047619047619,0.573371239908821,58.4605263157895
"5809947698.jpg",62,39,5,0,0,106,1.4622641509434,0.588371898941911,10.7232142857143
"5812785774.jpg",0,0,28,71,6,105,3.79047619047619,0.531602043450486,76.0602678571429
"5812840397.jpg",0,0,45,65,2,112,3.61607142857143,0.524112905006485,70.9487179487179
"5813122725.jpg",0,1,51,58,0,110,3.51818181818182,0.51991209881294,66.10625
"5813266787.jpg",1,43,54,7,0,105,2.63809523809524,0.622090296497492,42.9866071428571
"5815446993.jpg",0,5,68,33,0,106,3.26415094339623,0.539874532027984,62.1758474576271
"5817880168.jpg",0,3,52,45,3,103,3.46601941747573,0.607397759985128,69.1192660550459
"5819286075.jpg",0,0,27,70,5,102,3.7843137254902,0.5194713798307,77.5416666666667
"5820186062.jpg",0,14,76,16,0,106,3.0188679245283,0.534186200379279,55.2836134453782
"5821113845.jpg",0,4,45,51,3,103,3.51456310679612,0.624092716683751,66.6316964285714
"582148952.jpg",1,2,28,68,2,101,3.67326732673267,0.601812444056936,69.8727678571429
"5821971629.jpg",1,34,57,6,0,98,2.69387755102041,0.599108672401358,45.222972972973
"5822039641.jpg",0,2,41,83,6,132,3.70454545454545,0.576096847822295,76.2653846153846
"5822093825.jpg",0,1,14,76,16,107,4,0.566352113954854,78.6875
"5822768427.jpg",0,3,46,57,2,108,3.53703703703704,0.586864405455927,68.594537815126
"5824082232.jpg",2,43,85,9,1,140,2.74285714285714,0.627561554450933,48.025
"5825243642.jpg",61,39,5,0,0,105,1.46666666666667,0.589436932534684,11.0400943396226
"5825508500.jpg",34,61,8,2,0,105,1.79047619047619,0.660641269106681,21.8541666666667
"5825939601.jpg",0,0,27,73,6,106,3.80188679245283,0.524083078124337,78.7120535714286
"5827032065.jpg",0,46,85,1,0,132,2.65909090909091,0.491601921973172,46.375
"5827460813.jpg",0,8,74,26,0,108,3.16666666666667,0.538256097195586,60.2881355932203
"5828251146.jpg",0,15,59,21,1,96,3.08333333333333,0.643455583330581,56.1322115384615
"5828254727.jpg",0,18,71,19,0,108,3.00925925925926,0.587969265684951,54.2905405405405
"5829241861.jpg",0,17,74,7,0,98,2.89795918367347,0.486726831627486,51.5896226415094
"5829966131.jpg",14,66,22,1,0,103,2.09708737864078,0.6185777980902,28.8819444444444
"5830228003.jpg",1,3,62,36,0,102,3.30392156862745,0.576593198502975,64.5555555555556
"5830956184.jpg",0,5,57,50,0,112,3.40178571428571,0.576722979522574,63.1136363636364
"5831302222.jpg",1,46,58,7,0,112,2.63392857142857,0.61505929860294,43.7182203389831
"5831366691.jpg",0,8,71,28,1,108,3.2037037037037,0.576149955481303,59.025
"5832751066.jpg",0,0,29,77,2,108,3.75,0.476062510620918,73.7941176470588
"5833229623.jpg",0,8,57,42,1,108,3.33333333333333,0.626516850919416,66.243119266055
"5834781945.jpg",2,1,46,57,1,107,3.50467289719626,0.635043183432864,68.0760869565217
"5835525141.jpg",0,1,41,55,2,99,3.58585858585859,0.553469594506218,71.35
"5836498446.jpg",0,3,53,54,1,111,3.47747747747748,0.569638591115564,67.6292372881356
"5837969940.jpg",0,3,37,58,6,104,3.64423076923077,0.637322512597413,70.4137931034483
"5838329706.jpg",0,8,65,28,1,102,3.2156862745098,0.590811674948363,57.6903669724771
"5838518725.jpg",0,4,52,47,2,105,3.44761904761905,0.604167456106596,65.8108108108108
"5838794545.jpg",1,6,66,26,2,101,3.21782178217822,0.626162285610362,60.4
"5839623776.jpg",0,17,67,18,1,103,3.02912621359223,0.61765385762215,54.8108108108108
"5839793009.jpg",0,4,78,43,1,126,3.32539682539683,0.548880534606431,64.3387096774194
"5842574442.jpg",0,1,27,62,13,103,3.84466019417476,0.637969843060676,80.2311320754717
"5842712003.jpg",0,1,41,65,2,109,3.62385321100917,0.540729802206447,70.358407079646
"5842931891.jpg",0,0,45,55,1,101,3.56435643564356,0.517993080729046,69.9027777777778
"5844622887.jpg",0,4,49,57,0,110,3.48181818181818,0.570398511614213,67.8389830508475
"5844813103.jpg",1,50,53,1,0,105,2.51428571428571,0.53912831557927,39.1206896551724
"5844921100.jpg",0,3,41,55,6,105,3.60952380952381,0.642938537785661,68.6923076923077
"58449294.jpg",1,28,66,14,0,109,2.85321100917431,0.635751058800978,50.6363636363636
"5846011911.jpg",1,65,40,0,0,106,2.36792452830189,0.503804037831665,36.8986486486486
"5846078806.jpg",0,1,14,82,7,104,3.91346153846154,0.484929720122209,77.3125
"5847384440.jpg",0,1,79,67,1,148,3.45945945945946,0.526551848050522,69.9464285714286
"5847408057.jpg",0,0,24,78,3,105,3.8,0.468220855185637,74.7389380530973
"5847946773.jpg",6,40,50,10,0,106,2.60377358490566,0.739101710675986,43.8705357142857
"5848411050.jpg",0,1,25,65,13,104,3.86538461538462,0.624075118513327,79.4121621621622
"5849166675.jpg",1,42,52,4,0,99,2.5959595959596,0.587613504783473,41.7102803738318
"5849249346.jpg",0,1,21,76,7,105,3.84761904761905,0.533150151691889,77.4210526315789
"5849271016.jpg",0,0,44,75,4,123,3.67479674796748,0.535554484521395,74.0909090909091
"5849666747.jpg",0,3,37,62,3,105,3.61904761904762,0.594541717190521,71.7803738317757
"5850096725.jpg",3,57,37,3,0,100,2.4,0.603022689155527,36.7
"5853259008.jpg",0,4,43,59,1,107,3.53271028037383,0.587892895670724,69.7013274336283
"5854130158.jpg",0,12,66,23,2,103,3.14563106796116,0.632575919496846,60.125
"5856115357.jpg",1,17,77,11,0,106,2.92452830188679,0.546819604754398,52.1351351351351
"5856265647.jpg",0,1,29,73,2,105,3.72380952380952,0.509434794182543,75.9571428571429
"5858971250.jpg",0,4,50,47,6,107,3.51401869158878,0.66395734662544,67.6932773109244
"5859309993.jpg",0,1,49,68,1,119,3.57983193277311,0.528762519494814,71.9358974358974
"5863209284.jpg",0,1,63,47,1,112,3.42857142857143,0.532109277442409,66.51875
"5864167034.jpg",1,40,57,7,0,105,2.66666666666667,0.614983843856998,45.5647321428571
"5864866052.jpg",1,19,69,12,0,101,2.91089108910891,0.584790730107619,53.0733944954128
"5865132229.jpg",0,10,65,32,0,107,3.20560747663551,0.594603367991295,57.9180672268908
"5866448510.jpg",0,0,55,55,2,112,3.52678571428571,0.536250268125201,69.0810810810811
"5866763424.jpg",0,2,53,68,2,125,3.56,0.559377534234663,73.320564516129
"5867990992.jpg",3,52,46,5,1,107,2.52336448598131,0.677757044360061,40.8152173913044
"5868900850.jpg",0,0,13,77,13,103,4,0.504878164297401,82.9797297297297
"5869276624.jpg",0,13,67,19,0,99,3.06060606060606,0.568172541668243,57.1605504587156
"5869585652.jpg",0,0,8,64,33,105,4.23809523809524,0.580513855989964,88.3888888888889
"5869591890.jpg",0,1,45,62,1,109,3.57798165137615,0.532178923922789,70.2860169491525
"5870845920.jpg",0,1,49,58,0,108,3.52777777777778,0.519855000152735,72.4742990654206
"5870955720.jpg",0,0,29,67,6,102,3.77450980392157,0.543309673108284,74.7102803738318
"5871068150.jpg",0,3,66,40,0,109,3.3394495412844,0.530900414150486,62.7710084033613
"5871213191.jpg",0,2,26,78,8,114,3.80701754385965,0.578022153821943,77.0525210084034
"5871593028.jpg",0,7,55,37,0,99,3.3030303030303,0.596837677562393,64.5169902912621
"5871779223.jpg",2,33,83,10,0,128,2.7890625,0.597268635401731,48.0884615384615
"5873610214.jpg",0,22,66,17,0,105,2.95238095238095,0.610500305250229,50.7152173913043
"5875925963.jpg",0,13,93,13,0,119,3,0.469402794038177,54.7307692307692
"5876051594.jpg",0,2,43,53,1,99,3.53535353535354,0.559028518003738,71.125
"5876597412.jpg",0,13,77,21,0,111,3.07207207207207,0.551225275045787,57.9676724137931
"5876691783.jpg",0,0,25,69,10,104,3.85576923076923,0.56462495896549,74.804054054054
"5876722447.jpg",0,5,65,26,0,96,3.21875,0.527219618674978,58.6699029126214
"5877192304.jpg",0,9,73,24,0,106,3.14150943396226,0.542282288907294,58.9690265486726
"5877272501.jpg",0,0,19,83,4,106,3.85849056603774,0.445905803533031,79.195652173913
"5879690252.jpg",0,4,62,35,3,104,3.35576923076923,0.606089955045593,64.7565789473684
"5879706162.jpg",0,0,42,60,4,106,3.64150943396226,0.555297933679073,71.2289915966387
"5880149356.jpg",1,22,66,18,1,108,2.96296296296296,0.668740284945431,53.0972222222222
"5880272825.jpg",0,2,39,73,2,116,3.64655172413793,0.54779098433503,75.7478448275862
"5880662445.jpg",37,63,2,0,0,102,1.65686274509804,0.516942612040142,17.0540540540541
"5881048001.jpg",0,5,63,44,0,112,3.34821428571429,0.564885724368993,64.3910256410256
"5881856929.jpg",0,22,60,24,0,106,3.0188679245283,0.661616088873754,56.7279411764706
"5884343005.jpg",0,0,34,63,7,104,3.74038461538462,0.57445951478755,73.614224137931
"5884382109.jpg",0,4,73,33,0,110,3.26363636363636,0.518948703114017,63.1217948717949
"5884690824.jpg",0,3,57,44,0,104,3.39423076923077,0.547159819941693,64.1526548672566
"5884745280.jpg",3,38,55,6,0,102,2.62745098039216,0.643652458763498,45.608407079646
"5884906716.jpg",0,2,32,74,1,109,3.67889908256881,0.524946804094263,71.1949152542373
"5885686436.jpg",0,1,43,65,1,110,3.6,0.528108968460873,71.1949152542373
"5886060405.jpg",0,1,45,53,2,101,3.55445544554455,0.556331691075611,71.8125
"5886086971.jpg",0,38,58,6,0,102,2.68627450980392,0.5798666995481,44.9471153846154
"5886709832.jpg",1,3,37,63,2,106,3.58490566037736,0.630463541158059,70.2282608695652
"5887130142.jpg",9,77,18,0,0,104,2.08653846153846,0.504553574148434,28.0070754716981
"5887175840.jpg",10,57,37,1,0,105,2.27619047619048,0.642938537785661,34.4459459459459
"5887936508.jpg",0,4,49,56,0,109,3.47706422018349,0.570839704347729,69.75
"5888106239.jpg",0,1,40,65,0,106,3.60377358490566,0.510447894510187,73.3348214285714
"5889219072.jpg",0,1,53,46,2,102,3.48039215686275,0.55811550238036,68.3871681415929
"5890294263.jpg",0,6,64,35,1,106,3.29245283018868,0.585002745326492,63.6116071428571
"5890423400.jpg",0,5,49,51,2,107,3.46728971962617,0.619155800939241,66.8601694915254
"5890641011.jpg",0,7,64,37,0,108,3.27777777777778,0.577350269189626,64.1238532110092
"5890838382.jpg",1,5,56,41,0,103,3.33009708737864,0.616574177185378,61.375
"5891304676.jpg",1,20,81,13,0,115,2.92173913043478,0.564254298881501,53.2266949152542
"5891409099.jpg",0,2,60,42,1,105,3.4,0.547722557505166,66.4054054054054
"5891437045.jpg",0,4,72,28,1,105,3.24761904761905,0.533150151691889,61.8055555555556
"5891588921.jpg",0,0,29,77,5,111,3.78378378378378,0.511777746601454,75.25
"5892461244.jpg",0,0,29,73,10,112,3.83035714285714,0.567726505294041,75.1101694915254
"5893291303.jpg",0,4,54,47,0,105,3.40952380952381,0.566623570867177,64.1052631578947
"5893652818.jpg",37,60,9,0,0,106,1.73584905660377,0.606345599903975,18.7132352941176
"5894107324.jpg",0,7,51,52,0,110,3.40909090909091,0.610240658580274,65.6602564102564
"5894875244.jpg",0,0,32,66,1,99,3.68686868686869,0.487527385865313,76.6378504672897
"5895424608.jpg",0,47,55,6,1,109,2.64220183486239,0.631326290290066,43.625
"5895477446.jpg",0,0,24,73,6,103,3.8252427184466,0.513106350364809,75.775
"5896106502.jpg",0,1,37,66,9,113,3.73451327433628,0.612630439682677,74.2794117647059
"5897145842.jpg",8,87,13,0,0,108,2.0462962962963,0.440565890544636,28.4067796610169
"5897660924.jpg",0,18,69,19,0,106,3.00943396226415,0.593541157057616,53.892523364486
"5898928772.jpg",0,16,74,14,0,104,2.98076923076923,0.539341008015854,55.4954128440367
"5899300375.jpg",1,57,38,6,0,102,2.48039215686275,0.625060664887306,39.925
"5899684696.jpg",1,42,53,4,0,100,2.6,0.586032715327688,41.7389380530973
"5900853532.jpg",1,22,68,11,1,103,2.89320388349515,0.624854827990632,50.651376146789
"5901488995.jpg",3,61,62,2,0,128,2.4921875,0.575019256781276,41.4055118110236
"5901783769.jpg",0,6,50,48,1,105,3.41904761904762,0.616768133420437,63.7717391304348
"590233260.jpg",0,3,68,36,0,107,3.30841121495327,0.521449629494023,63.4198113207547
"5902359095.jpg",0,3,51,52,4,110,3.51818181818182,0.616766028256536,67.146017699115
"5903525428.jpg",0,3,45,56,0,104,3.50961538461538,0.557302663192804,70.6490384615385
"5903878980.jpg",0,6,47,43,3,99,3.43434343434343,0.657167952340955,67.6939252336449
"5903930781.jpg",0,8,31,64,2,105,3.57142857142857,0.662993544131796,72.7669902912621
"5904145977.jpg",0,1,28,69,2,100,3.72,0.514045157785213,73.2064220183486
"5904148188.jpg",0,24,94,16,0,134,2.94029850746269,0.545124584364857,52.8315217391304
"5904230612.jpg",0,3,42,56,6,107,3.60747663551402,0.640710238952061,70.9040178571429
"5905146921.jpg",0,15,73,12,0,100,2.97,0.521361853052351,53.5275229357798
"5905277829.jpg",1,9,85,20,0,115,3.07826086956522,0.532254821028433,57.0861344537815
"5906203942.jpg",0,20,74,15,0,109,2.95412844036697,0.567406724279621,53.858407079646
"5906327236.jpg",0,1,51,60,0,112,3.52678571428571,0.5191785165493,66.6474358974359
"5906517609.jpg",0,0,44,64,0,108,3.59259259259259,0.493642517690404,69.0986842105263
"5906582267.jpg",0,1,44,60,2,107,3.58878504672897,0.548639329374549,70.975
"5906624117.jpg",0,3,46,43,4,96,3.5,0.632455532033676,69.6432038834951
"5906952351.jpg",0,0,22,74,11,107,3.89719626168224,0.548317829593425,79.2710084033613
"5907004909.jpg",42,55,7,0,0,104,1.66346153846154,0.601140936628686,17.5
"5908187685.jpg",0,36,97,7,0,140,2.79285714285714,0.51588338110299,48.265625
"5909804133.jpg",0,26,67,12,0,105,2.86666666666667,0.589436932534684,48.6418918918919
"5909836930.jpg",0,57,50,2,0,109,2.4954128440367,0.537894613301424,40.6554621848739
"5910545670.jpg",10,68,22,1,0,101,2.13861386138614,0.583604368905803,30.390625
"5910732650.jpg",17,66,14,1,0,98,1.98979591836735,0.600599321969463,25.2201834862385
"5912070942.jpg",0,2,54,46,2,104,3.46153846153846,0.573239422405291,69.2706422018349
"5912436872.jpg",0,5,54,43,1,103,3.38834951456311,0.597921394740962,66.4054054054054
"5912451823.jpg",0,3,49,51,4,107,3.52336448598131,0.619582854077224,69.3881578947368
"5912584970.jpg",0,0,46,59,0,105,3.56190476190476,0.498532645405292,68.8652173913043
"5913086401.jpg",14,70,19,0,0,103,2.04854368932039,0.566700819790268,26.725
"5913526574.jpg",0,0,31,73,2,106,3.72641509433962,0.488594073759443,74.5291262135922
"5914023763.jpg",0,0,26,73,7,106,3.82075471698113,0.530896273813413,76.1826086956522
"5914304035.jpg",0,8,69,25,0,102,3.16666666666667,0.546516118688917,58.8986486486486
"5914413530.jpg",1,2,50,54,1,108,3.48148148148148,0.603440005945376,66.9269911504425
"5914417617.jpg",0,0,51,61,1,113,3.55752212389381,0.516479378259072,70.1890756302521
"5914426709.jpg",0,1,56,43,2,102,3.45098039215686,0.556286324530138,64.8050458715596
"5914848066.jpg",0,2,26,77,6,111,3.78378378378378,0.562549479123318,74.1313559322034
"5914999740.jpg",0,5,70,23,0,98,3.18367346938776,0.504555306410521,58.6013513513514
"5915008700.jpg",1,19,68,15,0,103,2.94174757281553,0.60755444714367,51.7635135135135
"5915252762.jpg",1,47,53,3,0,104,2.55769230769231,0.571608581483598,41.3660714285714
"5916873718.jpg",1,30,59,16,0,106,2.84905660377358,0.673193566307551,51.4575892857143
"5917296642.jpg",16,66,25,1,0,108,2.10185185185185,0.640382695377221,27.5665137614679
"5919030075.jpg",1,38,60,6,0,105,2.67619047619048,0.596387169276516,42.5369565217391
"5919706356.jpg",1,23,64,11,0,99,2.85858585858586,0.606261562231019,47.287610619469
"5920168142.jpg",1,0,21,78,5,105,3.81904761904762,0.550890055709715,77.5630841121495
"5920736883.jpg",1,12,96,27,0,136,3.09558823529412,0.556159802116439,58.2852112676056
"5920883206.jpg",0,5,68,29,0,102,3.23529411764706,0.529832228036428,61.7433628318584
"5921291430.jpg",0,7,53,49,1,110,3.4,0.62369129037375,64.0635593220339
"5921674068.jpg",0,1,70,33,1,105,3.32380952380952,0.509434794182543,62.7327586206897
"5922077897.jpg",0,6,53,37,1,97,3.34020618556701,0.610440379598756,65.5857142857143
"5922538133.jpg",2,30,65,2,0,99,2.67676767676768,0.550107277632037,44.9747706422018
"5922588235.jpg",0,1,36,60,6,103,3.68932038834951,0.594568985650855,72.0657894736842
"5923029266.jpg",0,2,51,57,0,110,3.5,0.537578669301595,67.9491150442478
"5923067948.jpg",0,0,39,60,4,103,3.66019417475728,0.552239612285735,72.2629310344828
"5924110639.jpg",0,55,71,2,0,128,2.5859375,0.525377161111256,44.0178571428571
"5925110976.jpg",5,78,26,0,0,109,2.19266055045872,0.499575082782089,31.9551282051282
"5925314446.jpg",0,2,38,53,8,101,3.66336633663366,0.652337761022191,72.6816037735849
"5925658885.jpg",0,15,86,20,0,121,3.04132231404959,0.538465322542935,55.65625
"5926348208.jpg",0,13,55,35,0,103,3.21359223300971,0.651551473248295,59.1183035714286
"5927112319.jpg",0,2,46,49,2,99,3.51515151515152,0.577885596397065,70.2847222222222
"5928144781.jpg",0,1,19,81,4,105,3.83809523809524,0.482856275873249,81.6320754716981
"5930701704.jpg",0,6,57,43,0,106,3.34905660377358,0.586230132451472,63.2219626168224
"5930876150.jpg",0,7,70,28,0,105,3.2,0.544200189409969,57.9676724137931
"5932454750.jpg",1,6,47,45,1,100,3.39,0.665073854788498,64.675
"5932521378.jpg",4,70,30,2,0,106,2.28301886792453,0.564922531244132,33.8613445378151
"5932591132.jpg",47,46,15,0,0,108,1.7037037037037,0.700590662137317,18.5131578947368
"5932756634.jpg",0,2,58,45,0,105,3.40952380952381,0.531602043450486,64.8478260869565
"5933359823.jpg",0,15,77,16,0,108,3.00925925925926,0.538175706470443,53.3947368421053
"5933439918.jpg",0,19,78,8,0,105,2.8952380952381,0.498532645405292,51.9009433962264
"5934416034.jpg",0,2,49,51,4,106,3.5377358490566,0.604341882142988,67.5021739130435
"5935217683.jpg",0,7,56,39,0,102,3.31372549019608,0.596697049969938,60.6482300884956
"5935609907.jpg",0,3,75,28,0,106,3.23584905660377,0.488961714198037,62.6540178571429
"5935910099.jpg",0,3,57,37,2,99,3.38383838383838,0.583918339046576,65.125
"5936087565.jpg",0,12,63,26,0,101,3.13861386138614,0.600494845444939,58.825
"5936297940.jpg",0,0,45,61,1,107,3.58878504672897,0.513097714553428,73.3918918918919
"5936466945.jpg",0,19,78,13,0,110,2.94545454545455,0.539050535262052,52.1351351351351
"5936518143.jpg",0,2,62,45,1,110,3.40909090909091,0.546808161946805,65.3938053097345
"5936667753.jpg",2,46,56,5,0,109,2.58715596330275,0.611782598373346,42.25
"5937141958.jpg",0,2,67,39,0,108,3.34259259259259,0.514500702288051,65.1184210526316
"5938961229.jpg",0,4,80,26,0,110,3.2,0.484626026252306,59.5602678571429
"5939994525.jpg",1,44,55,2,0,102,2.56862745098039,0.554188442797278,42.1776315789474
"594061158.jpg",0,0,22,77,6,105,3.84761904761905,0.495769649925795,77.2586956521739
"5941719690.jpg",0,2,48,53,0,103,3.49514563106796,0.540039693671242,68.125
"5941759615.jpg",5,65,33,2,0,105,2.3047619047619,0.590368358344854,33.7847826086957
"5942438965.jpg",0,22,79,11,0,112,2.90178571428571,0.536250268125201,52.1217948717949
"5943227958.jpg",0,1,33,67,5,106,3.71698113207547,0.564922531244132,75.25
"5944469044.jpg",0,12,56,36,1,105,3.24761904761905,0.661887632529297,61.045652173913
"5945639421.jpg",1,19,61,22,2,105,3.04761904761905,0.712268213053206,56.171875
"5946379420.jpg",0,10,74,11,1,96,3.03125,0.512026417903978,54.4247572815534
"5947239727.jpg",0,3,55,39,1,98,3.38775510204082,0.56773474751014,62.2544247787611
"5948128813.jpg",0,1,53,74,1,129,3.58139534883721,0.525857549903677,72.9548872180451
"5948378050.jpg",0,14,62,27,0,103,3.12621359223301,0.621188166536366,60.2428571428571
"5948782020.jpg",20,70,14,2,0,106,1.9811320754717,0.632171346203991,25.8193277310924
"5949374499.jpg",0,0,27,74,5,106,3.79245283018868,0.511151475677369,77.2076271186441
"5950051723.jpg",0,2,33,67,2,104,3.66346153846154,0.550561530172921,75.4117647058823
"5950379360.jpg",0,3,40,59,8,110,3.65454545454545,0.655762930372485,71.7347826086957
"5950764081.jpg",0,1,40,62,1,104,3.60576923076923,0.529118505469683,70.8739130434783
"5951267818.jpg",1,2,42,60,1,106,3.54716981132075,0.603672498276344,69.656779661017
"5952909406.jpg",0,15,62,23,0,100,3.08,0.61430752671096,54.7345132743363
"5952914370.jpg",0,0,8,71,21,100,4.13,0.525222415609412,86.35
"5952945336.jpg",0,0,56,54,1,111,3.5045045045045,0.520032759000883,67.6991525423729
"5952977231.jpg",0,2,57,44,2,105,3.43809523809524,0.570489154548862,67.1527777777778
"5955759351.jpg",1,34,66,6,0,107,2.7196261682243,0.579433564058746,46.7563025210084
"5955805991.jpg",0,0,27,79,2,108,3.76851851851852,0.465772024807321,76.5084745762712
"5955821366.jpg",0,3,68,35,1,107,3.31775700934579,0.542498253907659,63.6029411764706
"5956264742.jpg",0,10,42,53,5,110,3.48181818181818,0.726078042938244,65.6016949152542
"5956532834.jpg",29,67,5,0,0,101,1.76237623762376,0.531949524889066,19.7706422018349
"5956733523.jpg",0,7,68,29,1,105,3.22857142857143,0.576079970028582,60.4441964285714
"5957529687.jpg",0,1,32,75,3,111,3.72072072072072,0.525204222983285,72.5233050847458
"5958225311.jpg",0,1,40,70,4,115,3.6695652173913,0.557590982748749,71.1961206896552
"5958527369.jpg",0,1,27,78,5,111,3.78378378378378,0.529243120029236,76.1588983050847
"5958950790.jpg",7,68,32,1,0,108,2.25,0.582052443280648,33.3067226890756
"5959178118.jpg",0,23,61,20,0,104,2.97115384615385,0.645473120212687,55.1102941176471
"5959274849.jpg",2,33,56,18,0,109,2.8256880733945,0.718074027665874,47.26875
"5959668491.jpg",0,1,37,59,6,103,3.67961165048544,0.597602927930226,72.4051724137931
"5960283649.jpg",0,48,56,7,0,111,2.63063063063063,0.601935181166513,43.7625
"5961150371.jpg",0,1,16,72,23,112,4.04464285714286,0.620786958526392,83.1504237288136
"5961872098.jpg",47,50,4,0,0,101,1.57425742574257,0.57177853498475,13.1924778761062
"5962747.jpg",20,73,16,0,0,109,1.96330275229358,0.576172002106032,25.8181818181818
"5963098166.jpg",7,55,43,3,0,108,2.38888888888889,0.653292642893341,37.0394736842105
"5963776272.jpg",7,85,11,3,0,106,2.09433962264151,0.526050909844691,29.8403361344538
"5964504987.jpg",0,2,40,61,2,105,3.6,0.565005105490888,70.0130434782609
"5964655534.jpg",0,28,67,8,0,103,2.80582524271845,0.561130728663719,49.7039473684211
"5965102816.jpg",0,1,33,70,1,105,3.67619047619048,0.509434794182543,75.9779411764706
"5965133754.jpg",1,24,62,17,0,104,2.91346153846154,0.655233996934956,52.6792452830189
"5965181934.jpg",0,6,65,34,0,105,3.26666666666667,0.559303596287842,61.5257009345794
"5965591233.jpg",5,48,47,5,0,105,2.4952380952381,0.666849791698734,40.7281553398058
"596587243.jpg",0,5,52,48,1,106,3.42452830188679,0.600763216291175,65.4217391304348
"5966496820.jpg",0,0,44,61,0,105,3.58095238095238,0.495769649925795,70.2702702702703
"5966712198.jpg",0,8,70,27,0,105,3.18095238095238,0.550890055709715,58.8922413793103
"5966778623.jpg",4,59,35,2,0,100,2.35,0.592461054424762,36.25
"5967167167.jpg",0,4,54,47,0,105,3.40952380952381,0.566623570867177,65.4934782608696
"5967293937.jpg",0,8,54,43,2,107,3.36448598130841,0.65000033910711,61.5
"5968252137.jpg",0,5,61,40,0,106,3.33018867924528,0.56436560445306,64.997572815534
"5968485889.jpg",0,0,11,95,4,110,3.93636363636364,0.365414750591651,76.2899159663866
"5968558261.jpg",0,1,35,67,2,105,3.66666666666667,0.531085004543794,73.9473684210526
"5969471767.jpg",0,18,79,4,0,101,2.86138613861386,0.447877281636321,48.9105504587156
"5970029392.jpg",0,5,59,43,0,107,3.35514018691589,0.570539903993596,64.1575630252101
"5971260303.jpg",0,6,69,24,0,99,3.18181818181818,0.522232967867094,60.4
"5971597371.jpg",0,1,36,69,2,108,3.66666666666667,0.529503382213656,73.3918918918919
"5971762123.jpg",0,0,42,63,1,106,3.61320754716981,0.508419675108798,71.8616071428571
"5973089672.jpg",0,1,29,64,7,101,3.76237623762376,0.585636659567776,73.9633027522936
"5973209084.jpg",38,66,5,0,0,109,1.69724770642202,0.552847630806364,19.9470338983051
"5973304617.jpg",0,7,48,55,2,112,3.46428571428571,0.642749883801945,65.995652173913
"5974147290.jpg",26,67,10,1,0,104,1.86538461538462,0.608319223614763,23.1486486486486
"5974719661.jpg",25,60,23,0,0,108,1.98148148148148,0.669516236030214,27.0084745762712
"5974844404.jpg",0,2,49,48,4,103,3.52427184466019,0.607867700295262,67.5202702702703
"5975565227.jpg",0,29,74,9,0,112,2.82142857142857,0.556926664981405,48.5423728813559
"5976052920.jpg",0,8,66,28,2,104,3.23076923076923,0.611075277500422,59.3340707964602
"5976377870.jpg",0,13,75,17,0,105,3.03809523809524,0.535720390685605,55.3310810810811
"5977841815.jpg",0,0,12,78,19,109,4.06422018348624,0.531859584605752,82.5673913043478
"5977893194.jpg",0,17,59,31,0,107,3.13084112149533,0.659961579063691,59.6907894736842
"5979005595.jpg",0,2,31,104,3,140,3.77142857142857,0.499537298754423,78.7534246575343
"5979159909.jpg",0,2,52,53,0,107,3.47663551401869,0.538092269434313,65.453125
"5979161459.jpg",0,8,67,34,0,109,3.23853211009174,0.575729530261347,61.1071428571429
"5980068668.jpg",0,1,50,52,2,105,3.52380952380952,0.556348640264187,68.2913043478261
"5980262015.jpg",1,39,65,9,0,114,2.71929824561404,0.616997754328533,46.2710084033613
"5982393408.jpg",0,0,11,85,11,107,4,0.45557345160942,85.0608108108108
"5984121563.jpg",32,70,5,1,0,108,1.76851851851852,0.573666376741214,19.5804347826087
"5984140443.jpg",0,5,50,51,0,106,3.43396226415094,0.585846850205561,65.5398230088496
"5985353334.jpg",0,4,62,34,0,100,3.3,0.541229427257326,64.5022935779816
"5986724634.jpg",0,3,57,48,2,110,3.44545454545455,0.583981331176464,66.4159292035398
"5987364665.jpg",0,2,77,28,1,108,3.25925925925926,0.49991345737711,62.9135514018692
"5987384542.jpg",0,0,18,66,18,102,4,0.597022314125993,82.8188073394495
"5987658762.jpg",0,4,48,48,1,101,3.45544554455446,0.592026223663235,69.0625
"5990072932.jpg",0,2,76,32,0,110,3.27272727272727,0.486686812414118,61.7820512820513
"5991710179.jpg",0,4,79,23,0,106,3.17924528301887,0.474033750281675,60.0878378378378
"5992863973.jpg",0,0,38,63,5,106,3.68867924528302,0.558283211063718,73.8378378378378
"5993545370.jpg",0,1,36,66,0,103,3.63106796116505,0.504689601017511,72.4026548672566
"5993869890.jpg",0,1,17,80,7,105,3.88571428571429,0.506007861642441,75.6216216216216
"5993929800.jpg",0,0,6,97,7,110,4.00909090909091,0.345228405856435,79.9642857142857
"5994198578.jpg",0,2,30,70,1,103,3.67961165048544,0.527918447226235,70.9487179487179
"5994370430.jpg",0,1,45,53,3,102,3.56862745098039,0.571775139655522,67.9956896551724
"5995040588.jpg",0,0,9,84,7,100,3.98,0.401512292728531,80.9556074766355
"5995083892.jpg",0,15,61,29,0,105,3.13333333333333,0.636496822559394,58.527027027027
"5995809590.jpg",1,30,64,8,0,103,2.76699029126214,0.597443630865439,49.125
"5996266717.jpg",1,3,58,76,2,140,3.53571428571429,0.604666675353999,72.1986301369863
"5996293393.jpg",0,2,41,56,1,100,3.56,0.55632270266002,68.8922018348624
"5996648026.jpg",0,5,64,33,0,102,3.27450980392157,0.54784659891482,61.2477064220183
"5996831643.jpg",2,65,41,0,0,108,2.36111111111111,0.519855000152735,36.4470338983051
"5997968998.jpg",0,3,73,29,0,105,3.24761904761905,0.495769649925795,63.325
"5998921543.jpg",10,73,27,1,0,111,2.17117117117117,0.585799746638169,31.510775862069
"5999140032.jpg",6,31,57,6,2,102,2.67647058823529,0.759908341344662,43.7920560747664
"5999303076.jpg",1,40,60,2,0,103,2.61165048543689,0.54652215405893,42.0309734513274
"5999450318.jpg",2,32,63,14,0,111,2.8018018018018,0.671765919997026,49.1602564102564
"5999962453.jpg",0,0,11,81,8,100,3.97,0.437047023797327,81.0022935779816
"6000347443.jpg",0,2,61,76,0,139,3.53237410071942,0.528905874661932,70.7347972972973
"6000377344.jpg",2,34,61,11,0,108,2.75,0.657451892273652,48.6928571428571
"6000772290.jpg",0,0,19,78,8,105,3.8952380952381,0.498532645405292,78.1486486486486
"6000896987.jpg",0,1,53,44,2,100,3.47,0.55876848714134,66.6915887850467
"6001045244.jpg",0,0,23,75,12,110,3.9,0.557681965202324,75.3886554621849
"6001214984.jpg",0,4,58,43,1,106,3.38679245283019,0.578516241974426,63.4439655172414
"6001258616.jpg",0,1,58,44,0,103,3.41747572815534,0.514958057394668,64.5691964285714
"6001444866.jpg",9,83,17,1,0,110,2.09090909090909,0.516613079807823,29.1470588235294
"6001560793.jpg",5,29,57,15,0,106,2.77358490566038,0.746841206656721,48.2352941176471
"6001836316.jpg",2,45,47,9,2,105,2.65714285714286,0.744577467021132,44.6764705882353
"6002391220.jpg",0,6,42,57,2,107,3.51401869158878,0.634904330652494,70.2214285714286
"6002788833.jpg",0,2,59,44,1,106,3.41509433962264,0.549769207478433,67.2426470588235
"6003444578.jpg",0,1,20,70,11,102,3.8921568627451,0.578609852395438,80.65
"6003830397.jpg",7,71,28,0,0,106,2.19811320754717,0.541950820484571,32.0588235294118
"6003925442.jpg",8,70,19,1,0,98,2.13265306122449,0.549371808111076,29.9128440366972
"6004179446.jpg",1,11,59,30,0,101,3.16831683168317,0.649142618084702,58.15
"6004662053.jpg",0,0,45,57,1,103,3.57281553398058,0.516434642668834,71.9934210526316
"6005119430.jpg",1,12,70,16,0,99,3.02020202020202,0.571067707122655,56.0266990291262
"6006544496.jpg",0,28,63,13,0,104,2.85576923076923,0.614047043369844,49.1973684210526
"6007032209.jpg",19,82,11,1,0,113,1.94690265486726,0.548385747388932,25.4033613445378
"6008172185.jpg",0,10,58,38,3,109,3.31192660550459,0.676281331257795,63.186974789916
"6008267730.jpg",5,72,26,1,0,104,2.22115384615385,0.538908115251656,31.25
"6010335101.jpg",0,1,35,72,3,111,3.69369369369369,0.535856032103481,73.4247787610619
"6011182310.jpg",13,72,23,3,0,111,2.14414414414414,0.644513161539169,30.4955752212389
"6011321842.jpg",0,1,75,26,0,102,3.24509803921569,0.454597515593999,62.2
"6011443641.jpg",15,69,22,0,0,106,2.06603773584906,0.589896971222672,27.1012931034483
"6012494248.jpg",4,61,31,1,0,97,2.29896907216495,0.562082223626436,32.9882075471698
"6013203590.jpg",6,73,28,0,0,107,2.20560747663551,0.527334302993257,31.5472972972973
"6014996044.jpg",22,76,8,0,0,106,1.86792452830189,0.517787816408617,21.9478260869565
"6015032576.jpg",2,38,55,9,0,104,2.68269230769231,0.657509615669258,44.777027027027
"6015497423.jpg",0,6,68,31,0,105,3.23809523809524,0.5463833805441,62.5803571428571
"6015802455.jpg",0,1,27,82,1,111,3.74774774774775,0.476129632242551,72.15625
"6015806731.jpg",0,0,13,84,15,112,4.01785714285714,0.50192678941306,80.7021739130435
"6015956857.jpg",2,18,69,10,0,99,2.87878787878788,0.593721010424024,51.0298165137615
"6016351794.jpg",0,1,39,64,3,107,3.64485981308411,0.553757941271021,70.4258474576271
"6016403844.jpg",0,1,12,64,30,107,4.14953271028037,0.641397917843739,83.6375
"6018292739.jpg",0,2,13,76,11,102,3.94117647058824,0.559765322322265,82.825
"6018448805.jpg",2,47,56,0,0,105,2.51428571428571,0.53912831557927,41.128640776699
"6018954377.jpg",1,11,69,27,1,109,3.14678899082569,0.635751058800978,59.1625
"6019043810.jpg",0,29,65,8,0,102,2.79411764705882,0.568796458994521,49.4305555555556
"6019255824.jpg",0,26,73,7,0,106,2.82075471698113,0.530896273813413,47.8223684210526
"6019634729.jpg",0,2,52,45,1,100,3.45,0.557320429022713,65.2591743119266
"6019945837.jpg",1,27,63,13,0,104,2.84615384615385,0.635048056727989,49.4423076923077
"6021031344.jpg",0,1,42,63,1,107,3.5981308411215,0.529503382213656,70.5044247787611
"6021411453.jpg",0,13,74,23,0,110,3.09090909090909,0.567393113976683,55.5338983050847
"6021481506.jpg",1,70,34,2,0,107,2.34579439252336,0.53381510010521,36.3571428571429
"6022378177.jpg",0,34,60,9,1,104,2.77884615384615,0.637908152521211,46.9539473684211
"6022545118.jpg",2,32,54,12,0,100,2.76,0.683425714376264,45.8073394495413
"6022867548.jpg",0,18,92,25,0,135,3.05185185185185,0.564080529321814,56.9821428571429
"6024552297.jpg",28,65,17,1,0,111,1.91891891891892,0.662435384638108,23.775641025641
"6024842797.jpg",5,55,43,1,0,104,2.38461538461538,0.596229126278775,36.9203539823009
"6025425827.jpg",0,40,56,8,0,104,2.69230769230769,0.608626068135469,45.3347826086957
"6026252669.jpg",0,7,74,25,0,106,3.16981132075472,0.525025135238804,60.3365384615385
"6026326925.jpg",0,1,69,39,1,110,3.36363636363636,0.519831884032117,62.6323529411765
"6026481577.jpg",4,34,62,2,0,102,2.6078431372549,0.599618075558597,43.4391891891892
"6027079771.jpg",9,59,40,2,0,110,2.31818181818182,0.648665789207668,35.6205357142857
"6027104916.jpg",0,5,36,56,3,100,3.57,0.639681107421439,68.8165137614679
"6027592169.jpg",0,22,73,10,0,105,2.88571428571429,0.542683604419273,49.7289719626168
"6027700445.jpg",2,32,61,12,0,107,2.77570093457944,0.663160119185679,47.8482142857143
"6028150139.jpg",12,60,29,2,0,103,2.20388349514563,0.662130004724368,33.5330188679245
"6028637115.jpg",5,48,45,4,0,102,2.47058823529412,0.655606171823823,40.4428571428571
"6029121560.jpg",0,1,48,58,0,107,3.53271028037383,0.519756056883325,71.7879464285714
"6029275021.jpg",0,3,40,55,1,99,3.54545454545455,0.576278122917761,68.0221238938053
"6030228496.jpg",0,0,21,83,3,107,3.83177570093458,0.444801870423548,79.7094594594595
"6030949586.jpg",0,16,68,21,1,106,3.06603773584906,0.621348271706714,56.3108695652174
"6031428768.jpg",0,0,28,69,9,106,3.82075471698113,0.565637774237369,76.7697368421053
"6031659162.jpg",0,0,48,58,3,109,3.58715596330275,0.547908636177939,70.0663716814159
"6031843630.jpg",0,0,37,72,4,113,3.70796460176991,0.52917415323319,73.3781512605042
"6032331327.jpg",0,14,63,29,0,106,3.14150943396226,0.623945651559997,58.3195652173913
"6033104227.jpg",0,1,26,72,6,105,3.79047619047619,0.549391938265845,74.3738938053097
"6034206796.jpg",0,4,57,40,0,101,3.35643564356436,0.558285919862602,63.4198113207547
"6034305010.jpg",23,63,20,0,0,106,1.97169811320755,0.639308363926894,26.7075892857143
"6035124340.jpg",0,0,30,70,3,103,3.7378640776699,0.504123487994673,73.7767857142857
"6035849303.jpg",0,3,64,44,0,111,3.36936936936937,0.538143744364542,64.3910256410256
"6036947560.jpg",0,0,21,79,3,103,3.8252427184466,0.45216655932624,78.5353982300885
"6037494854.jpg",0,16,72,19,0,107,3.02803738317757,0.573929584880092,54.9933035714286
"6038209414.jpg",0,3,43,54,2,102,3.53921568627451,0.59155054900552,67.7638888888889
"6038295974.jpg",1,31,64,11,0,107,2.79439252336449,0.625530985869761,49.1134453781513
"6038701648.jpg",9,60,30,0,0,99,2.21212121212121,0.593721010424024,32.3194444444444
"6039555736.jpg",0,1,22,80,4,107,3.81308411214953,0.497746641649642,77.3310810810811
"6039986831.jpg",0,14,89,45,4,152,3.25657894736842,0.656064026579015,63.8996815286624
"6040260022.jpg",2,59,35,7,0,103,2.45631067961165,0.653447854545654,38.3252427184466
"6041797981.jpg",0,2,73,34,0,109,3.29357798165138,0.496333823848313,64.8411214953271
"6042672092.jpg",0,22,64,13,0,99,2.90909090909091,0.590587896150757,51.1168224299065
"6043711166.jpg",0,3,54,53,1,111,3.46846846846847,0.569207101147486,68.8877118644068
"6044839741.jpg",0,3,41,61,1,106,3.56603773584906,0.569358334309913,70.2702702702703
"6044933517.jpg",0,0,22,80,3,105,3.81904761904762,0.45533065713392,77.777027027027
"6045595814.jpg",0,7,49,45,1,102,3.3921568627451,0.631779864298186,66.0917431192661
"6045753888.jpg",0,10,57,39,2,108,3.30555555555556,0.662173330970994,64.0066371681416
"6046652289.jpg",0,0,34,64,4,102,3.70588235294118,0.537471809882315,73.0911214953271
"6046933267.jpg",0,1,23,81,5,110,3.81818181818182,0.510114543384925,77.0833333333333
"6047228959.jpg",1,7,50,43,1,102,3.35294117647059,0.669669030467229,65.6514423076923
"6048178491.jpg",6,57,34,2,0,99,2.32323232323232,0.619879560854329,32.3938053097345
"6048377722.jpg",0,2,37,58,5,102,3.64705882352941,0.607658365839589,74.2569444444444
"6050570749.jpg",2,45,70,6,0,123,2.65040650406504,0.600324227115871,45.5909090909091
"6051776132.jpg",0,0,24,73,10,107,3.86915887850467,0.550884574245936,77.6592920353982
"6052522172.jpg",0,5,53,52,0,110,3.42727272727273,0.581978449569343,65.4875
"6052669253.jpg",0,4,49,48,0,101,3.43564356435644,0.572989381824104,65.4722222222222
"6052980564.jpg",0,5,37,61,5,108,3.61111111111111,0.653292642893341,68.7331932773109
"6052981024.jpg",0,8,44,54,1,107,3.44859813084112,0.647690306554005,66.925
"6053711143.jpg",1,15,70,19,0,105,3.01904761904762,0.604167456106596,53.9189189189189
"6054384333.jpg",1,13,48,39,2,103,3.27184466019417,0.74352333926053,62.1285714285714
"6055173386.jpg",0,4,42,57,3,106,3.55660377358491,0.618449500255742,69.6985981308411
"6056249968.jpg",0,32,65,11,1,109,2.8256880733945,0.636018237236307,48.64375
"6059213593.jpg",0,4,59,42,1,106,3.37735849056604,0.576571644062338,61.8793103448276
"6059364561.jpg",0,2,33,63,3,101,3.66336633663366,0.570565118505719,72.0934782608696
"6059439026.jpg",1,5,55,46,6,113,3.45132743362832,0.706995029817823,65.9423076923077
"6059676315.jpg",0,4,47,52,5,108,3.53703703703704,0.647438171203495,69.972972972973
"6060968148.jpg",0,8,57,44,3,112,3.375,0.659306214656501,65.2521186440678
"6061284714.jpg",0,1,38,62,3,104,3.64423076923077,0.555960975629318,74.5291262135922
"6061619361.jpg",1,34,60,9,0,104,2.74038461538462,0.623102047271884,47.5882352941176
"6062434084.jpg",0,19,75,9,0,103,2.90291262135922,0.514773186429315,51.6
"6063249330.jpg",0,25,50,29,3,107,3.09345794392523,0.783469669018019,58.825
"6063545051.jpg",2,31,60,11,0,104,2.76923076923077,0.657012497565065,46.5959821428571
"6064738730.jpg",0,4,39,63,1,107,3.57009345794393,0.584584185920639,71.9338235294118
"6065678020.jpg",0,6,44,51,4,105,3.5047619047619,0.666849791698734,69.6756756756757
"6065704403.jpg",0,3,55,50,2,110,3.46363636363636,0.585407765473404,67.7432432432432
"6066096952.jpg",1,11,74,23,0,109,3.09174311926605,0.585966823793358,56.2894736842105
"6066179576.jpg",0,19,76,14,0,109,2.95412844036697,0.550846505152943,54.1907894736842
"6066562802.jpg",0,3,45,56,1,105,3.52380952380952,0.573371239908821,69.3228155339806
"6067571211.jpg",0,4,52,50,1,107,3.44859813084112,0.586541588543228,66.2373949579832
"6067656779.jpg",0,0,37,68,4,109,3.69724770642202,0.535837647398623,73.781779661017
"6068598546.jpg",0,4,57,42,0,103,3.36893203883495,0.559942070920715,62.6857798165138
"6068776554.jpg",0,7,62,38,0,107,3.28971962616822,0.582922788414288,61.2323008849558
"6070920773.jpg",0,0,19,86,6,111,3.88288288288288,0.461986594428468,80.2284482758621
"6070993297.jpg",0,13,96,17,0,126,3.03174603174603,0.488860028008148,57.3095238095238
"6071037995.jpg",21,67,15,0,0,103,1.94174757281553,0.591197566898576,25.9709821428571
"6071930227.jpg",29,75,4,1,0,109,1.78899082568807,0.54557809121954,21.14375
"6072006649.jpg",1,8,57,64,0,130,3.41538461538462,0.64441085869206,67.6823308270677
"6072373526.jpg",0,0,50,54,0,104,3.51923076923077,0.502049570731066,69.8528037383178
"6072752880.jpg",0,3,51,50,0,104,3.45192307692308,0.55528891618072,67
"6073381897.jpg",0,1,36,72,1,110,3.66363636363636,0.511828395971184,73.1346153846154
"6073506056.jpg",0,2,44,53,7,106,3.61320754716981,0.640992604028072,71.2648305084746
"6074442813.jpg",0,3,67,36,2,108,3.34259259259259,0.566379500873785,65.0460526315789
"6074911475.jpg",0,24,70,8,0,102,2.84313725490196,0.540353716921064,49.15
"6075825527.jpg",0,11,63,29,1,104,3.19230769230769,0.624374219953223,62.3088235294118
"6077061574.jpg",0,2,51,57,1,111,3.51351351351351,0.553745344570866,68.468220338983
"6077250722.jpg",0,4,75,27,2,108,3.25,0.549000791583107,60.429203539823
"6077930890.jpg",8,66,26,1,0,101,2.1980198019802,0.583434691807027,30.1041666666667
"6078173140.jpg",1,0,35,65,4,105,3.67619047619048,0.596387169276516,71.7142857142857
"6078472527.jpg",0,4,69,32,0,105,3.26666666666667,0.523792873528243,61.3053097345133
"6079223986.jpg",0,3,66,39,0,108,3.33333333333333,0.529503382213656,63.364406779661
"6080237953.jpg",0,7,71,25,0,103,3.1747572815534,0.531870256662233,59.506880733945
"6080350914.jpg",0,0,27,75,5,107,3.79439252336449,0.509130182355242,76.5022321428571
"6080905239.jpg",0,0,19,77,6,102,3.87254901960784,0.480749592657772,79.5575221238938
"6081414146.jpg",0,12,76,19,0,107,3.06542056074766,0.536779847310727,58.5913461538462
"6082438802.jpg",1,1,38,65,0,105,3.59047619047619,0.566623570867177,69.8986486486486
"6084731334.jpg",1,51,45,5,0,102,2.52941176470588,0.608616062833893,38.9197247706422
"6087235314.jpg",0,13,83,15,0,111,3.01801801801802,0.504200212433369,55.3310810810811
"6087381283.jpg",0,6,55,45,0,106,3.36792452830189,0.590810124975516,64.0635593220339
"6087844508.jpg",0,2,42,61,4,109,3.61467889908257,0.591737192678284,71.891592920354
"6088173087.jpg",0,1,54,50,0,105,3.46666666666667,0.520108469949126,68.2014563106796
"6088627872.jpg",0,2,36,68,4,110,3.67272727272727,0.576434642795271,72.1995798319328
"6088697532.jpg",0,16,73,19,1,109,3.04587155963303,0.599155595646713,55.5825892857143
"6088929536.jpg",0,1,35,88,4,128,3.7421875,0.521144919920606,78.1732283464567
"6090586494.jpg",0,0,47,64,0,111,3.57657657657658,0.496342065873372,70.3846153846154
"6091930648.jpg",0,5,44,57,3,109,3.53211009174312,0.631998701057173,68.8718487394958
"6092043977.jpg",1,3,48,52,3,107,3.49532710280374,0.649728996853956,68.1785714285714
"6092350487.jpg",0,0,49,57,0,106,3.5377358490566,0.500942507905264,70.5675675675676
"6092502687.jpg",1,16,89,5,0,111,2.88288288288288,0.461986594428468,51.9224137931034
"6093133362.jpg",2,31,45,26,1,105,2.93333333333333,0.811772356621214,51.9935344827586
"6093527262.jpg",0,1,21,72,8,102,3.85294117647059,0.552170493535534,74.795871559633
"6094279767.jpg",0,11,60,33,0,104,3.21153846153846,0.618062693949391,60.6651785714286
"6095610288.jpg",4,60,37,7,0,108,2.43518518518519,0.673575314054563,37.7964601769912
"6095633645.jpg",5,59,40,5,0,109,2.41284403669725,0.655616887540276,38.125
"6096610009.jpg",0,2,56,49,1,108,3.4537037037037,0.553396635896595,67.489406779661
"6096713881.jpg",1,53,46,4,0,104,2.50961538461538,0.591118608959406,40.4077669902913
"6098070477.jpg",0,6,58,42,0,106,3.33962264150943,0.58369581857791,64.9932432432432
"6098120607.jpg",34,85,20,2,0,141,1.9290780141844,0.661657983196347,23.7989864864865
"6098553690.jpg",5,42,55,6,0,108,2.57407407407407,0.672611088746493,41.3008849557522
"6098945608.jpg",0,1,29,73,7,110,3.78181818181818,0.564741041277403,74.7478260869565
"6098953309.jpg",0,5,65,28,1,99,3.25252525252525,0.559581373109678,63.1084905660377
"6099389158.jpg",6,61,36,2,0,105,2.32380952380952,0.612297660381309,36.4605263157895
"6100280225.jpg",0,15,61,23,0,99,3.08080808080808,0.617380372230659,55.2683486238532
"6100334587.jpg",0,14,70,25,1,110,3.11818181818182,0.616766028256536,57.7628205128205
"6102774302.jpg",0,10,74,26,0,110,3.14545454545455,0.555809412856166,58.1260504201681
"6103897334.jpg",22,76,7,0,0,105,1.85714285714286,0.508174928781181,22.2879464285714
"6104666546.jpg",0,5,62,51,2,120,3.41666666666667,0.602283237388536,66.5805084745763
"610496828.jpg",0,0,24,70,7,101,3.83168316831683,0.530458423077494,75.6319444444444
"6105670251.jpg",0,3,17,86,6,112,3.84821428571429,0.54043395023708,75.739406779661
"6106078585.jpg",0,1,62,31,1,95,3.33684210526316,0.517985589132277,65.0168269230769
"6106478357.jpg",0,8,79,20,0,107,3.11214953271028,0.501452659661762,58.4703389830508
"6106890458.jpg",0,8,71,28,0,107,3.18691588785047,0.551684232925323,58.95625
"6107208468.jpg",0,3,58,44,0,105,3.39047619047619,0.545880342186223,65.0630434782609
"6107409429.jpg",0,14,71,19,0,104,3.04807692307692,0.563963224241827,53.1794871794872
"6107838272.jpg",1,35,68,8,0,112,2.74107142857143,0.596469126003533,48.5086206896552
"6109808754.jpg",0,1,27,78,3,109,3.76146788990826,0.507336592353515,75.8093220338983
"6110951544.jpg",0,3,14,70,13,100,3.93,0.623690547459154,77.0022123893805
"6111148526.jpg",6,79,13,0,0,98,2.07142857142857,0.436716898556188,27.6081081081081
"6112454258.jpg",0,12,64,27,0,103,3.14563106796116,0.600779999378117,58.896017699115
"6112534853.jpg",0,20,71,17,0,108,2.97222222222222,0.587380265521398,54.5884955752212
"6112607748.jpg",0,3,41,55,4,103,3.58252427184466,0.61873165403042,72.1467889908257
"611264152.jpg",0,15,67,26,1,109,3.11926605504587,0.634279565687073,59.3289473684211
"6112648095.jpg",0,3,49,50,0,102,3.46078431372549,0.557070993350661,67.1586538461538
"6113347868.jpg",0,29,62,13,2,106,2.88679245283019,0.680626528133925,51.7584745762712
"6113677746.jpg",0,1,36,64,3,104,3.66346153846154,0.550561530172921,75.5767326732673
"6113689999.jpg",0,0,26,72,4,102,3.7843137254902,0.500048531909845,74.0921052631579
"6114016805.jpg",0,3,64,44,0,111,3.36936936936937,0.538143744364542,62.9826086956522
"6114724699.jpg",1,27,69,6,0,103,2.77669902912621,0.558921209413618,44.6808035714286
"6114847662.jpg",0,2,67,44,0,113,3.3716814159292,0.520897067318328,64.3685344827586
"6114886448.jpg",0,0,32,72,2,106,3.71698113207547,0.492896530842733,72.5233050847458
"6115396985.jpg",0,5,44,52,3,104,3.50961538461538,0.638493255283538,70.7087155963303
"6115480209.jpg",0,8,55,35,2,100,3.31,0.646591685749831,62.1559633027523
"6116188135.jpg",0,1,31,74,1,107,3.70093457943925,0.499338303120032,72.8728813559322
"6117273943.jpg",0,0,29,71,3,103,3.74757281553398,0.499380922663678,72.671875
"611785273.jpg",10,61,31,0,0,102,2.20588235294118,0.602605486334754,32.2099056603774
"6118735934.jpg",0,0,34,66,10,110,3.78181818181818,0.596346955563209,76.3978260869565
"6118739597.jpg",1,25,76,7,0,109,2.81651376146789,0.547132890870062,48.09375
"6118760299.jpg",0,0,32,64,8,104,3.76923076923077,0.578427215227558,77.8962264150943
"6119101323.jpg",0,2,60,41,0,103,3.37864077669903,0.526112357610771,66.8472222222222
"6119482341.jpg",0,2,58,48,2,110,3.45454545454545,0.568861145185787,65.6134453781513
"6119560603.jpg",0,1,12,78,11,102,3.97058823529412,0.516190968440775,81.7065217391304
"6120678876.jpg",0,34,63,13,0,110,2.80909090909091,0.628022300566103,49.675
"6121503317.jpg",0,3,34,62,1,100,3.61,0.566666666666667,74.4861111111111
"6121672426.jpg",1,27,75,3,0,106,2.75471698113208,0.512906206123813,47.2589285714286
"6121771164.jpg",0,0,19,79,7,105,3.88571428571429,0.486634551602316,79.3026315789474
"6121783761.jpg",0,10,66,37,0,113,3.23893805309735,0.601699027207627,60.88125
"6122580003.jpg",42,54,14,0,0,110,1.74545454545455,0.669607082328077,19.21875
"6123127594.jpg",0,1,47,50,2,100,3.53,0.55876848714134,68.2110091743119
"6123909061.jpg",0,3,43,55,1,102,3.52941176470588,0.575160457214671,71.2867647058823
"6124044226.jpg",0,0,35,58,4,97,3.68041237113402,0.550499616874248,71.9797297297297
"6124674840.jpg",1,3,53,51,0,108,3.42592592592593,0.599122468932278,67.2291666666667
"6125004754.jpg",0,2,49,54,1,106,3.50943396226415,0.556267887140855,67.2869565217391
"6125799438.jpg",0,0,35,62,7,104,3.73076923076923,0.578427215227558,77.2935779816514
"6127342377.jpg",3,62,39,0,0,104,2.34615384615385,0.535519542113137,35.1478260869565
"6127748837.jpg",0,0,53,54,1,108,3.51851851851852,0.520270984055541,67.9491150442478
"6128176020.jpg",4,68,37,1,0,110,2.31818181818182,0.557382779577142,35.6923076923077
"6128487555.jpg",3,70,34,1,0,108,2.30555555555556,0.53753214784685,34.9491150442478
"6128600017.jpg",0,0,18,74,10,102,3.92156862745098,0.520591333800132,80.7256637168142
"6128722390.jpg",0,5,69,34,0,108,3.26851851851852,0.540101781364678,62.3684210526316
"6128851294.jpg",0,4,68,35,1,108,3.30555555555556,0.554646192409083,64.7565789473684
"6129702417.jpg",3,11,54,38,0,106,3.19811320754717,0.73575113961376,60.0878378378378
"6130471976.jpg",28,69,8,1,0,106,1.83018867924528,0.593162598975189,20.5200892857143
"6131302144.jpg",0,0,31,75,3,109,3.74311926605505,0.498212912331938,73.875
"6131345309.jpg",0,0,41,60,2,103,3.62135922330097,0.526112357610771,69.5108695652174
"6132160018.jpg",9,77,33,0,0,119,2.20168067226891,0.561170567332449,32.8813559322034
"6132687106.jpg",0,1,17,75,12,105,3.93333333333333,0.559303596287842,76.1418918918919
"6132687448.jpg",0,13,69,21,1,104,3.09615384615385,0.599663834131796,58.4527027027027
"6133227550.jpg",1,18,70,13,1,103,2.95145631067961,0.616419782747704,51.7692307692308
"6133915607.jpg",0,5,77,17,0,99,3.12121212121212,0.457872793865044,58.4326923076923
"6135085548.jpg",10,53,39,3,0,105,2.33333333333333,0.688737231721194,34.8175675675676
"6136695263.jpg",1,37,58,12,0,108,2.75,0.657451892273652,47.1029411764706
"6138227307.jpg",0,0,22,76,4,102,3.82352941176471,0.475368844930275,76.825
"6138363884.jpg",0,1,33,77,2,113,3.70796460176991,0.512023575231571,72.8928571428571
"6138545533.jpg",0,21,75,13,1,110,2.94545454545455,0.587895697488881,53.3205128205128
"6139148199.jpg",3,40,58,6,0,107,2.62616822429907,0.637260713300787,43.0675675675676
"6141644899.jpg",0,0,48,55,1,104,3.54807692307692,0.5191443238415,70.1393805309735
"6141827403.jpg",0,2,31,79,2,114,3.71052631578947,0.527537008902245,73.9327731092437
"6142185721.jpg",1,48,43,6,0,98,2.55102040816327,0.627915040868018,39.6009174311927
"6142593562.jpg",0,18,73,14,0,105,2.96190476190476,0.553377905438143,52.5804347826087
"6142750214.jpg",0,5,79,29,0,113,3.21238938053097,0.507995490587907,60.0672268907563
"6142852545.jpg",1,11,57,36,0,105,3.21904761904762,0.664786726658552,59.3289473684211
"6143005598.jpg",17,71,21,0,0,109,2.03669724770642,0.592024234748369,27.4831932773109
"6143020134.jpg",1,4,65,60,2,132,3.43939393939394,0.62097652421578,68.5277777777778
"6143211622.jpg",1,3,46,75,1,126,3.57142857142857,0.59904686198756,71.5609756097561
"6143633711.jpg",0,4,61,41,0,106,3.34905660377358,0.552784343210652,65.96875
"6143698715.jpg",7,62,34,0,0,103,2.2621359223301,0.576690440094974,33.6349557522124
"6144141675.jpg",6,32,58,7,0,103,2.64077669902913,0.69809782072062,46.2593457943925
"6144182512.jpg",2,46,60,0,0,108,2.53703703703704,0.536968401338476,42.3898305084746
"6144690260.jpg",0,4,29,63,4,100,3.67,0.620442982835244,76.4399038461538
"6144702078.jpg",0,21,64,18,0,103,2.97087378640777,0.61765385762215,54.0357142857143
"6146146023.jpg",0,0,12,91,2,105,3.9047619047619,0.35420033237968,80.7739130434783
"6146595160.jpg",0,2,45,60,0,107,3.54205607476635,0.536944075507108,71.6261682242991
"6147028264.jpg",0,1,61,43,0,105,3.4,0.511408311956759,67.7208737864078
"6147638271.jpg",0,2,27,71,5,105,3.75238095238095,0.568076247268466,76.5486111111111
"6147756679.jpg",0,14,68,27,1,110,3.13636363636364,0.627756639682572,58.0625
"6148781935.jpg",0,1,30,71,2,104,3.71153846153846,0.515263659967445,73.4871794871795
"6149089572.jpg",0,1,38,63,3,105,3.64761904761905,0.554369919210997,73.3517699115044
"6149327841.jpg",1,21,85,5,0,112,2.83928571428571,0.494174558439115,50.3589743589744
"6149786725.jpg",1,3,44,54,3,105,3.52380952380952,0.651850001847377,69.8986486486486
"615034576.jpg",60,48,1,0,0,109,1.45871559633028,0.518761168407095,13.16875
"6150431643.jpg",0,17,62,21,2,102,3.07843137254902,0.670248579715003,57.1
"6151722057.jpg",0,1,35,62,4,102,3.67647058823529,0.565716311123285,72.2027027027027
"6153674206.jpg",0,0,30,74,3,107,3.74766355140187,0.497037600489617,74.5387931034483
"6153807982.jpg",0,3,44,56,0,103,3.51456310679612,0.557727842651489,66.7053571428571
"6153962968.jpg",1,46,50,5,0,102,2.57843137254902,0.604214153068591,40.6605504587156
"6153984860.jpg",0,23,72,14,1,110,2.93636363636364,0.609967253253567,53.3910256410256
"6153987026.jpg",0,1,28,103,1,133,3.78195488721805,0.449551053234858,79.4945652173913
"6154151584.jpg",4,30,69,7,0,110,2.71818181818182,0.637250662617026,45.6470588235294
"6154181656.jpg",1,5,54,44,2,106,3.38679245283019,0.655682192427328,62.6652542372881
"6154682169.jpg",0,10,72,21,0,103,3.10679611650485,0.540744246734931,57.175
"6156825791.jpg",0,2,63,40,1,106,3.37735849056604,0.542530757323038,66.0388349514563
"6157269517.jpg",0,18,76,16,0,110,2.98181818181818,0.558205154187778,54.8383620689655
"6157377531.jpg",0,2,41,60,2,105,3.59047619047619,0.566623570867177,70.2853982300885
"6158806771.jpg",48,51,6,1,0,106,1.62264150943396,0.639238090954555,16.8008474576271
"6160181184.jpg",0,0,28,76,2,106,3.75471698113208,0.474317971602474,74.3487394957983
"6160253188.jpg",12,72,23,1,0,108,2.12037037037037,0.591490949877323,29.0065789473684
"6160448268.jpg",3,35,62,4,0,104,2.64423076923077,0.606089955045593,44.6808035714286
"6160450342.jpg",5,52,45,4,0,106,2.45283018867925,0.649279094317736,37.4849137931034
"6162009461.jpg",0,4,65,38,1,108,3.33333333333333,0.563699396261691,65.9976635514019
"6162806548.jpg",1,7,65,36,0,109,3.24770642201835,0.610948917406847,58.4004237288136
"6162845121.jpg",0,3,34,59,3,99,3.62626262626263,0.599078520046235,71.0871559633027
"6163494059.jpg",0,4,35,59,5,103,3.63106796116505,0.64154059768128,72.3296460176991
"6163563949.jpg",0,2,39,57,1,99,3.57575757575758,0.554957418681078,72.025
"6163576407.jpg",0,3,68,38,1,110,3.33636363636364,0.546503023439813,63.5067567567568
"6163642388.jpg",0,2,40,53,1,96,3.55208333333333,0.559507145275228,73.0661764705882
"6163705024.jpg",0,0,29,69,7,105,3.79047619047619,0.549391938265845,76.6495535714286
"6164110615.jpg",0,9,78,19,0,106,3.09433962264151,0.507623818098411,56.3826086956522
"6164643779.jpg",0,2,45,54,2,103,3.54368932038835,0.573545885630822,68.5782608695652
"6166445475.jpg",4,32,53,11,0,100,2.71,0.71484970518991,47.0940366972477
"6166626410.jpg",0,20,81,4,0,105,2.84761904761905,0.45533065713392,48.9353448275862
"6166766826.jpg",0,1,51,53,2,107,3.52336448598131,0.555347832401704,68.6205357142857
"616692637.jpg",0,54,41,3,0,98,2.47959183673469,0.5603679173715,38.0093457943925
"6167276187.jpg",44,42,10,0,0,96,1.64583333333333,0.664580067912563,16.2307692307692
"6167489115.jpg",0,1,51,50,0,102,3.48039215686275,0.521429720673115,68.9712389380531
"6167876275.jpg",0,1,52,46,2,101,3.48514851485149,0.558817705269592,64.8478260869565
"6168174174.jpg",0,7,67,30,0,104,3.22115384615385,0.556632223656022,60.5571428571429
"6169499538.jpg",0,0,24,75,8,107,3.85046728971963,0.528503374933567,77.725
"6169751513.jpg",0,3,43,54,2,102,3.53921568627451,0.59155054900552,68.125
"6170589548.jpg",0,0,72,41,0,113,3.36283185840708,0.482958644019467,64.4348739495798
"6170767458.jpg",1,1,58,42,4,106,3.44339622641509,0.633661899923134,66.5695652173913
"6171193930.jpg",8,64,35,1,0,108,2.26851851851852,0.605372851533239,34.3142857142857
"6171205916.jpg",0,10,74,16,0,100,3.06,0.508910501944987,56.7064220183486
"6171792130.jpg",0,1,26,74,0,101,3.72277227722772,0.471567850498486,76.6
"6172349199.jpg",1,4,34,58,10,107,3.67289719626168,0.736843099636979,71.9915966386555
"6172964730.jpg",18,73,9,1,0,101,1.93069306930693,0.552402493523957,23.8224299065421
"6173003449.jpg",0,1,39,63,2,105,3.62857142857143,0.541670188774122,72.6009174311927
"61745002.jpg",2,35,58,14,0,109,2.77064220183486,0.688974378964255,47.7727272727273
"6175048748.jpg",0,1,48,53,1,103,3.52427184466019,0.539510675068835,70.9040178571429
"6175206335.jpg",0,7,59,41,1,108,3.33333333333333,0.611417840515743,61.5
"6175384810.jpg",0,3,56,42,1,102,3.40196078431373,0.567429568562114,67.0793269230769
"6175479501.jpg",1,7,65,31,0,104,3.21153846153846,0.602149497985196,59.6752336448598
"6176401677.jpg",5,72,26,2,0,105,2.23809523809524,0.563706987508198,34.8168316831683
"6177131907.jpg",0,9,74,22,0,105,3.12380952380952,0.531602043450486,57.3152173913044
"6177166693.jpg",0,1,34,62,5,102,3.69607843137255,0.576593198502975,70.1788990825688
"6177663697.jpg",0,2,45,62,2,111,3.57657657657658,0.564874073650685,68.5252100840336
"6178467080.jpg",0,0,31,74,3,108,3.74074074074074,0.49991345737711,75.1101694915254
"6178888063.jpg",0,5,64,32,0,101,3.26732673267327,0.545730503250659,62.3918918918919
"6179066994.jpg",0,4,71,28,1,104,3.25,0.535170783012574,62.3830275229358
"6180251027.jpg",0,4,51,53,0,108,3.4537037037037,0.570034582641014,68.375
"6180327231.jpg",0,0,11,79,11,101,4,0.469041575982343,83.7920353982301
"6180360861.jpg",0,1,59,46,1,107,3.4392523364486,0.535134793343113,67.5110619469027
"6181551181.jpg",0,10,79,19,0,108,3.08333333333333,0.513827492052328,56.7224576271186
"6182410940.jpg",0,2,59,52,1,114,3.45614035087719,0.550789471644304,65.4487179487179
"6183915148.jpg",3,60,40,2,0,105,2.39047619047619,0.58004041794248,36.0067567567568
"6184879643.jpg",1,3,59,41,1,105,3.36190476190476,0.606436779693949,62.3175675675676
"6185806763.jpg",0,0,24,83,7,114,3.85087719298246,0.501898275141767,75.8900862068966
"6186480885.jpg",1,12,60,40,1,114,3.24561403508772,0.685648114150722,62.1470588235294
"6186608340.jpg",1,51,54,8,0,114,2.60526315789474,0.632713233882272,43.2205882352941
"6188110673.jpg",0,0,39,66,1,106,3.64150943396226,0.501211470344994,75.1026785714286
"6188375845.jpg",5,48,45,7,0,105,2.51428571428571,0.694958295847336,39.6185344827586
"6189434531.jpg",1,24,102,14,0,141,2.91489361702128,0.541022335188902,52.2280405405405
"6190085634.jpg",2,27,57,21,0,107,2.90654205607477,0.720753147498986,51.8865546218487
"6190472459.jpg",0,3,64,42,3,112,3.40178571428571,0.592138001759229,64.5608695652174
"6190639250.jpg",0,4,51,71,3,129,3.56589147286822,0.597455035446053,72.5827067669173
"6190643783.jpg",0,0,31,76,3,110,3.74545454545455,0.49652671863516,71.60625
"6191653562.jpg",0,1,30,72,3,106,3.72641509433962,0.526136300789146,74.8943965517241
"6192180077.jpg",0,1,44,61,1,107,3.57943925233645,0.532657686415534,70.3970588235294
"6192537618.jpg",0,1,60,70,1,132,3.53787878787879,0.530091494771472,71.912213740458
"6193425785.jpg",0,5,50,46,0,101,3.40594059405941,0.586143631233543,69.4127358490566
"6194409059.jpg",0,0,14,81,10,105,3.96190476190476,0.478857002981088,77.9256756756757
"6194607609.jpg",0,1,23,74,10,108,3.86111111111111,0.571247746200316,76.14375
"6194753185.jpg",0,1,34,73,1,109,3.67889908256881,0.507001606121974,70.1625
"6197628088.jpg",0,0,35,72,2,109,3.69724770642202,0.50008494011783,76.0138888888889
"6198414386.jpg",0,8,72,22,2,104,3.17307692307692,0.581966997568077,58.4579646017699
"6198870834.jpg",0,14,56,31,4,105,3.23809523809524,0.727532837268552,59.3739495798319
"6199129652.jpg",0,9,56,37,1,103,3.29126213592233,0.63602731414348,64.3028846153846
"6199370121.jpg",0,0,28,70,8,106,3.81132075471698,0.554002020748761,76.4695652173913
"6199923383.jpg",0,28,74,4,0,106,2.77358490566038,0.50300087793021,47.2311320754717
"6200906518.jpg",0,9,66,24,0,99,3.15151515151515,0.559949639930132,60.0315533980583
"6201268474.jpg",1,7,45,45,2,100,3.4,0.696310623822791,65.7889908256881
"6201290598.jpg",0,1,63,42,0,106,3.38679245283019,0.508419675108798,65.6621621621622
"6201330007.jpg",0,5,45,48,2,100,3.47,0.626921289342054,66.0747663551402
"6202357240.jpg",0,19,77,10,0,106,2.91509433962264,0.518568074757916,51.4956896551724
"6202637984.jpg",0,0,30,77,0,107,3.7196261682243,0.451295671882312,77.05
"6204572206.jpg",0,1,33,73,6,113,3.74336283185841,0.563451751356045,73.1346153846154
"62049415.jpg",0,37,57,9,0,103,2.72815533980583,0.613478905741538,44.9525862068966
"6205007970.jpg",0,6,57,44,1,108,3.37037037037037,0.605158395772291,66.1238938053097
"6205974624.jpg",3,21,66,16,0,106,2.89622641509434,0.675126023974768,51.9558823529412
"6206537563.jpg",3,35,53,7,0,98,2.6530612244898,0.659616271084103,40.7898230088496
"6206641810.jpg",0,0,34,65,5,104,3.72115384615385,0.547841851767616,72.9867256637168
"6207546656.jpg",1,15,69,16,1,102,3.00980392156863,0.621322416568889,53.0733944954128
"6208184332.jpg",3,64,36,3,0,106,2.36792452830189,0.590810124975516,36.7743362831858
"6208522710.jpg",0,2,53,48,3,106,3.49056603773585,0.589516073028878,67.9012605042017
"6208981295.jpg",0,3,62,43,1,109,3.38532110091743,0.559567572471583,65.9144736842105
"6209362711.jpg",1,3,47,56,1,108,3.49074074074074,0.618943482848146,70.15
"6210021795.jpg",0,19,64,22,0,105,3.02857142857143,0.627221327289334,52.8673913043478
"6210436753.jpg",2,44,49,10,0,105,2.63809523809524,0.681116299848575,43.5878378378378
"6210494281.jpg",0,7,72,27,1,107,3.20560747663551,0.561976259436275,59.7075892857143
"6211550250.jpg",0,27,86,9,0,122,2.85245901639344,0.524949917289101,51.0454545454545
"6211562802.jpg",0,6,70,32,2,110,3.27272727272727,0.589029537881659,62.2457627118644
"6214101646.jpg",0,7,77,22,1,107,3.1588785046729,0.534640290117207,60.3108108108108
"6216457478.jpg",0,1,61,42,1,105,3.40952380952381,0.531602043450486,64.9195652173913
"6216628901.jpg",0,1,21,70,9,101,3.86138613861386,0.566210260774158,81.85
"6218336714.jpg",0,0,20,88,4,112,3.85714285714286,0.442294241002747,75.1794871794872
"6219475255.jpg",0,7,71,25,1,104,3.19230769230769,0.558724676052145,61.1808035714286
"6220511513.jpg",0,8,65,35,0,108,3.25,0.582052443280648,63.3761682242991
"6220758013.jpg",0,3,58,45,0,106,3.39622641509434,0.546490888400823,67.6629464285714
"6221634862.jpg",2,33,65,5,0,105,2.6952380952381,0.590368358344854,46.2673913043478
"6222011944.jpg",0,8,60,36,0,104,3.26923076923077,0.594975225571673,63.1305309734513
"6222668667.jpg",0,4,38,59,2,103,3.57281553398058,0.603940357845674,70
"6224117679.jpg",1,12,83,12,0,108,2.98148148148148,0.511210428744952,53.9258474576271
"6224309834.jpg",28,82,21,1,0,132,1.96212121212121,0.63492865536941,23.3055555555556
"6224567547.jpg",1,44,54,5,0,104,2.60576923076923,0.59802700252003,42.5369565217391
"6224584485.jpg",1,70,27,5,0,103,2.3495145631068,0.589262381454646,36.0046728971963
"6225839332.jpg",0,7,64,31,0,102,3.23529411764706,0.565973630359299,58.8256880733945
"6225884368.jpg",50,46,6,0,0,102,1.56862745098039,0.605417848038965,14.4929906542056
"6226065978.jpg",0,8,53,46,1,108,3.37037037037037,0.635295098000753,65.8851351351351
"6226355668.jpg",0,1,52,53,1,107,3.50467289719626,0.53858360321749,67.6991525423729
"6226545880.jpg",0,2,57,41,0,100,3.39,0.529817959970281,64.3986486486486
"6226958482.jpg",0,1,25,66,11,103,3.84466019417476,0.606456786902706,77.3486842105263
"6227646726.jpg",0,4,61,40,0,105,3.34285714285714,0.551720585437597,64.027027027027
"6227862554.jpg",0,2,42,65,3,112,3.61607142857143,0.573365844159199,71.19375
"6227951538.jpg",3,31,65,8,0,107,2.72897196261682,0.637952110610902,45.5202702702703
"6228242896.jpg",1,28,70,10,0,109,2.81651376146789,0.595743196207382,49.5833333333333
"6228278450.jpg",0,8,55,42,0,105,3.32380952380952,0.612297660381309,62.6239130434783
"6228740926.jpg",0,3,49,50,3,105,3.5047619047619,0.606436779693949,67.7891304347826
"6229984844.jpg",0,7,80,20,0,107,3.1214953271028,0.489710741996757,59.2948113207547
"6230011878.jpg",0,1,25,62,10,98,3.8265306122449,0.609639241033473,77.4797297297297
"6232031392.jpg",0,1,46,54,5,106,3.59433962264151,0.598065164259555,71.8241525423729
"6232083444.jpg",0,15,73,14,0,102,2.99019607843137,0.535753342818227,54.0573394495413
"6233076325.jpg",0,2,29,72,1,104,3.69230769230769,0.522817666278851,74.9553571428571
"6233367790.jpg",1,6,71,27,0,105,3.18095238095238,0.568076247268466,60.6422018348624
"62339435.jpg",0,4,48,54,2,108,3.5,0.603726743906886,67.4159663865546
"6235008903.jpg",0,1,44,57,3,105,3.59047619047619,0.566623570867177,72.6617647058823
"6235266506.jpg",2,16,62,26,0,106,3.05660377358491,0.687717947157675,57.3082524271845
"6236533476.jpg",0,3,55,80,0,138,3.55797101449275,0.540587892230949,71.3541666666667
"6237039351.jpg",0,2,43,61,0,106,3.55660377358491,0.535949334478999,73.3042452830189
"6237051127.jpg",2,13,54,31,1,101,3.15841584158416,0.731200017332149,58.1214285714286
"6237170971.jpg",0,16,51,40,0,107,3.22429906542056,0.691026188168703,61.1970338983051
"6237287200.jpg",3,57,45,0,0,105,2.4,0.547722557505166,36.7254464285714
"6237907286.jpg",0,1,51,53,0,105,3.4952380952381,0.521163814564789,67.1473214285714
"6238087656.jpg",0,4,57,35,1,97,3.34020618556701,0.575300608706446,66.4551886792453
"6238203210.jpg",2,36,49,19,1,107,2.82242990654206,0.774756006779268,47.40625
"6238346062.jpg",0,1,28,83,2,114,3.75438596491228,0.489923301000493,73.4008620689655
"6238543010.jpg",0,6,62,35,1,104,3.29807692307692,0.589220444222254,62.4330357142857
"6238988012.jpg",0,24,68,13,0,105,2.8952380952381,0.587101903155359,52.4913793103448
"6239374380.jpg",0,0,17,83,7,107,3.90654205607477,0.466474337104266,82.3851351351351
"6239620274.jpg",0,0,32,68,1,101,3.69306930693069,0.484614780158958,72.925
"6239948477.jpg",1,30,67,6,0,104,2.75,0.570300550978694,46.1148648648649
"6243575043.jpg",1,24,75,12,0,112,2.875,0.587021800783067,51.4871794871795
"6243772733.jpg",2,54,44,1,0,101,2.43564356435644,0.555262849183311,37.4696261682243
"6244943274.jpg",4,42,53,4,0,103,2.55339805825243,0.637522092501558,39.2629310344828
"6245095836.jpg",0,2,64,39,0,105,3.35238095238095,0.518521425656133,63.2695652173913
"6245438349.jpg",0,1,26,78,8,113,3.82300884955752,0.554689238859652,76.4978991596639
"6245654215.jpg",0,0,36,62,5,103,3.69902912621359,0.557215617370319,75.4879807692308
"6245749984.jpg",1,16,70,18,1,106,3.0188679245283,0.632171346203991,54.2631578947368
"62458506.jpg",0,12,41,47,4,104,3.41346153846154,0.745349034327118,64.5320512820513
"6246977871.jpg",24,59,22,0,0,105,1.98095238095238,0.664786726658552,25.8243243243243
"6248527465.jpg",0,1,33,60,3,97,3.6701030927835,0.553805950607101,75.6391509433962
"6249554399.jpg",0,1,46,53,1,101,3.53465346534653,0.539710226615053,67.2894736842105
"6249766642.jpg",0,2,35,69,1,107,3.64485981308411,0.536451240088433,74.5263157894737
"6250057202.jpg",0,4,45,59,0,108,3.50925925925926,0.571853362851923,69.1554054054054
"62503983.jpg",10,49,34,9,0,102,2.41176470588235,0.787940556340483,36.3974358974359
"6251598886.jpg",1,18,73,15,0,107,2.95327102803738,0.588941768753835,53.3727678571429
"6251689254.jpg",0,34,67,1,0,102,2.67647058823529,0.490741300359832,44.425
"6251795586.jpg",0,1,32,72,0,105,3.67619047619048,0.49019694031383,73.4878640776699
"6252006096.jpg",5,64,56,4,0,129,2.45736434108527,0.625096891714403,38.447265625
"6252132752.jpg",0,12,62,29,1,104,3.18269230769231,0.634974551541479,60.6081081081081
"6252195920.jpg",0,3,25,70,8,106,3.78301886792453,0.617286180156368,71.7542372881356
"6252279555.jpg",0,2,58,50,1,111,3.45045045045045,0.551670829698929,67.0699152542373
"6252497829.jpg",0,15,65,21,0,101,3.05940594059406,0.597022314125993,57.8660714285714
"6252913864.jpg",2,35,52,15,0,104,2.76923076923077,0.713677325455493,48.2760869565217
"6253185409.jpg",0,34,71,3,0,108,2.71296296296296,0.512478418527609,47.0986842105263
"6253604200.jpg",0,3,53,51,2,109,3.47706422018349,0.586835996321222,67.4935897435897
"6253829392.jpg",0,18,49,37,4,108,3.25,0.774898244751933,59.7125
"6254765942.jpg",0,3,33,61,0,97,3.5979381443299,0.552641268033813,73.5841346153846
"6255399920.jpg",0,1,37,63,3,104,3.65384615384615,0.553352198616052,71.2345132743363
"6255404207.jpg",0,2,39,69,1,111,3.62162162162162,0.540270202668898,71.6538461538462
"6255414433.jpg",0,3,69,32,0,104,3.27884615384615,0.511170952903096,59.1216216216216
"6255855320.jpg",1,15,65,20,0,101,3.02970297029703,0.62378594957813,54.1330275229358
"6256521905.jpg",0,2,46,55,1,104,3.52884615384615,0.556632223656022,72.6816037735849
"6256829619.jpg",0,0,32,92,5,129,3.7906976744186,0.494886644291068,78.6507633587786
"6256953359.jpg",0,0,38,64,1,103,3.64077669902913,0.502042278745347,72.0285714285714
"6257410462.jpg",6,53,44,4,0,107,2.42990654205607,0.660362243825315,38.5195652173913
"6257507740.jpg",0,8,68,38,0,114,3.26315789473684,0.580701918553278,61.1681034482759
"6257550303.jpg",4,48,53,8,0,113,2.57522123893805,0.678829214458263,41.2012711864407
"6258118545.jpg",2,66,35,2,0,105,2.35238095238095,0.554369919210997,36.5826086956522
"6258120264.jpg",0,0,38,70,1,109,3.6605504587156,0.494791079859087,71.5995575221239
"6258336058.jpg",3,52,47,2,0,104,2.46153846153846,0.589932971724506,38.3383620689655
"6259041958.jpg",0,1,41,56,0,98,3.56122448979592,0.51904604270297,70.2847222222222
"6259163279.jpg",1,50,46,5,0,102,2.53921568627451,0.608057589564304,40.4334862385321
"6259804978.jpg",7,59,36,1,0,103,2.30097087378641,0.607711093903304,33.6071428571429
"6261187277.jpg",0,24,63,13,1,101,2.91089108910891,0.634019083324628,50.725
"6264153932.jpg",3,43,51,0,0,97,2.49484536082474,0.561317485553077,40.6605504587156
"6264326921.jpg",0,35,62,6,0,103,2.71844660194175,0.567372266494723,43.9441964285714
"6264359892.jpg",0,2,42,61,7,112,3.65178571428571,0.625434212102243,72.6410256410256
"6264868738.jpg",1,41,49,7,0,98,2.63265306122449,0.632255903789858,40.6438053097345
"6265723593.jpg",0,0,46,56,0,102,3.54901960784314,0.500048531909845,72.6216814159292
"6266190688.jpg",0,19,74,18,0,111,2.99099099099099,0.579898039556728,54.0961538461538
"6267817145.jpg",0,4,51,47,0,102,3.42156862745098,0.570500466583819,64.975
"6267962364.jpg",4,20,56,27,0,107,2.99065420560748,0.770877068519931,53.2013274336283
"6268176546.jpg",0,0,28,70,10,108,3.83333333333333,0.571929019842775,75.8739495798319
"6268918476.jpg",0,3,43,58,2,106,3.55660377358491,0.586842863355548,71.4196428571429
"6269063819.jpg",0,22,65,15,0,102,2.93137254901961,0.60131545437867,51.625
"6272061393.jpg",0,1,25,74,5,105,3.79047619047619,0.531602043450486,73.6891891891892
"6272882973.jpg",0,23,110,15,1,149,2.95973154362416,0.531179140023,53.8846153846154
"6272884743.jpg",0,27,67,10,0,104,2.83653846153846,0.576406290821484,48.8058035714286
"6273772448.jpg",0,2,20,82,5,109,3.8256880733945,0.524299121177549,77.0752212389381
"6273784733.jpg",5,47,41,9,1,103,2.55339805825243,0.763482158706318,40.8221153846154
"6274128274.jpg",0,2,75,28,0,105,3.24761904761905,0.475979806879217,61.1173913043478
"6274950285.jpg",0,1,21,73,4,99,3.80808080808081,0.508634981518014,76.675
"6275395379.jpg",0,0,38,66,0,104,3.63461538461538,0.483869763182389,72.0825892857143
"6275790989.jpg",1,34,93,12,0,140,2.82857142857143,0.574554655724946,49.2003424657534
"6276334186.jpg",7,67,37,2,0,113,2.30088495575221,0.610692752889998,35.44375
"6277079135.jpg",0,9,77,18,2,106,3.12264150943396,0.564047113680261,56.8622881355932
"6278202326.jpg",9,67,22,0,0,98,2.13265306122449,0.549371808111076,28.4256756756757
"6279019362.jpg",0,5,66,34,0,105,3.27619047619048,0.545880342186223,62.5521739130435
"6279173860.jpg",0,11,61,28,1,101,3.18811881188119,0.62789921623026,57.3628318584071
"6279975735.jpg",0,2,69,35,0,106,3.31132075471698,0.504516884368361,62.7327586206897
"6280923250.jpg",0,0,45,57,3,105,3.6,0.547722557505166,69.7737068965517
"6282202152.jpg",0,0,37,66,2,105,3.66666666666667,0.512660231362364,72.4762931034483
"6283537466.jpg",0,9,72,20,0,101,3.10891089108911,0.527275831022244,55.4197247706422
"6283627097.jpg",0,15,72,21,0,108,3.05555555555556,0.577350269189626,57.8247663551402
"6284871746.jpg",2,59,59,2,0,122,2.5,0.564076074817766,40.9327731092437
"6285601097.jpg",0,3,37,66,0,106,3.59433962264151,0.548214450336683,73.6933962264151
"6285698915.jpg",0,1,2,80,19,102,4.14705882352941,0.47506245183049,87.2964601769911
"6285772617.jpg",2,34,78,18,0,132,2.84848484848485,0.659456733209076,51.2886029411765
"6286044979.jpg",0,2,54,45,1,102,3.44117647058824,0.555325779182854,66.3060747663551
"6287889158.jpg",0,10,50,44,1,105,3.34285714285714,0.662579043594792,62.7692307692308
"6289164461.jpg",16,71,17,0,0,104,2.00961538461538,0.56594610720975,25.8223684210526
"628981585.jpg",0,1,23,71,12,107,3.8785046728972,0.594158361042598,76.7752100840336
"6290063091.jpg",0,0,41,64,0,105,3.60952380952381,0.49019694031383,72.5808823529412
"6290086775.jpg",0,1,52,52,1,106,3.5,0.538958431120797,69.3571428571429
"6290479072.jpg",0,7,80,41,2,130,3.29230769230769,0.589917269802883,64.2919847328244
"6291431070.jpg",0,0,14,86,11,111,3.97297297297297,0.475957589009385,78.9243697478992
"6292365384.jpg",1,61,41,2,0,105,2.41904761904762,0.550890055709716,37.5560344827586
"6293184375.jpg",0,0,49,57,2,108,3.56481481481481,0.534302727522781,68.6638655462185
"6293629106.jpg",0,37,57,2,0,96,2.63541666666667,0.525553175569207,44.8183962264151
"629401204.jpg",2,44,55,6,0,107,2.60747663551402,0.625812820074585,43.7058823529412
"6294378978.jpg",0,3,78,49,0,130,3.35384615384615,0.526234811584218,65.5708661417323
"6294913930.jpg",0,8,67,21,0,96,3.13541666666667,0.535474048054946,58.75
"6295098733.jpg",0,2,41,69,1,113,3.61061946902655,0.541717314238842,74.1548672566372
"6296603222.jpg",0,1,45,54,3,103,3.57281553398058,0.570550847480092,73
"6297143428.jpg",0,1,20,75,6,102,3.84313725490196,0.521708883566678,82.4882075471698
"6298978484.jpg",1,12,62,28,1,104,3.15384615384615,0.664921789243146,59.8096330275229
"6299847089.jpg",0,5,50,46,6,107,3.49532710280374,0.678147195238211,67.6629464285714
"6301607249.jpg",0,9,47,43,6,105,3.43809523809524,0.732800339107684,66.1897321428571
"6301736669.jpg",0,10,64,37,0,111,3.24324324324324,0.606273508878268,61.0769230769231
"6302067502.jpg",0,2,39,57,1,99,3.57575757575758,0.554957418681078,67.7300884955752
"6302152017.jpg",3,33,76,9,0,121,2.75206611570248,0.622909727750033,48.1428571428571
"6302283687.jpg",1,55,52,4,0,112,2.52678571428571,0.584481312035213,40.2923728813559
"6303415659.jpg",3,60,84,6,0,153,2.6078431372549,0.598631049250651,45.1586538461538
"6303418704.jpg",7,79,20,1,0,107,2.14018691588785,0.522125520418677,29.2120535714286
"6303626544.jpg",0,0,38,69,5,112,3.70535714285714,0.547531608485631,71.0550847457627
"6303893419.jpg",0,11,78,13,1,103,3.03883495145631,0.522481449095346,56.5707547169811
"6304784314.jpg",19,63,23,1,0,106,2.05660377358491,0.659439714263199,28.3513513513514
"6305224063.jpg",17,76,12,0,0,105,1.95238095238095,0.525886657519257,24.8891304347826
"6305294695.jpg",0,7,61,26,0,94,3.20212765957447,0.559949829435447,60.0985576923077
"6305410399.jpg",0,0,38,67,1,106,3.65094339622642,0.498425192938695,74.3660714285714
"6305573914.jpg",0,12,79,15,0,106,3.02830188679245,0.506294609694721,53.7715517241379
"6305619763.jpg",2,49,49,4,0,104,2.52884615384615,0.60670574383033,41.4861111111111
"6305935130.jpg",0,2,40,66,2,110,3.61818181818182,0.558205154187778,69.3375
"6306859998.jpg",0,1,28,77,4,110,3.76363636363636,0.523349703761283,72.3625
"6307302399.jpg",0,1,20,81,2,104,3.80769230769231,0.463773527692987,80.107476635514
"6308479233.jpg",0,9,64,31,0,104,3.21153846153846,0.585804184173917,61.7894736842105
"6308614891.jpg",0,15,97,11,0,123,2.96747967479675,0.460487257074245,55.5040983606557
"6308697965.jpg",0,8,73,24,0,105,3.15238095238095,0.533150151691889,57.8965517241379
"6309109435.jpg",4,68,27,2,0,101,2.26732673267327,0.563756846679681,33.394495412844
"6309436752.jpg",0,26,60,16,1,103,2.92233009708738,0.666999726435983,50.2729357798165
"6310649828.jpg",30,70,5,0,0,105,1.76190476190476,0.528492222557749,18.7522321428571
"6311708784.jpg",0,10,73,27,1,111,3.17117117117117,0.585799746638169,57.7794117647059
"63121245.jpg",0,33,50,18,2,103,2.89320388349515,0.752937012171998,50.3577586206897
"6312611820.jpg",0,6,71,25,0,102,3.18627450980392,0.521429720673115,59.7905405405405
"6316913705.jpg",0,21,81,6,0,108,2.86111111111111,0.482561958315932,50.010593220339
"6317074483.jpg",0,2,73,51,0,126,3.38888888888889,0.521109926556341,66.8658536585366
"6317232957.jpg",0,2,63,37,0,102,3.34313725490196,0.516942612040142,61.5504587155963
"6317292405.jpg",2,30,65,12,1,110,2.81818181818182,0.679743855991455,48.1428571428571
"6318611647.jpg",1,27,65,15,0,108,2.87037037037037,0.642608477952408,49.2777777777778
"6318820907.jpg",0,8,65,29,0,102,3.20588235294118,0.568796458994521,61.8819444444444
"6319935355.jpg",0,0,16,86,4,106,3.88679245283019,0.421352803580746,82.1741071428571
"6319992606.jpg",0,17,59,19,0,95,3.02105263157895,0.618490739682324,55.7642857142857
"6320692581.jpg",0,1,41,60,6,108,3.65740740740741,0.598472151883554,74.493119266055
"6321219958.jpg",1,9,89,53,2,154,3.2987012987013,0.627578291133123,64.8591772151899
"6321269427.jpg",2,48,52,4,0,106,2.54716981132075,0.603672498276344,41.6207627118644
"6321717266.jpg",0,15,68,21,1,105,3.07619047619048,0.615430401227124,54.9806034482759
"6321752444.jpg",0,10,69,26,0,105,3.15238095238095,0.568076247268466,57.4864864864865
"632270898.jpg",0,4,50,55,3,112,3.50892857142857,0.61505929860294,66.510593220339
"6323869799.jpg",0,3,36,67,4,110,3.65454545454545,0.597185503372164,69.13125
"6324713970.jpg",0,0,25,81,7,113,3.84070796460177,0.510013509649778,77.6071428571429
"6325240412.jpg",0,0,19,82,7,108,3.88888888888889,0.480134975830314,79.9343220338983
"6326442580.jpg",0,5,68,29,2,104,3.26923076923077,0.578427215227558,61.6659482758621
"6326811967.jpg",0,1,58,49,1,109,3.45871559633028,0.536313032067666,64.6025641025641
"6326886913.jpg",0,52,54,0,0,106,2.50943396226415,0.502285879874493,41.0614406779661
"6326902733.jpg",0,4,60,40,2,106,3.37735849056604,0.592859578470624,66.2633928571429
"6327903295.jpg",0,3,57,47,5,112,3.48214285714286,0.629344616307033,67.978813559322
"6328014889.jpg",0,6,59,33,2,100,3.31,0.614554121031474,62.0045871559633
"6328697192.jpg",0,0,22,86,3,111,3.82882882882883,0.444642325590803,74.4110169491525
"6329144585.jpg",9,76,22,0,0,107,2.1214953271028,0.526832478007591,30.3256302521008
"6329859114.jpg",5,83,18,1,0,107,2.14018691588785,0.484643384372334,30.8269230769231
"6331865739.jpg",0,3,46,51,4,104,3.53846153846154,0.62197738108714,68.4601769911504
"6332554758.jpg",0,1,36,65,0,102,3.62745098039216,0.505838557336368,74.2569444444444
"6332564856.jpg",0,7,71,31,0,109,3.22018348623853,0.55038367367073,61.328125
"6332883956.jpg",36,66,1,0,0,103,1.66019417475728,0.496130083713671,16.9
"6332978018.jpg",2,17,59,24,0,102,3.02941176470588,0.69589862629412,55.4652777777778
"6333112690.jpg",0,6,48,50,2,106,3.45283018867925,0.634441268574515,67.5021739130435
"6333581509.jpg",0,2,38,66,5,111,3.66666666666667,0.592887132188877,72.3834745762712
"6333620590.jpg",0,7,77,22,0,106,3.14150943396226,0.505939564342714,59.7162162162162
"6335908367.jpg",0,22,74,7,0,103,2.85436893203884,0.512735206482347,48.5675675675676
"6336463501.jpg",0,5,64,33,0,102,3.27450980392157,0.54784659891482,60.0301724137931
"6337822588.jpg",2,37,92,7,0,138,2.7536231884058,0.5642848869312,47.9105839416058
"6339141620.jpg",0,13,70,24,0,107,3.10280373831776,0.581711518973664,57.0558035714286
"6339286279.jpg",3,12,68,49,1,133,3.24812030075188,0.72201333654259,63.5362595419847
"6340619552.jpg",7,72,22,2,0,103,2.18446601941748,0.573047799661376,30.4324324324324
"6340836746.jpg",8,70,30,2,0,110,2.23636363636364,0.604680106910321,31.3986486486486
"6341153287.jpg",0,5,48,59,0,112,3.48214285714286,0.584825266229659,68.2692307692308
"6342206102.jpg",1,6,75,43,0,125,3.28,0.590243252205558,64.4512195121951
"6343064519.jpg",0,0,21,72,8,101,3.87128712871287,0.522749774493183,77.6180555555556
"6343807770.jpg",0,5,57,41,2,105,3.38095238095238,0.610500305250229,66.509900990099
"6344257116.jpg",0,0,32,75,4,111,3.74774774774775,0.512896737231836,72.5
"6344881273.jpg",0,13,71,18,0,102,3.04901960784314,0.551818792548555,54.925
"6344902938.jpg",0,1,22,81,8,112,3.85714285714286,0.534522483824849,78.5360169491525
"6345193023.jpg",0,1,43,59,3,106,3.60377358490566,0.563648747140221,71.4196428571429
"6345505389.jpg",0,1,56,62,1,120,3.525,0.533932611490856,70.146186440678
"6345773491.jpg",0,0,48,51,1,100,3.53,0.521361853052351,69.0817757009346
"6346260646.jpg",0,10,76,19,1,106,3.10377358490566,0.550830460184462,57.3987068965517
"6346767698.jpg",0,1,54,47,1,103,3.46601941747573,0.538981137226463,66.9263392857143
"6346994570.jpg",0,0,22,73,11,106,3.89622641509434,0.550830460184462,76.0190677966102
"6347069171.jpg",2,20,65,23,0,110,2.99090909090909,0.683963818795398,51.4705882352941
"6350199154.jpg",0,28,61,17,1,107,2.91588785046729,0.674627714626046,50.225
"6350910177.jpg",0,1,34,71,1,107,3.67289719626168,0.50982240590043,71.5063025210084
"6351773844.jpg",0,39,62,6,0,107,2.69158878504673,0.573160963154644,44.8151260504202
"6352194993.jpg",0,6,46,55,3,110,3.5,0.6460891522542,68.1186440677966
"6352599641.jpg",1,13,75,17,0,106,3.0188679245283,0.568726766357,55.1630434782609
"6354614287.jpg",0,24,60,15,0,99,2.90909090909091,0.624187783932359,49.3318584070796
"6360259167.jpg",0,2,42,55,9,108,3.65740740740741,0.657978169638111,71.4868421052632
"6363131561.jpg",1,3,67,38,1,110,3.31818181818182,0.589383415677403,60.25
"6366256547.jpg",0,3,41,61,3,108,3.59259259259259,0.596516946936129,71.3075221238938
"6366296433.jpg",0,3,62,45,1,111,3.3963963963964,0.560507550501074,66.7902542372881
"6366361319.jpg",0,2,41,59,1,103,3.57281553398058,0.553100738042354,72.1857142857143
"6366516291.jpg",0,8,58,36,0,102,3.27450980392157,0.599618075558597,62.7971698113208
"6366586615.jpg",5,50,48,3,0,106,2.4622641509434,0.635078222431983,38.6939655172414
"6367495079.jpg",1,12,71,26,0,110,3.10909090909091,0.610991892398866,57.5512820512821
"6368218585.jpg",0,1,38,61,5,105,3.66666666666667,0.582875278034323,72.4521739130435
"6371973185.jpg",0,9,67,32,0,108,3.21296296296296,0.58086184639443,59.3
"6372460147.jpg",0,7,41,59,2,109,3.51376146788991,0.64714013164307,65.8214285714286
"6373766117.jpg",0,6,73,28,1,108,3.22222222222222,0.552535926574701,60.8672566371681
"6376701103.jpg",1,5,67,30,0,103,3.22330097087379,0.576195072410062,60.7948717948718
"6378298689.jpg",2,30,67,6,0,105,2.73333333333333,0.592690518974322,46.7368421052632
"6379014005.jpg",1,40,53,10,0,104,2.69230769230769,0.65473515103323,44.7544642857143
"6379443681.jpg",0,26,76,6,1,109,2.8348623853211,0.553001263609331,47.921875
"6383007575.jpg",0,0,21,84,3,108,3.83333333333333,0.44301431381276,74.6953781512605
"6385141033.jpg",4,34,101,17,0,156,2.83974358974359,0.63750314227481,51.2783018867925
"6385461657.jpg",0,2,72,58,0,132,3.42424242424242,0.525984531180724,67.1860902255639
"6386599471.jpg",1,29,56,15,0,101,2.84158415841584,0.674279960659172,48.4953271028037
"63888840.jpg",2,43,51,12,0,108,2.67592592592593,0.694823364950002,45.6470588235294
"6389008737.jpg",1,2,43,56,2,104,3.53846153846154,0.62197738108714,69.6462264150943
"6391074279.jpg",0,0,23,74,7,104,3.84615384615385,0.517072242783258,76.6973684210526
"6391919133.jpg",0,3,42,52,1,98,3.52040816326531,0.57847278200474,64.4446902654867
"63920904.jpg",10,32,32,27,8,109,2.91743119266055,1.09821775118508,51.5227272727273
"6394609023.jpg",0,7,50,51,2,110,3.43636363636364,0.642918699145877,65.405462184874
"6395582961.jpg",0,0,16,79,5,100,3.89,0.447100648511037,77.3125
"6396984107.jpg",0,3,51,55,4,113,3.53097345132743,0.613403800528788,66.7179487179487
"6398001637.jpg",0,1,13,88,10,112,3.95535714285714,0.491154052953148,78.9804347826087
"6399276439.jpg",0,1,42,59,0,102,3.56862745098039,0.517224196779339,71.575
"6403149971.jpg",5,60,38,1,0,104,2.33653846153846,0.584767432371758,35.3231132075472
"640351831.jpg",0,1,45,60,3,109,3.59633027522936,0.563048350911192,69.6776315789474
"6407770545.jpg",0,10,53,41,3,107,3.34579439252336,0.688213488957717,61.3844537815126
"6407934435.jpg",0,2,41,60,0,103,3.56310679611651,0.53632560553216,72.8716216216216
"6408708033.jpg",1,31,62,11,0,105,2.79047619047619,0.630860799214334,47.7008928571429
"6408799339.jpg",0,3,43,57,1,104,3.53846153846154,0.573239422405291,67.489406779661
"6408985463.jpg",0,28,61,10,0,99,2.81818181818182,0.595281383707316,48.7591743119266
"6410507631.jpg",0,1,52,47,0,100,3.46,0.52068331172711,67.75
"6411216741.jpg",0,0,39,62,2,103,3.64077669902913,0.521204655375482,72.3971962616822
"6411944553.jpg",0,16,67,21,0,104,3.04807692307692,0.597402267951459,56.9977876106195
"6412693303.jpg",0,23,68,7,0,98,2.83673469387755,0.531364273114677,48.3807339449541
"6415648509.jpg",1,3,55,48,2,109,3.43119266055046,0.629034717246345,68.0951327433628
"641595598.jpg",0,0,19,86,1,106,3.83018867924528,0.401703470668117,74.7478260869565
"6419047435.jpg",0,3,51,50,2,106,3.4811320754717,0.589287415935903,67.8009708737864
"6419135601.jpg",0,3,67,36,3,109,3.35779816513761,0.585676812974409,63.35625
"6419593777.jpg",0,2,53,47,1,103,3.45631067961165,0.556189751601725,68.4121621621622
"6422846525.jpg",0,1,34,64,1,100,3.65,0.519809599951771,71.6169724770642
"6423969851.jpg",1,46,63,10,0,120,2.68333333333333,0.634886787146336,45.4390756302521
"6424074571.jpg",13,81,16,1,0,111,2.04504504504505,0.545850252315136,25.8217391304348
"6427589897.jpg",19,64,18,1,0,102,2.00980392156863,0.637058494589801,26.7905405405405
"6430851513.jpg",2,51,48,1,0,102,2.47058823529412,0.55768052803139,38.575
"6431960911.jpg",0,9,74,17,0,100,3.08,0.50612411142092,54.8142201834862
"6433692937.jpg",1,39,57,8,0,105,2.68571428571429,0.625027471923707,45.7742718446602
"6434043361.jpg",0,3,56,44,1,104,3.41346153846154,0.567922067043096,64.6730769230769
"6434876963.jpg",58,40,3,0,0,101,1.45544554455446,0.557220826517594,11.0022123893805
"6435747701.jpg",0,3,22,68,8,101,3.8019801980198,0.616762547179999,74.3173913043478
"6437207759.jpg",0,1,27,75,3,106,3.75471698113208,0.512906206123813,74.5133928571429
"6438830749.jpg",0,0,27,74,1,102,3.74509803921569,0.460010213184165,77.4711538461538
"6439148467.jpg",0,3,37,56,6,102,3.63725490196078,0.641613308272179,71.5
"6439499095.jpg",0,4,47,48,1,100,3.46,0.593227774062537,67.525
"6440356973.jpg",1,23,66,14,0,104,2.89423076923077,0.621902331025801,52.4678899082569
"6440541263.jpg",0,1,30,71,5,107,3.74766355140187,0.551044598816994,75.3193277310924
"6441383857.jpg",0,1,34,65,3,103,3.67961165048544,0.546173717839859,74.1603773584906
"6441809623.jpg",0,17,70,12,0,99,2.94949494949495,0.541610172592673,53.1985981308411
"6443379565.jpg",0,0,39,58,7,104,3.69230769230769,0.592459462820778,70.3846153846154
"6443396365.jpg",1,13,64,26,2,106,3.14150943396226,0.682274616478662,56.0233050847458
"6443711585.jpg",5,36,55,9,0,105,2.64761904761905,0.706847720257836,45.4459459459459
"6445980191.jpg",0,4,56,50,0,110,3.41818181818182,0.564741041277403,63.8109243697479
"6449745557.jpg",0,0,27,75,0,102,3.73529411764706,0.443355133075576,73.785046728972
"6450022679.jpg",0,1,48,60,1,110,3.55454545454545,0.534778761361184,66.9306722689076
"6450302367.jpg",0,5,76,26,0,107,3.19626168224299,0.503558138451676,61.4485981308411
"6451339307.jpg",0,4,74,31,0,109,3.24770642201835,0.512003387263685,62.6578947368421
"6452060589.jpg",0,8,65,28,0,101,3.1980198019802,0.566035369569747,62.0661764705882
"6452529101.jpg",0,3,57,47,0,107,3.41121495327103,0.548639329374549,66.2887931034483
"6452613567.jpg",0,0,23,73,12,108,3.89814814814815,0.562700677637197,76.41875
"6453185751.jpg",0,11,65,38,0,114,3.23684210526316,0.614033978751189,60.5525210084034
"6453831461.jpg",11,44,46,7,0,108,2.4537037037037,0.765912311167127,38.0871559633027
"6458056243.jpg",2,39,63,2,0,106,2.61320754716981,0.561812622838427,42.6880530973451
"6458754563.jpg",0,2,47,49,5,103,3.55339805825243,0.621953836944761,69.0625
"6459542105.jpg",0,17,67,17,2,103,3.03883495145631,0.640501183925179,55.75
"6459811757.jpg",0,0,50,65,0,115,3.56521739130435,0.497897945976051,68.2913043478261
"6461549237.jpg",23,74,9,0,0,106,1.86792452830189,0.535865507257953,22.4797297297297
"6462096609.jpg",1,17,72,12,0,102,2.93137254901961,0.567429568562114,51.2710280373832
"6462502847.jpg",0,2,59,39,2,102,3.40196078431373,0.567429568562114,67.3784403669725
"6464291091.jpg",0,0,23,76,4,103,3.81553398058252,0.479942251745426,77.3310810810811
"6464821041.jpg",0,5,72,32,0,109,3.24770642201835,0.529779187103462,60.6482300884956
"6465089945.jpg",2,40,58,1,0,101,2.57425742574257,0.55401326073417,42.325
"6465343643.jpg",0,1,63,39,0,103,3.36893203883495,0.504689601017511,64.8985849056604
"6467546565.jpg",5,83,19,0,0,107,2.13084112149533,0.457311919263665,29.7710084033613
"6468297341.jpg",0,9,85,16,0,110,3.06363636363636,0.474627284525461,56.7923728813559
"6469192803.jpg",8,71,29,0,0,108,2.19444444444444,0.554646192409084,32.0848214285714
"6469390735.jpg",5,54,48,0,0,107,2.4018691588785,0.58049772209769,39.1737288135593
"6470955539.jpg",0,2,64,40,0,106,3.35849056603774,0.519865902952877,64.4316037735849
"6471980333.jpg",0,8,65,33,1,107,3.25233644859813,0.600211565591906,59.728813559322
"6473904775.jpg",15,63,31,2,0,111,2.18018018018018,0.67686709046094,31.4615384615385
"6474704871.jpg",0,17,64,25,0,106,3.07547169811321,0.627893124171503,55.65625
"6475916177.jpg",0,6,67,28,1,102,3.23529411764706,0.565973630359299,60.1602564102564
"6475932467.jpg",0,2,40,67,4,113,3.64601769911504,0.581260237733202,71.33125
"6476406225.jpg",0,1,17,93,4,115,3.8695652173913,0.449595122547114,79.864406779661
"6476717611.jpg",1,28,70,7,0,106,2.78301886792453,0.569121578460334,48.953125
"6479303397.jpg",14,68,18,1,0,101,2.05940594059406,0.597022314125993,28.975
"6479556701.jpg",0,26,65,12,1,104,2.88461538461538,0.627952325005221,50.3526785714286
"6480739257.jpg",0,30,70,11,0,111,2.82882882882883,0.585799746638169,49.46875
"6481674971.jpg",1,18,69,14,0,102,2.94117647058824,0.594088525786005,53.425
"6483140329.jpg",7,63,31,0,0,101,2.23762376237624,0.568304757176731,31.25
"6486375983.jpg",32,60,11,1,0,104,1.81730769230769,0.65008473050323,20.661214953271
"6486604889.jpg",6,39,43,13,2,103,2.66990291262136,0.844687545371162,45
"6486906969.jpg",5,54,44,4,0,107,2.4392523364486,0.646873031393711,38.2385321100917
"6489144861.jpg",0,4,50,52,0,106,3.45283018867925,0.571248848646511,66.9256756756757
"6489257695.jpg",0,9,51,42,3,105,3.37142857142857,0.68299598570088,62.875
"6490629733.jpg",0,1,42,59,5,107,3.63551401869159,0.589091455315854,71.5913043478261
"6491835829.jpg",0,0,23,60,18,101,3.95049504950495,0.638376654080683,79.1857798165138
"6493285057.jpg",0,1,30,64,4,99,3.71717171717172,0.55402799679505,71.3075221238938
"6493347009.jpg",0,1,36,65,2,104,3.65384615384615,0.535519542113137,75.552752293578
"6493679161.jpg",0,4,69,30,1,104,3.26923076923077,0.543822665820023,63.4876237623762
"6494527059.jpg",0,29,71,2,0,102,2.73529411764706,0.485970919315653,46.675
"6495386031.jpg",0,5,46,59,2,112,3.51785714285714,0.614863097003413,68.9576271186441
"6496266341.jpg",5,65,30,3,1,104,2.32692307692308,0.660131021009601,35.8982300884956
"6497142149.jpg",0,13,54,36,8,111,3.35135135135135,0.782172367060875,63.0148305084746
"649761301.jpg",6,80,41,0,0,127,2.2755905511811,0.544484106409208,33.6071428571429
"6498451617.jpg",0,14,94,24,0,132,3.07575757575758,0.533191630492889,56.5055147058824
"6500646971.jpg",0,1,24,72,0,97,3.7319587628866,0.468051455449562,78.6745283018868
"6504283859.jpg",0,25,71,4,0,100,2.79,0.498381217928443,49.894495412844
"6508138341.jpg",45,61,0,0,0,106,1.57547169811321,0.496619298620989,15.7065217391304
"6511236583.jpg",0,3,49,60,1,113,3.52212389380531,0.568477684144608,68.4558823529412
"6512316735.jpg",0,0,53,52,1,106,3.50943396226415,0.520901837363733,69.4308035714286
"6512617013.jpg",0,0,15,76,17,108,4.01851851851852,0.546552175027866,80.26875
"6512960549.jpg",0,3,53,46,3,105,3.46666666666667,0.605530070819498,65.8620689655172
"6513274589.jpg",0,8,70,31,0,109,3.21100917431193,0.562293492881853,59.6261061946903
"6513828853.jpg",32,71,5,0,0,108,1.75,0.531705068975115,19.5105042016807
"6515985695.jpg",12,74,17,0,0,103,2.04854368932039,0.530974700787572,27.9598214285714
"6517362491.jpg",0,5,64,35,0,104,3.28846153846154,0.551662569637779,61.9504310344828
"6517732881.jpg",0,2,43,55,1,101,3.54455445544554,0.557220826517594,72.175
"6520839597.jpg",0,13,62,31,0,106,3.16981132075472,0.624449443044222,57.5021008403361
"6521275803.jpg",4,61,38,3,0,106,2.37735849056604,0.608711835626666,36.6214953271028
"6521723915.jpg",0,2,37,55,3,97,3.60824742268041,0.587308497705987,72.7522935779816
"6522952765.jpg",0,4,62,32,2,100,3.32,0.583960701597377,61.6261467889908
"6523676619.jpg",1,5,75,19,1,101,3.13861386138614,0.548264588867401,56.4036697247706
"6526093429.jpg",5,35,62,9,0,111,2.67567567567568,0.689692450064285,46.6217948717949
"6527460609.jpg",0,2,69,57,1,129,3.44186046511628,0.543526918954257,69
"6530075543.jpg",0,1,19,84,3,107,3.83177570093458,0.46552833260779,81.2640186915888
"6530161213.jpg",0,17,67,27,0,111,3.09009009009009,0.625947275583169,54.7648305084746
"6531551463.jpg",0,23,65,14,0,102,2.91176470588235,0.598727051921314,53.2991071428571
"6533123895.jpg",0,0,29,72,3,104,3.75,0.497566895536651,74.2278761061947
"6534182163.jpg",15,86,10,0,0,111,1.95495495495495,0.47457899787625,25.8205128205128
"6534779805.jpg",4,88,42,1,0,135,2.2962962962963,0.533561311141816,34.3101503759398
"6534801331.jpg",1,25,75,8,0,109,2.8256880733945,0.558503899274291,49.8653846153846
"6537150655.jpg",0,0,18,78,10,106,3.92452830188679,0.510799806233829,79.8413043478261
"6537249483.jpg",0,2,24,68,12,106,3.84905660377358,0.629322429740926,75.3217391304348
"6537543865.jpg",9,60,34,2,0,105,2.27619047619048,0.642938537785661,32.5398230088496
"6538847583.jpg",0,5,61,35,0,101,3.2970297029703,0.557576083695231,64.7083333333333
"6540737111.jpg",3,14,68,19,0,104,2.99038461538462,0.66090835267441,53.3243243243243
"6543370923.jpg",0,3,65,36,1,105,3.33333333333333,0.548891657143786,64.9557522123894
"6543602941.jpg",0,16,47,35,0,98,3.19387755102041,0.698424785304732,55.3185840707965
"6544670475.jpg",0,14,72,23,1,110,3.1,0.605024830789249,56.0486725663717
"6550772311.jpg",0,8,47,51,3,109,3.44954128440367,0.673386116359509,64.525
"6551619395.jpg",0,6,46,46,5,103,3.48543689320388,0.684049041784815,69.0442477876106
"6553742481.jpg",44,57,3,0,0,104,1.60576923076923,0.547159819941693,15.5848214285714
"6555285779.jpg",0,28,76,8,0,112,2.82142857142857,0.540508364550718,48.0320512820513
"6558436183.jpg",0,1,31,66,2,100,3.69,0.525991127935317,73.8119266055046
"6560010177.jpg",2,31,64,3,0,100,2.68,0.566399223876658,45.3532110091743
"6561794905.jpg",0,5,57,47,1,110,3.4,0.593543240195398,65.3794642857143
"6563196289.jpg",0,16,69,19,0,104,3.02884615384615,0.582207562647962,52.6554054054054
"6563980965.jpg",0,0,11,81,16,108,4.0462962962963,0.500173040323575,81.1625
"6564623827.jpg",0,1,33,71,4,109,3.71559633027523,0.545889405419606,73.9915254237288
"6564941395.jpg",0,1,45,59,2,107,3.57943925233645,0.550083753101153,72.3296460176991
"656718644.jpg",16,85,24,2,0,127,2.09448818897638,0.609879910975738,27.9711538461538
"6568238645.jpg",0,8,68,24,1,101,3.17821782178218,0.57264368684131,56.9247787610619
"6568691361.jpg",0,5,54,43,1,103,3.38834951456311,0.597921394740962,65.2162162162162
"6569563105.jpg",0,3,51,49,3,106,3.49056603773585,0.605455877341205,66.0043103448276
"6569780821.jpg",1,31,89,8,0,129,2.8062015503876,0.545972746856542,49.7204724409449
"6569878593.jpg",1,3,59,44,2,109,3.39449541284404,0.623881942533605,65.0588235294118
"657099880.jpg",2,28,88,8,0,126,2.80952380952381,0.561630280013971,51.1707317073171
"6573749079.jpg",0,2,37,66,2,107,3.63551401869159,0.556141073532199,73.1689189189189
"6576363795.jpg",16,59,23,5,0,103,2.16504854368932,0.742242064244632,31.7640186915888
"6576807711.jpg",0,0,23,74,6,103,3.83495145631068,0.506759938112031,76.7565217391304
"6577277115.jpg",0,8,81,43,1,133,3.2781954887218,0.581968751877034,62.5485611510791
"6577912541.jpg",0,0,46,49,5,100,3.59,0.587667878442863,72.5763888888889
"6578628541.jpg",0,17,64,27,0,108,3.09259259259259,0.634477296634495,55.7689075630252
"6579889887.jpg",0,3,55,47,1,106,3.43396226415094,0.569358334309913,64.1334745762712
"6579913923.jpg",0,3,57,44,1,105,3.40952380952381,0.566623570867177,65.1347826086957
"6584540793.jpg",0,1,48,52,3,104,3.54807692307692,0.572506118885479,72.0589622641509
"6585039061.jpg",64,36,5,1,0,106,1.4622641509434,0.635078222431983,12.8156779661017
"6585164875.jpg",0,10,62,33,1,106,3.23584905660377,0.625671247807053,60.2058823529412
"6585714605.jpg",0,0,22,71,16,109,3.94495412844037,0.590587629295024,80.40625
"6587178245.jpg",0,2,40,65,0,107,3.58878504672897,0.531165877300352,69.703781512605
"6587673561.jpg",0,13,74,18,0,105,3.04761904761905,0.543863535997354,55.4054054054054
"6590042471.jpg",4,28,65,10,0,107,2.75700934579439,0.670695520369644,47.725
"6591706349.jpg",0,10,47,42,2,101,3.35643564356436,0.686791939612596,63.4426605504587
"6593133897.jpg",0,7,54,44,0,105,3.35238095238095,0.604167456106596,62.8391304347826
"6593145547.jpg",0,2,59,51,1,113,3.45132743362832,0.550829738447856,68.6217948717949
"6594506719.jpg",0,20,73,12,0,105,2.92380952380952,0.549391938265845,52.7098214285714
"6595488751.jpg",0,10,46,48,2,106,3.39622641509434,0.685624432567636,64.343220338983
"6596085063.jpg",0,4,74,29,1,108,3.25,0.531705068975115,62.1111111111111
"6596093581.jpg",0,0,38,63,2,103,3.6504854368932,0.518458080898139,73
"6596306.jpg",0,56,40,6,0,102,2.50980392156863,0.609253691152125,40.6282051282051
"6598075737.jpg",0,3,46,80,0,129,3.5968992248062,0.537926863130593,73.755905511811
"6598327095.jpg",0,12,60,41,0,113,3.25663716814159,0.637780205393605,62.0215517241379
"6599488221.jpg",0,1,35,72,2,110,3.68181818181818,0.523429379441696,73.8504464285714
"6599596287.jpg",0,2,44,59,1,106,3.55660377358491,0.553434104637671,71.6456310679612
"6599722517.jpg",7,53,39,2,0,101,2.35643564356436,0.641625411215011,36.6283185840708
"6602696603.jpg",0,20,81,9,0,110,2.9,0.505928159675159,51.3761061946903
"6602870035.jpg",0,1,31,73,5,110,3.74545454545455,0.549167236712308,72.0609243697479
"6603102821.jpg",0,1,44,59,1,105,3.57142857142857,0.534522483824849,68.0405405405405
"6603666933.jpg",0,16,79,11,0,106,2.95283018867925,0.504872930202633,52.6336206896552
"6604046527.jpg",0,12,77,14,1,104,3.03846153846154,0.538301480532277,55.9026548672566
"6605703733.jpg",0,2,36,63,6,107,3.68224299065421,0.608092142365009,71.3676470588235
"6606950227.jpg",0,1,23,60,24,108,3.99074074074074,0.690325270351178,80.6575630252101
"6608109869.jpg",0,0,44,58,0,102,3.56862745098039,0.497713662195456,70.0070093457944
"6608146543.jpg",0,3,62,36,0,101,3.32673267326733,0.531204497177671,63.4861111111111
"6609931137.jpg",0,4,62,50,1,117,3.41025641025641,0.574664012089195,67.2115384615385
"6612589223.jpg",0,45,62,1,0,108,2.59259259259259,0.512225071679205,43.2617924528302
"6613235741.jpg",6,44,48,6,0,104,2.51923076923077,0.696464988502015,42.3308823529412
"6617069623.jpg",3,71,30,1,0,105,2.27619047619048,0.527972138237027,33.6413043478261
"6617738113.jpg",2,29,81,15,1,128,2.875,0.652071200401997,50.6309523809524
"6621080809.jpg",2,34,62,12,0,110,2.76363636363636,0.662595296622246,47.9615384615385
"6621488051.jpg",0,3,53,52,1,109,3.46788990825688,0.570393096087146,66.5840336134454
"6621968211.jpg",0,12,72,21,0,105,3.08571428571429,0.556677743304068,55.8772321428571
"6622105827.jpg",0,0,14,85,9,108,3.9537037037037,0.461291548477137,78.3262711864407
"6622490475.jpg",0,2,28,68,4,102,3.72549019607843,0.565630512031092,71.6315789473684
"6622717529.jpg",0,1,32,60,11,104,3.77884615384615,0.637908152521211,74.5387931034483
"6622738777.jpg",3,25,68,18,0,114,2.8859649122807,0.688190804086158,49.7176724137931
"6623118287.jpg",1,19,101,27,0,148,3.04054054054054,0.581791490554252,56.7678571428571
"6625886365.jpg",29,67,6,0,0,102,1.77450980392157,0.543309673108284,20.2013274336283
"6626107981.jpg",0,25,77,3,0,105,2.79047619047619,0.474245110579355,47.4418103448276
"6627549719.jpg",0,6,70,31,0,107,3.23364485981308,0.542173112581533,61.4760869565217
"6628327223.jpg",0,2,42,58,1,103,3.56310679611651,0.554304066633732,71.6698113207547
"6628854085.jpg",2,18,64,18,0,102,2.96078431372549,0.658855422585499,52.6
"6629226527.jpg",0,1,52,57,0,110,3.50909090909091,0.520152668934002,67.89375
"6630214003.jpg",0,1,29,66,7,103,3.76699029126214,0.580802073794872,72.7972972972973
"6630840931.jpg",2,26,72,10,0,110,2.81818181818182,0.608529859983942,48.50625
"6632573597.jpg",0,18,69,14,2,103,3,0.626224291085149,53.125
"6633974935.jpg",0,2,34,68,0,104,3.63461538461538,0.522460428337392,74.2794117647059
"6635887941.jpg",0,2,71,34,0,107,3.29906542056075,0.499338303120032,62.0353982300885
"6638453859.jpg",0,2,31,68,2,103,3.67961165048544,0.546173717839859,75.85
"6639033203.jpg",0,0,44,57,1,102,3.57843137254902,0.515814735906503,72.9044117647059
"6640061445.jpg",0,21,67,14,0,102,2.93137254901961,0.584618076590697,50.5756880733945
"6640354399.jpg",0,36,64,8,0,108,2.74074074074074,0.585979017364931,47.0810810810811
"6641523883.jpg",0,2,65,41,0,108,3.36111111111111,0.519855000152735,64.7565789473684
"6641795483.jpg",0,0,31,69,7,107,3.77570093457944,0.554712422774405,72.6848739495798
"6642387989.jpg",0,1,21,72,8,102,3.85294117647059,0.552170493535534,82.5660377358491
"6642761299.jpg",0,12,100,28,0,140,3.11428571428571,0.524036825079168,59.0287162162162
"6642932619.jpg",0,4,49,49,1,103,3.45631067961165,0.590392010499209,67.8102678571429
"6643514423.jpg",0,1,44,53,1,99,3.54545454545455,0.539703759874809,68.8092105263158
"6643932717.jpg",9,75,22,1,0,107,2.14018691588785,0.55709147195867,30.1351351351351
"6644227727.jpg",46,76,7,0,0,129,1.69767441860465,0.567404330630816,16.375
"6644440429.jpg",1,54,53,0,0,108,2.48148148148148,0.520270984055541,39.6848739495798
"6645063001.jpg",1,47,51,7,0,106,2.60377358490566,0.627606872447408,43.3686440677966
"6647398937.jpg",0,44,56,6,0,106,2.64150943396226,0.588600911691008,43.9717391304348
"6648576397.jpg",2,48,42,3,0,95,2.48421052631579,0.598991313380285,40.1470588235294
"6649624069.jpg",0,3,64,37,2,106,3.35849056603774,0.572191763481324,64.345652173913
"6650873585.jpg",0,1,50,55,2,108,3.53703703703704,0.554099858167321,69.7743362831858
"665094052.jpg",8,72,23,0,0,103,2.14563106796116,0.531512215385263,29.8026315789474
"6652263581.jpg",0,28,67,13,0,108,2.86111111111111,0.60308139177812,49.5987394957983
"6652379747.jpg",5,68,32,1,0,106,2.27358490566038,0.561172562678651,33.5805084745763
"6653174291.jpg",0,8,70,22,0,100,3.14,0.532195756495975,58.2873831775701
"6654258389.jpg",0,2,54,53,2,111,3.4954954954955,0.570069754485822,66.4978260869565
"6654380789.jpg",0,0,24,74,6,104,3.82692307692308,0.510896940043469,79.7794117647059
"6655597997.jpg",0,9,72,30,0,111,3.18918918918919,0.564293822779869,60.6702586206897
"6656239161.jpg",0,39,53,4,0,96,2.63541666666667,0.564190928240407,43.5857142857143
"6656519345.jpg",11,78,13,0,0,102,2.01960784313725,0.487068258311613,26.3392857142857
"6656935539.jpg",34,52,10,0,0,96,1.75,0.632455532033676,17.9714285714286
"6657341905.jpg",0,16,81,4,0,101,2.88118811881188,0.430978623898478,50.0416666666667
"6657359355.jpg",2,41,65,2,0,110,2.60909090909091,0.560069696604103,43.4911504424779
"6658108283.jpg",18,67,15,5,0,105,2.06666666666667,0.71072371926664,26.9695652173913
"6658947687.jpg",1,35,55,10,2,103,2.77669902912621,0.713071770374435,47.6995412844037
"6661527913.jpg",0,1,39,61,4,105,3.64761904761905,0.571451464742874,70.195945945946
"6661741471.jpg",29,71,6,0,0,106,1.78301886792453,0.534606521634318,19.8771186440678
"6663294041.jpg",0,7,76,20,0,103,3.12621359223301,0.498617926155918,57.8815789473684
"6663775735.jpg",0,2,37,55,7,101,3.66336633663366,0.636823801734393,72.1283783783784
"6665024915.jpg",1,13,79,16,0,109,3.00917431192661,0.552693955297959,54.2631578947368
"6666568019.jpg",0,0,63,41,0,104,3.39423076923077,0.491051363274922,66.4551886792453
"6668846319.jpg",0,6,71,32,0,109,3.23853211009174,0.542611698158005,61.6964285714286
"6669002441.jpg",0,1,45,79,4,129,3.66666666666667,0.549621081594705,74.60546875
"6669862645.jpg",0,8,76,19,0,103,3.10679611650485,0.503178550916489,58.5165094339623
"6670935319.jpg",2,13,74,16,0,105,2.99047619047619,0.596387169276516,54.2566964285714
"6678741473.jpg",0,2,21,71,6,100,3.81,0.563090318750649,74.8119469026549
"6679121211.jpg",0,0,30,73,3,106,3.74528301886792,0.498785587196151,72.2179487179487
"6679373485.jpg",1,47,60,2,0,110,2.57272727272727,0.549546784229254,42.6625
"6681014309.jpg",0,10,73,24,0,107,3.13084112149533,0.550884574245936,59.4504716981132
"6681296959.jpg",0,3,46,56,5,110,3.57272727272727,0.627490866326171,69.6517857142857
"6681716765.jpg",0,2,38,71,2,113,3.64601769911504,0.549680978618847,69.9870689655172
"6681891719.jpg",15,74,11,1,0,101,1.98019801980198,0.54736090506725,24.3876146788991
"66839471.jpg",0,4,53,43,0,100,3.39,0.566666666666667,63.7954545454545
"6685463337.jpg",0,4,38,56,8,106,3.64150943396226,0.678775918495346,70.9516806722689
"6686438027.jpg",0,3,39,59,2,103,3.58252427184466,0.586185272268683,69.175
"6688716327.jpg",0,1,26,73,4,104,3.76923076923077,0.525666829970697,75.5584112149533
"6688906197.jpg",0,1,75,23,0,99,3.22222222222222,0.441600880737891,59.9065420560748
"6691471103.jpg",0,2,74,27,0,103,3.24271844660194,0.474155997691248,63.497641509434
"6692795337.jpg",0,2,45,72,2,121,3.61157024793388,0.553351919764844,72.3834745762712
"6693843973.jpg",1,61,37,1,0,100,2.38,0.527620922996651,35.6651376146789
"6694664547.jpg",0,2,55,47,0,104,3.43269230769231,0.535432373634963,66.4602803738318
"6694665963.jpg",2,41,54,13,0,110,2.70909090909091,0.695271771105669,44.725
"6694669509.jpg",0,3,70,34,0,107,3.28971962616822,0.514127687583038,64.6869158878505
"669490972.jpg",13,76,11,2,0,102,2.01960784313725,0.562533029294091,26.7523364485981
"6696229175.jpg",3,80,21,1,0,105,2.19047619047619,0.482286981579155,30.8040540540541
"6696763655.jpg",0,22,78,5,0,105,2.83809523809524,0.482856275873249,47.4799107142857
"6698669369.jpg",0,0,14,79,13,106,3.99056603773585,0.507003954504498,79.9130434782609
"6699302891.jpg",0,0,20,77,13,110,3.93636363636364,0.546503023439813,81.7162162162162
"6701756497.jpg",0,4,50,55,1,110,3.48181818181818,0.58626196013806,65.6016949152542
"6702372317.jpg",0,2,55,50,0,107,3.44859813084112,0.536122431451909,68.2452830188679
"6702441233.jpg",0,0,18,81,6,105,3.88571428571429,0.466457305208545,77.7608695652174
"6703759327.jpg",0,7,48,48,0,103,3.39805825242718,0.615801817897875,66.7642857142857
"6705759167.jpg",1,14,67,21,0,103,3.04854368932039,0.616419782747704,56.222972972973
"6705859439.jpg",0,1,37,66,2,106,3.65094339622642,0.535278349133619,72.3834745762712
"6707835355.jpg",0,2,25,77,1,105,3.73333333333333,0.505102172959299,74.7102803738318
"6708577729.jpg",0,0,56,44,1,101,3.45544554455446,0.520091385724615,65.9403669724771
"6708806483.jpg",0,1,45,60,0,106,3.55660377358491,0.517874569834108,69.1491596638655
"6710396995.jpg",0,1,8,82,19,110,4.08181818181818,0.526923182288805,79.925
"6710865793.jpg",0,1,64,39,1,105,3.38095238095238,0.525886657519257,63.8325892857143
"6711319143.jpg",0,2,29,57,19,107,3.86915887850467,0.714857317199347,74.5625
"6711335759.jpg",0,1,40,73,8,122,3.72131147540984,0.592826191996283,75.1818181818182
"6711764573.jpg",0,1,36,62,1,100,3.63,0.525222415609412,71.5490654205608
"6712830935.jpg",0,1,13,65,29,108,4.12962962962963,0.642608477952408,83.5
"6713488045.jpg",1,12,66,29,0,108,3.13888888888889,0.633316936990578,57.9539473684211
"6720918207.jpg",1,28,84,8,0,121,2.81818181818182,0.547722557505166,48.9747899159664
"6724979243.jpg",0,0,34,62,4,100,3.7,0.541229427257326,73.075
"6725311751.jpg",0,10,67,30,0,107,3.18691588785047,0.584885751164282,58.972972972973
"6727094363.jpg",12,80,18,1,0,111,2.07207207207207,0.551225275045787,28.6864406779661
"6727591153.jpg",0,0,39,64,4,107,3.67289719626168,0.545577432281346,72.7330508474576
"6727661759.jpg",0,11,59,36,1,107,3.25233644859813,0.645645178914234,60.4138655462185
"6728176335.jpg",0,2,57,45,3,107,3.45794392523365,0.587292698581456,66.9306722689076
"6728215257.jpg",0,0,66,40,1,107,3.39252336448598,0.509476411693017,64.9724576271186
"6729160073.jpg",0,4,39,66,2,111,3.59459459459459,0.593577418989429,72.6185344827586
"6729759239.jpg",0,0,12,80,9,101,3.97029702970297,0.457284277983717,77.9256756756757
"6730791971.jpg",0,2,43,59,2,106,3.57547169811321,0.568173568509905,73.1262376237624
"6731073163.jpg",0,3,51,49,1,104,3.46153846153846,0.573239422405291,65.6602564102564
"6731198091.jpg",0,0,15,78,9,102,3.94117647058824,0.483869088992539,80.4527027027027
"6733542819.jpg",1,5,59,38,0,103,3.30097087378641,0.607711093903304,60.0758928571429
"6735104841.jpg",2,7,35,62,5,111,3.54954954954955,0.759649904276949,67.9088983050847
"6736392821.jpg",0,35,65,7,0,107,2.73831775700935,0.571929019842775,46.8761682242991
"6737389193.jpg",0,5,44,48,4,101,3.5049504950495,0.657628502670583,67
"6738986329.jpg",0,4,36,49,11,100,3.67,0.725509225553774,70.6666666666667
"6739568529.jpg",0,5,74,21,1,101,3.17821782178218,0.517610656844706,57.9789719626168
"6739930655.jpg",0,9,76,16,1,102,3.08823529411765,0.528456395467316,59.4439252336449
"6741097253.jpg",0,15,71,26,0,112,3.09821428571429,0.59969694191018,57.8333333333333
"6743243667.jpg",0,1,28,71,3,103,3.7378640776699,0.523209646590323,76.5758928571429
"6745774611.jpg",3,61,43,1,0,108,2.38888888888889,0.560929357894812,36.2
"6746049049.jpg",0,7,65,34,1,107,3.27102803738318,0.591928308030625,62.077731092437
"6746835381.jpg",0,2,19,78,4,103,3.81553398058252,0.519191921436553,79.8602941176471
"6748049411.jpg",1,12,64,29,0,106,3.14150943396226,0.639027225670588,57.3869565217391
"6748287295.jpg",0,6,52,32,4,94,3.36170212765957,0.669634209725081,66.3653846153846
"6748422197.jpg",0,1,27,70,4,102,3.75490196078431,0.534665149393819,73.9864864864865
"6748739885.jpg",2,31,66,10,0,109,2.77064220183486,0.63293887603394,47.1029411764706
"6749061363.jpg",0,2,67,33,1,103,3.32038834951456,0.527918447226235,64.6201923076923
"6749191929.jpg",0,8,74,24,0,106,3.15094339622642,0.530811648599867,57.8891304347826
"6749380301.jpg",0,2,50,51,1,104,3.49038461538462,0.557302663192804,69.0067567567568
"6749631813.jpg",0,0,22,70,15,107,3.93457943925234,0.587142553443228,77.45
"6752719165.jpg",0,10,64,32,0,106,3.20754716981132,0.597087871527506,59.2478448275862
"6755602871.jpg",1,26,60,23,0,110,2.95454545454545,0.695811368991397,54.3782051282051
"6755644805.jpg",0,0,6,88,16,110,4.09090909090909,0.439880186886929,80.68125
"6757989209.jpg",0,0,45,62,2,109,3.60550458715596,0.527368530639052,70.4258474576271
"6759678037.jpg",81,27,3,0,0,111,1.2972972972973,0.515127426328928,8.41806722689076
"6762482065.jpg",0,2,55,42,4,103,3.46601941747573,0.607397759985128,66.3067226890756
"6764494191.jpg",3,41,59,6,0,109,2.62385321100917,0.635216364796543,43.0819327731092
"6766502563.jpg",0,9,57,39,3,108,3.33333333333333,0.669774686623137,62.05
"6766779583.jpg",0,4,49,60,0,113,3.49557522123894,0.568894507627822,66.4260869565217
"6766818267.jpg",2,37,55,13,0,107,2.73831775700935,0.691408851523274,48.2121848739496
"6769268131.jpg",0,4,43,50,2,99,3.50505050505051,0.612351395946061,67.9839449541284
"6769877279.jpg",0,1,36,64,3,104,3.66346153846154,0.550561530172921,73.8026315789474
"6771336533.jpg",11,67,28,1,0,107,2.17757009345794,0.611417840515743,31.1272321428571
"6772091149.jpg",0,11,73,23,1,108,3.12962962962963,0.581531857077601,59.265625
"6775082758.jpg",0,7,61,27,1,96,3.22916666666667,0.589007491091076,61.1071428571429
"6775674634.jpg",0,23,64,15,0,102,2.92156862745098,0.608296998034594,52.4457547169811
"6776603937.jpg",0,1,78,49,0,128,3.375,0.501964644110527,66.740157480315
"6777036983.jpg",0,3,25,72,3,103,3.72815533980583,0.563500522074354,78.5202702702703
"6778568929.jpg",0,10,49,49,2,110,3.39090909090909,0.678577229119796,61.7310924369748
"677921002.jpg",0,1,47,51,1,100,3.52,0.54085603678359,67.4626168224299
"6779633762.jpg",0,4,40,60,1,105,3.55238095238095,0.588037027565055,71.2428571428571
"6780493014.jpg",0,1,9,94,6,110,3.95454545454545,0.415002235792886,80.9830508474576
"6781694906.jpg",1,12,78,16,0,107,3.01869158878505,0.549121226111612,56.8897058823529
"6782077853.jpg",47,92,10,0,0,149,1.75167785234899,0.568378921338911,18.7401960784314
"6782624408.jpg",3,53,43,4,0,103,2.46601941747573,0.6233296735855,40.1875
"6782627736.jpg",0,0,49,50,1,100,3.52,0.521845985251618,68.8504672897196
"6782909752.jpg",0,11,50,41,4,106,3.35849056603774,0.71963852361589,62.875
"6784024897.jpg",0,0,26,72,6,104,3.80769230769231,0.522817666278851,75.5446428571429
"6784185258.jpg",55,40,3,0,0,98,1.46938775510204,0.559898400810326,11.0833333333333
"6785564222.jpg",6,29,54,20,0,109,2.80733944954128,0.799039518563143,47.68125
"6785846367.jpg",0,0,43,61,0,104,3.58653846153846,0.494838934727131,69.25
"6786638173.jpg",0,2,59,47,0,108,3.41666666666667,0.531705068975115,67.1542056074766
"6787512667.jpg",0,0,40,61,1,102,3.61764705882353,0.508231600107372,74.0600961538462
"6787714050.jpg",0,7,71,32,2,112,3.25892857142857,0.596469126003533,61.2884615384615
"6788163039.jpg",0,7,65,48,1,121,3.35537190082645,0.6035934632437,64.86875
"6788530155.jpg",11,66,24,0,0,101,2.12871287128713,0.577293102966486,28.975
"6788551083.jpg",66,42,1,0,0,109,1.40366972477064,0.511339309957935,11.0375
"6788897458.jpg",0,2,70,65,0,137,3.45985401459854,0.528797172004346,69.5384615384615
"6789727386.jpg",0,2,55,50,0,107,3.44859813084112,0.536122431451909,69.3130841121495
"6789846783.jpg",56,50,6,0,0,112,1.55357142857143,0.597883439697578,13.4121621621622
"6790082633.jpg",1,11,67,24,1,104,3.125,0.633797309181897,56.222972972973
"6791354533.jpg",6,64,33,3,0,106,2.31132075471698,0.622792597857498,35.7478813559322
"6791434529.jpg",0,2,37,60,5,104,3.65384615384615,0.603697840726373,72.4508928571429
"6791461596.jpg",0,5,78,26,0,109,3.19266055045872,0.499575082782089,60.2058823529412
"6791631777.jpg",0,1,25,65,16,107,3.89719626168224,0.643319508036135,79.4845132743363
"6793483796.jpg",0,4,63,44,0,111,3.36036036036036,0.552560861194046,67
"6793575356.jpg",0,12,72,26,0,110,3.12727272727273,0.576434642795271,57.7094594594595
"6793966090.jpg",1,3,55,50,1,110,3.42727272727273,0.612695816428967,63.15
"6795087227.jpg",16,70,17,3,0,106,2.06603773584906,0.651282513851062,29.39375
"6795803065.jpg",1,58,41,3,0,103,2.44660194174757,0.572715501692198,36.7991071428571
"6796559908.jpg",4,68,31,2,0,105,2.2952380952381,0.570489154548862,34.0717391304348
"6796759928.jpg",0,4,43,84,3,134,3.64179104477612,0.580419670241638,75.8082706766917
"6797193823.jpg",0,31,71,3,0,105,2.73333333333333,0.505102172959299,45.6217391304348
"6798093193.jpg",0,7,72,22,1,102,3.16666666666667,0.546516118688917,57.8660714285714
"6798101803.jpg",0,4,43,60,0,107,3.52336448598131,0.572083157837716,69.8285714285714
"6798563238.jpg",1,25,63,17,0,106,2.90566037735849,0.655065273182284,52.1019417475728
"6798891367.jpg",0,1,28,66,7,102,3.77450980392157,0.578609852395438,77.7323008849557
"6799140939.jpg",0,12,61,28,1,102,3.17647058823529,0.63576203135491,60.7935779816514
"6799306335.jpg",28,68,12,0,0,108,1.85185185185185,0.593025110417193,21.5114678899083
"6800438108.jpg",0,0,23,80,9,112,3.875,0.522036897663874,76.4487179487179
"6800703361.jpg",0,1,45,59,2,107,3.57943925233645,0.550083753101153,70.5357142857143
"6801180487.jpg",2,71,33,1,0,107,2.30841121495327,0.521449629494023,35.05
"6801462257.jpg",1,11,62,31,1,106,3.18867924528302,0.663514560749833,60.6102941176471
"6801568370.jpg",1,36,61,5,0,103,2.67961165048544,0.580965933883841,44.6071428571429
"6803183748.jpg",0,5,81,20,0,106,3.14150943396226,0.466775754160451,58.4553571428571
"6803244763.jpg",0,0,30,78,2,110,3.74545454545455,0.477692535492641,73.4977876106195
"6803834950.jpg",0,4,58,60,1,123,3.47154471544715,0.577234833765261,70.1524390243902
"6803864259.jpg",0,3,71,33,0,107,3.2803738317757,0.510168165455875,62.6
"6804651008.jpg",0,20,77,16,0,113,2.9646017699115,0.565830671601859,54.2436974789916
"6805903671.jpg",0,0,30,74,4,108,3.75925925925926,0.509175077217316,76.228813559322
"6807214777.jpg",0,16,66,20,0,102,3.03921568627451,0.595720191934298,55.1802884615385
"6808449405.jpg",0,3,59,43,3,108,3.42592592592593,0.599122468932278,67.8481308411215
"6808473551.jpg",1,29,67,5,0,102,2.74509803921569,0.557332304127295,47.275
"6809126683.jpg",0,29,66,5,0,100,2.76,0.534090371802868,46.2614678899083
"6809286909.jpg",16,81,8,0,0,105,1.92380952380952,0.474245110579355,22.6918103448276
"6810784384.jpg",0,30,68,7,0,105,2.78095238095238,0.554369919210997,47.1554054054054
"6810820079.jpg",0,0,26,81,3,110,3.79090909090909,0.47109971957979,74.6906779661017
"6811037194.jpg",8,48,44,5,0,105,2.43809523809524,0.70606996716671,38.1621621621622
"6811333589.jpg",0,2,46,88,3,139,3.66187050359712,0.545786984440383,75.7020547945205
"6812098169.jpg",0,1,25,71,3,100,3.76,0.514830559553826,75.6284403669725
"6812883252.jpg",0,5,69,66,0,140,3.43571428571429,0.565312853927834,68.9081632653061
"6813135887.jpg",0,0,54,46,1,101,3.47524752475248,0.521422274283341,66.1
"6813481975.jpg",0,3,70,54,0,127,3.40157480314961,0.538366761746795,68.4637096774194
"6813687716.jpg",0,7,59,29,0,95,3.23157894736842,0.573392880402916,62.3642857142857
"6814736135.jpg",0,38,62,11,0,111,2.75675675675676,0.621087260978186,46.3050847457627
"6814873580.jpg",13,66,25,3,0,107,2.16822429906542,0.665681397366797,31.0189075630252
"6815253808.jpg",2,44,59,1,1,107,2.57943925233645,0.599329549589169,42.7126168224299
"6815460393.jpg",0,10,65,27,0,102,3.16666666666667,0.581621722757015,57.9789719626168
"6817139940.jpg",1,6,72,26,1,106,3.18867924528302,0.587378478571482,59.9285714285714
"6818185643.jpg",0,9,46,44,6,105,3.44761904761905,0.733549751615552,65.8620689655172
"6818454464.jpg",0,3,47,49,6,105,3.55238095238095,0.650161997282695,69.6013513513514
"6818698150.jpg",0,6,56,36,1,99,3.32323232323232,0.603193589736868,64.25
"6818984013.jpg",0,31,69,9,0,109,2.79816513761468,0.573808209566535,49.5911016949153
"6820819077.jpg",0,3,40,54,1,98,3.54081632653061,0.577380636067711,70.4059633027523
"6823375889.jpg",4,28,68,5,0,105,2.7047619047619,0.618991262579839,44.3310810810811
"682337857.jpg",0,16,54,35,0,105,3.18095238095238,0.676258831606662,58.603982300885
"6823515263.jpg",0,4,58,38,1,101,3.35643564356436,0.575919411304074,64.0928571428571
"6824806522.jpg",5,73,21,2,0,101,2.1980198019802,0.548083971307281,30.9929906542056
"6825162524.jpg",15,72,20,0,0,107,2.04672897196262,0.572699294966035,28.0378151260504
"6825556474.jpg",0,6,68,25,1,100,3.21,0.555868598672293,59.2126168224299
"6826290090.jpg",0,3,37,59,4,103,3.62135922330097,0.612236415543079,68.4864864864865
"6827213168.jpg",0,33,65,9,0,107,2.77570093457944,0.587742903859208,48.8938053097345
"6827495732.jpg",1,18,70,15,0,104,2.95192307692308,0.597402267951459,54.3823529411765
"6827830343.jpg",5,74,30,0,0,109,2.22935779816514,0.520559306098236,33.3125
"6828049746.jpg",0,1,40,65,4,110,3.65454545454545,0.565626447164065,71.7763157894737
"6828526069.jpg",0,2,56,39,1,98,3.39795918367347,0.551283337227311,64.7640186915888
"6829189111.jpg",0,2,44,59,0,105,3.54285714285714,0.537597422809103,71.004854368932
"6829439085.jpg",2,15,67,23,0,107,3.03738317757009,0.657686534912265,55.5769230769231
"6830281130.jpg",0,1,23,72,5,101,3.8019801980198,0.529524352229395,76.1108695652174
"6831480328.jpg",0,0,32,64,8,104,3.76923076923077,0.578427215227558,75.6183035714286
"6831984052.jpg",0,2,29,75,1,107,3.70093457943925,0.517886730367843,76.3014705882353
"6832136083.jpg",3,58,39,1,0,101,2.37623762376238,0.563053907694722,34.8102678571429
"6832446699.jpg",0,30,88,8,0,126,2.82539682539683,0.522752179593583,51.5060975609756
"6833109332.jpg",0,2,37,69,4,112,3.66964285714286,0.575606109959227,70.8076923076923
"6834245510.jpg",0,5,80,71,1,157,3.43312101910828,0.569231210632313,69.1009316770186
"6834514891.jpg",8,78,19,1,0,106,2.12264150943396,0.529201198369576,28.8081896551724
"6834902092.jpg",0,8,115,29,0,152,3.13815789473684,0.475204272636476,60.0526315789474
"6835007518.jpg",2,68,37,1,0,108,2.34259259259259,0.532355671933666,35.0794392523364
"6835820588.jpg",0,7,78,23,0,108,3.14814814814815,0.50815434432866,59.4673913043478
"6836104801.jpg",0,1,39,61,2,103,3.62135922330097,0.544428191746183,71.7347826086957
"6836874905.jpg",0,0,43,69,0,112,3.61607142857143,0.488526663712741,68.2954545454545
"6837071286.jpg",0,3,46,52,1,102,3.5,0.575919411304074,65.7663551401869
"6837228368.jpg",0,2,48,56,2,108,3.53703703703704,0.570717304456499,69.5169491525424
"6837388142.jpg",0,13,74,20,0,107,3.06542056074766,0.554076284465623,56.3728813559322
"6837541080.jpg",0,1,36,64,5,106,3.68867924528302,0.575089352016914,72.9342105263158
"6837662382.jpg",0,0,36,66,2,104,3.67307692307692,0.51089694004347,71.5265486725664
"6837956899.jpg",3,15,53,32,1,104,3.125,0.77192861483933,56.6689189189189
"6838263860.jpg",4,49,47,4,0,104,2.49038461538462,0.638493255283538,39.6896551724138
"6840130023.jpg",0,1,43,58,4,106,3.61320754716981,0.578516241974426,71.304347826087
"6840500976.jpg",0,7,66,28,1,102,3.22549019607843,0.578609852395438,57.8417431192661
"6840900400.jpg",0,1,35,66,3,105,3.67619047619048,0.545880342186223,75.0073529411765
"6841095.jpg",9,79,14,0,0,102,2.04901960784314,0.474653620040621,27.0192307692308
"6842318096.jpg",0,1,55,50,1,107,3.47663551401869,0.538092269434313,66.5875
"6842750557.jpg",15,74,20,1,0,110,2.06363636363636,0.594736434219807,29.4166666666667
"6843523713.jpg",1,19,62,25,1,108,3.05555555555556,0.694885633477702,56.2894736842105
"6843525285.jpg",0,2,51,74,2,129,3.58914728682171,0.553573661267958,71.5343511450382
"6844145276.jpg",0,0,33,67,7,107,3.75700934579439,0.563699396261691,73.8504464285714
"6844398521.jpg",0,11,68,28,1,108,3.17592592592593,0.608793869688389,58.3119469026549
"6844773508.jpg",0,1,34,69,1,105,3.66666666666667,0.512660231362364,75.5767326732673
"6845434524.jpg",0,2,42,66,0,110,3.58181818181818,0.531258125581778,74.1041666666667
"6845552547.jpg",0,6,65,28,0,99,3.22222222222222,0.545024911536171,61.8819444444444
"6845847924.jpg",1,40,60,3,0,104,2.625,0.560642834922123,42.676724137931
"6845848072.jpg",0,2,28,77,4,111,3.74774774774775,0.547198957808492,77.3125
"6846284796.jpg",1,1,60,39,1,102,3.37254901960784,0.578861440139363,63.6116071428571
"6846869922.jpg",0,5,53,49,2,109,3.44036697247706,0.615106023088559,64.9375
"6849285524.jpg",19,69,17,1,0,106,2,0.617213399848368,27.2752100840336
"6849557935.jpg",33,61,17,0,0,111,1.85585585585586,0.658467184891574,23.0723684210526
"6849693569.jpg",0,2,40,62,2,106,3.60377358490566,0.563648747140221,71.5337837837838
"6850513360.jpg",0,0,37,105,2,144,3.75694444444444,0.461777165674258,78.8913793103448
"6851326367.jpg",4,40,56,8,0,108,2.62962962962963,0.677993088385809,43.8445378151261
"6853001361.jpg",0,2,33,72,1,108,3.66666666666667,0.529503382213656,75.1763392857143
"6854146276.jpg",0,2,35,64,2,103,3.64077669902913,0.557557153177668,73.1081730769231
"6854228547.jpg",0,7,78,25,0,110,3.16363636363636,0.516290095668838,58.0448717948718
"6855935825.jpg",0,0,38,68,4,110,3.69090909090909,0.53750109102436,74.2012711864407
"6856483689.jpg",0,13,72,17,1,103,3.05825242718447,0.574375069070326,56.1216814159292
"6857581314.jpg",0,3,62,34,2,101,3.34653465346535,0.573334868368503,65.4105504587156
"6858600475.jpg",1,9,72,24,0,106,3.12264150943396,0.580686460578041,59.6485148514851
"6860404399.jpg",1,50,54,3,0,108,2.5462962962963,0.570034582641014,41.5625
"6860502754.jpg",4,54,41,3,0,102,2.42156862745098,0.620384334881543,37.0275229357798
"68605475.jpg",0,40,53,12,0,105,2.73333333333333,0.654373844377301,46.58125
"6860584767.jpg",0,0,22,77,3,102,3.81372549019608,0.460958797515768,77.8783185840708
"6862937532.jpg",0,13,70,27,0,110,3.12727272727273,0.592136404274997,56.7787610619469
"6862989864.jpg",0,2,30,73,0,105,3.67619047619048,0.509434794182543,75.6504854368932
"6864569694.jpg",0,2,62,37,2,103,3.37864077669903,0.562147577692258,65.8851351351351
"6865288108.jpg",0,1,50,57,3,111,3.55855855855856,0.56704472622512,69.6776315789474
"6865774865.jpg",0,4,47,54,2,107,3.50467289719626,0.604602345155841,66.51875
"6866519003.jpg",0,3,47,46,0,96,3.44791666666667,0.559507145275228,67.1617647058823
"6866899862.jpg",0,6,64,32,1,103,3.27184466019417,0.58063816746346,59.6034482758621
"6867407079.jpg",1,29,72,5,0,107,2.75700934579439,0.546707494751528,48.2901785714286
"6869357574.jpg",0,43,61,4,0,108,2.63888888888889,0.554646192409083,43.3451327433628
"6869450975.jpg",3,32,66,10,0,111,2.74774774774775,0.653222340937163,47.6089743589744
"6869642911.jpg",0,6,48,55,2,111,3.47747747747748,0.630250265541711,69.6089743589744
"6869855884.jpg",6,72,47,0,0,125,2.328,0.564772292110266,35.140243902439
"6870048801.jpg",0,0,37,66,3,106,3.67924528301887,0.526392390510218,73.825
"6870564661.jpg",0,5,52,44,2,103,3.41747572815534,0.61873165403042,66.7027027027027
"6870596537.jpg",0,13,69,20,0,102,3.06862745098039,0.567429568562114,56.9084821428571
"6870782384.jpg",0,8,42,52,5,107,3.50467289719626,0.705421482141036,67
"6873503299.jpg",2,42,64,7,0,115,2.66086956521739,0.619662564113602,44.7179487179487
"6873701210.jpg",0,12,51,36,2,101,3.27722772277228,0.694533107651293,62.563679245283
"6874497596.jpg",3,41,49,7,0,100,2.6,0.666666666666667,41.7201834862385
"6874966846.jpg",1,1,44,59,0,105,3.53333333333333,0.572891899231546,71.5265486725664
"6875112664.jpg",0,4,91,30,0,125,3.208,0.480188135173382,62.7073170731707
"6875194504.jpg",0,19,111,12,1,143,2.96503496503496,0.495224908537972,54.35
"6875495692.jpg",0,16,67,22,0,105,3.05714285714286,0.601737411241741,55.7429906542056
"6877203986.jpg",0,4,58,47,0,109,3.39449541284404,0.561386323439955,68.464953271028
"6879970399.jpg",0,38,64,1,0,103,2.64077669902913,0.502042278745347,44.9513274336283
"6880912844.jpg",0,3,57,40,3,103,3.41747572815534,0.602678203158173,64.5472972972973
"6880980024.jpg",12,69,19,2,0,102,2.1078431372549,0.611876884418025,29.7163461538462
"688110993.jpg",0,0,41,59,1,101,3.6039603960396,0.511452987493319,69.3571428571429
"6881321836.jpg",44,82,13,0,0,139,1.77697841726619,0.60244869247683,18.6866438356164
"6881599127.jpg",0,4,37,54,6,101,3.61386138613861,0.662877017699407,74.0485436893204
"6882017804.jpg",1,33,58,14,0,106,2.80188679245283,0.667900923943703,46.9642857142857
"6883091790.jpg",0,8,81,17,0,106,3.08490566037736,0.480434813541747,56.4369158878505
"6883445766.jpg",1,9,65,27,1,103,3.1747572815534,0.632876787965461,55.8772321428571
"6884968602.jpg",3,69,37,1,0,110,2.32727272727273,0.543672373500889,36.2372881355932
"6886226928.jpg",0,4,46,55,2,107,3.51401869158878,0.604456499695956,68.0855263157895
"6886337587.jpg",0,5,64,36,0,105,3.2952380952381,0.553377905438143,61.8893805309735
"6887917604.jpg",4,30,67,5,0,106,2.68867924528302,0.622792597857498,47.1852678571429
"6890326436.jpg",0,5,62,37,1,105,3.32380952380952,0.58004041794248,62.05
"6890378940.jpg",0,1,33,62,5,101,3.7029702970297,0.575231335298166,75.775
"6890379430.jpg",0,8,65,39,1,113,3.29203539823009,0.607709633571641,60.3012820512821
"6890554826.jpg",8,58,39,2,0,107,2.32710280373832,0.640985399041599,35.4513888888889
"6890677809.jpg",0,0,14,75,12,101,3.98019801980198,0.509513454578031,80.05
"6891271025.jpg",0,0,17,83,5,105,3.88571428571429,0.445366869391571,81.5111607142857
"6891596982.jpg",0,5,67,31,1,104,3.26923076923077,0.561391634768236,64.6311881188119
"6891599340.jpg",0,5,65,34,1,105,3.2952380952381,0.570489154548862,63.2354368932039
"6891623153.jpg",1,8,76,19,0,104,3.08653846153846,0.54167265081622,55.9762931034483
"6891957010.jpg",1,2,40,61,2,106,3.57547169811321,0.616412249307342,67.7112068965517
"6892058753.jpg",0,2,42,61,3,108,3.60185185185185,0.579071361231418,68.85625
"6892553923.jpg",1,28,67,10,0,106,2.81132075471698,0.603374755965617,47.5328947368421
"6892713466.jpg",0,1,17,74,9,101,3.9009900990099,0.538608401253629,76.6123853211009
"6893014325.jpg",0,0,28,74,3,105,3.76190476190476,0.49075705888198,76.5607476635514
"6893891182.jpg",3,42,55,11,0,111,2.66666666666667,0.691944996938253,45.4230769230769
"6893965047.jpg",2,58,80,2,0,142,2.57746478873239,0.549970259182636,43.5281690140845
"6895353221.jpg",1,32,83,6,0,122,2.77049180327869,0.542215919388249,48.5227272727273
"6895365088.jpg",0,2,43,59,2,106,3.57547169811321,0.568173568509905,70.4314159292035
"6896225625.jpg",0,5,64,37,1,107,3.31775700934579,0.576229298586476,62.6323529411765
"6897314758.jpg",0,2,41,58,2,103,3.58252427184466,0.569214660991312,73.5091743119266
"6897446719.jpg",3,67,38,4,0,112,2.38392857142857,0.603973863080537,37.09375
"6897675527.jpg",0,14,120,20,0,154,3.03896103896104,0.469781160053697,56.9935483870968
"6898490953.jpg",0,1,13,76,15,105,4,0.554700196225229,80.1554054054054
"6898804586.jpg",2,69,25,3,0,99,2.29292929292929,0.557921164289131,32.7133027522936
"6899120807.jpg",2,7,53,41,2,105,3.32380952380952,0.713809364973457,61.7972972972973
"6899517653.jpg",0,1,40,65,3,109,3.64220183486239,0.553154853742444,70.0847826086956
"6899882301.jpg",0,23,78,9,0,110,2.87272727272727,0.526527326788343,51.3461538461538
"6900924910.jpg",0,0,52,54,2,108,3.53703703703704,0.536968401338476,71.1973684210526
"6901970679.jpg",0,12,69,23,1,105,3.12380952380952,0.599603043290984,56.9084821428571
"6902342114.jpg",1,32,67,7,0,107,2.74766355140187,0.584282465030387,47.8014018691589
"6902428631.jpg",0,0,45,60,1,106,3.58490566037736,0.513956168750047,69.0986842105263
"6902444479.jpg",0,0,42,61,2,105,3.61904761904762,0.525886657519257,68.8581081081081
"6903329459.jpg",4,86,23,0,0,113,2.16814159292035,0.46102864156565,31.31875
"6903462833.jpg",1,8,60,37,0,106,3.25471698113208,0.633378255370013,62.125
"6903802628.jpg",0,6,65,32,1,104,3.26923076923077,0.578427215227558,63.7326732673267
"6904448359.jpg",0,10,72,24,0,106,3.13207547169811,0.553352926184042,55.0444915254237
"6904500540.jpg",0,1,41,84,1,127,3.66929133858268,0.504819913045161,74.8057692307692
"6904675638.jpg",0,41,57,2,0,100,2.61,0.529817959970281,43.0210280373832
"6905163828.jpg",0,1,44,61,1,107,3.57943925233645,0.532657686415534,72.5982142857143
"6905574433.jpg",2,41,60,4,0,107,2.61682242990654,0.593118713070191,44.2775423728814
"6905808386.jpg",0,7,62,31,0,100,3.24,0.570663268185859,61.3233944954128
"6905924906.jpg",0,2,67,33,1,103,3.32038834951456,0.527918447226235,65.3194444444444
"6906058795.jpg",0,14,53,38,1,106,3.24528301886792,0.687456606488099,59.4013157894737
"6906948754.jpg",0,2,33,72,1,108,3.66666666666667,0.529503382213656,72.5486725663717
"6907198605.jpg",0,1,60,41,1,103,3.40776699029126,0.53204918694708,66.2699115044248
"6907499876.jpg",0,2,49,53,3,107,3.53271028037383,0.587892895670724,70.3883928571429
"6907897085.jpg",0,2,36,55,4,97,3.62886597938144,0.600686892039473,73.4254807692308
"6908276949.jpg",0,1,57,49,0,107,3.44859813084112,0.518227109458397,66.7226890756303
"6908900076.jpg",0,0,16,79,9,104,3.93269230769231,0.488000140795043,80.3881578947368
"6909297506.jpg",0,29,85,18,0,132,2.91666666666667,0.59311143175921,52.0277777777778
"6909401846.jpg",0,5,38,51,11,105,3.64761904761905,0.733549751615552,70.4137931034483
"6909860315.jpg",0,4,63,37,2,106,3.34905660377358,0.586230132451472,64.4891304347826
"6910469420.jpg",0,4,58,69,3,134,3.52985074626866,0.596862706439081,71.5701438848921
"6911254247.jpg",0,2,46,48,6,102,3.56862745098039,0.637287008435109,68.594537815126
"6911586648.jpg",8,69,24,0,0,101,2.15841584158416,0.542819919813684,29.8013392857143
"6912813329.jpg",0,1,38,66,3,108,3.65740740740741,0.549630921823901,72.70625
"6913622130.jpg",0,0,50,54,2,106,3.54716981132075,0.536870570048989,72.0825892857143
"6913908117.jpg",2,26,69,8,0,105,2.79047619047619,0.599603043290984,45.2972972972973
"6915315864.jpg",0,0,45,57,0,102,3.55882352941176,0.498979739499495,68.7678571428571
"6915332491.jpg",0,1,22,71,13,107,3.89719626168224,0.597709139828855,76.4385593220339
"6915781600.jpg",0,1,27,71,5,104,3.76923076923077,0.543822665820023,74.5986842105263
"69161613.jpg",0,3,32,65,4,104,3.67307692307692,0.598417130425389,71.74375
"6916511144.jpg",0,0,37,61,5,103,3.68932038834951,0.560621612518976,72.6896551724138
"6918766149.jpg",0,11,70,23,0,104,3.11538461538462,0.562720374224038,55.225
"691940284.jpg",0,3,39,60,2,104,3.58653846153846,0.584767432371758,72.2224770642202
"6920118996.jpg",0,1,60,41,0,102,3.3921568627451,0.510423290560389,64.9375
"6920447844.jpg",1,2,49,66,0,118,3.52542372881356,0.580478205555074,71.6843220338983
"6921149341.jpg",0,18,71,15,0,104,2.97115384615385,0.565285919050108,54.3303571428571
"6921873872.jpg",2,62,38,1,0,103,2.36893203883495,0.542150606058615,36.8473451327434
"6922435153.jpg",0,5,51,48,0,104,3.41346153846154,0.584767432371758,66.2142857142857
"6923520196.jpg",1,78,26,1,0,106,2.25471698113208,0.479311425846485,32.35
"6924377004.jpg",0,0,47,52,1,100,3.54,0.52068331172711,66.9269911504425
"6926235386.jpg",0,4,64,27,1,96,3.26041666666667,0.547622452860721,62.05
"6927606175.jpg",0,0,29,75,6,110,3.79090909090909,0.526289670569155,74.3411016949153
"6927641976.jpg",3,47,41,12,0,103,2.60194174757282,0.732171171260087,42.3973214285714
"6927744497.jpg",0,0,11,80,10,101,3.99009900990099,0.458149528100826,81.85
"6928560176.jpg",1,18,74,13,0,106,2.93396226415094,0.5735249058324,52.2094594594595
"6929188980.jpg",0,5,40,61,1,107,3.54205607476635,0.603142303553142,70.8648648648649
"6929191226.jpg",2,32,58,11,0,103,2.75728155339806,0.663709412812857,48.0691964285714
"6929201627.jpg",0,3,71,33,0,107,3.2803738317757,0.510168165455875,64.3014018691589
"6930075142.jpg",0,32,60,13,0,105,2.81904761904762,0.632165879839856,51.2208737864078
"6931269556.jpg",0,6,70,33,0,109,3.24770642201835,0.546977609785377,60.8298319327731
"6931553873.jpg",0,1,29,69,4,103,3.7378640776699,0.541623649245881,75.8785714285714
"6932651943.jpg",2,38,61,5,0,106,2.65094339622642,0.602256911327458,44.3125
"6933526580.jpg",0,8,56,46,1,111,3.36036036036036,0.629470091610869,65.025641025641
"6934705817.jpg",0,22,77,14,0,113,2.92920353982301,0.562469271530391,52.9957983193277
"6935047173.jpg",0,0,31,65,10,106,3.80188679245283,0.592328919576578,74.271186440678
"6935129773.jpg",0,0,18,85,7,110,3.9,0.46825853440794,78.0924369747899
"6935202616.jpg",0,31,67,1,0,99,2.6969696969697,0.483493778415228,45.5654205607477
"6935219850.jpg",2,39,63,8,0,112,2.6875,0.630047188279941,45.1864406779661
"6935652834.jpg",5,60,44,1,0,110,2.37272727272727,0.588250257377267,35.2375
"6936616730.jpg",0,23,60,22,1,106,3.00943396226415,0.683064286437966,53.472972972973
"6936925429.jpg",0,23,66,15,0,104,2.92307692307692,0.602459484877279,51.625
"6937167103.jpg",0,0,10,82,10,102,4,0.444994159489985,78.5045871559633
"6937606166.jpg",0,0,30,75,3,108,3.75,0.495305060345378,74.7434210526316
"6937691669.jpg",0,0,16,85,4,105,3.88571428571429,0.423226746698362,78.4065217391304
"6937719329.jpg",0,2,51,53,0,106,3.4811320754717,0.538624917208215,68.7794117647059
"6938468092.jpg",0,5,56,34,0,95,3.30526315789474,0.566318536982807,63.15
"6938575813.jpg",0,2,74,30,0,106,3.26415094339623,0.484067818791518,61.5257009345794
"6938775083.jpg",0,29,68,5,0,102,2.76470588235294,0.529832228036428,50.0619469026549
"6938815179.jpg",0,9,73,23,0,105,3.13333333333333,0.538278357119799,57.4241071428571
"6939374638.jpg",0,8,63,36,1,108,3.27777777777778,0.608864936503513,60.5375
"6940202479.jpg",0,2,56,45,0,103,3.41747572815534,0.533656859801263,65.1495327102804
"6940429128.jpg",2,53,45,1,0,101,2.44554455445545,0.556331691075611,40.225
"6941715715.jpg",0,4,63,41,1,109,3.35779816513761,0.569647970888463,64.7367256637168
"6942312836.jpg",0,1,28,74,3,106,3.74528301886792,0.517527468876994,74.9004237288136
"6942418274.jpg",1,16,77,13,0,107,2.95327102803738,0.55598251584586,54.3823529411765
"6942738260.jpg",0,5,59,42,1,107,3.36448598130841,0.589091455315854,64.3947368421053
"6943168420.jpg",0,7,67,28,1,103,3.22330097087379,0.576195072410062,61.6964285714286
"6943468904.jpg",0,71,41,0,0,112,2.36607142857143,0.483894406512202,37.3141025641026
"6945167278.jpg",0,2,48,57,1,108,3.52777777777778,0.554646192409084,70.5902777777778
"6945246052.jpg",0,3,41,92,5,141,3.70212765957447,0.570021062907376,77.535472972973
"6945819872.jpg",0,12,69,28,0,109,3.14678899082569,0.590443776502902,58.8199152542373
"6946044735.jpg",0,49,54,7,0,110,2.61818181818182,0.605507114509346,43.4285714285714
"6946130339.jpg",0,1,50,52,3,106,3.5377358490566,0.571956180504146,69.3571428571429
"6946374385.jpg",0,26,73,7,0,106,2.82075471698113,0.530896273813413,49.4048672566372
"6947149263.jpg",0,25,69,7,0,101,2.82178217821782,0.536582511902138,47.0183486238532
"6947720174.jpg",1,11,77,16,1,106,3.04716981132075,0.575401730829747,55.5338983050847
"6947747616.jpg",0,3,78,24,1,106,3.21698113207547,0.497703621524604,62.875
"6948272719.jpg",1,52,46,2,0,101,2.48514851485149,0.558817705269592,40.3577981651376
"6949001721.jpg",1,22,68,16,1,108,2.94444444444444,0.653292642893341,50.70625
"6951573031.jpg",1,35,61,9,0,106,2.73584905660377,0.62185416744646,47.6013513513514
"6952277665.jpg",0,22,76,6,0,104,2.84615384615385,0.497941993136503,48.4932432432432
"6952458517.jpg",5,18,57,28,2,110,3.03636363636364,0.82314314502258,54.4851694915254
"6953798231.jpg",0,30,57,12,0,99,2.81818181818182,0.628630457676932,48.3411214953271
"6954316003.jpg",0,5,69,29,4,107,3.29906542056075,0.617587412971562,59.7899159663866
"6954547933.jpg",3,58,36,3,0,100,2.39,0.601261300530104,37.1032110091743
"6955151884.jpg",4,65,38,3,0,110,2.36363636363636,0.60163801984452,36.4092920353982
"6955490571.jpg",0,0,34,64,3,101,3.69306930693069,0.524262801606708,72.8598130841121
"6956011813.jpg",2,27,64,6,0,99,2.74747474747475,0.594934987760785,46.0344036697248
"6956670735.jpg",0,20,69,18,0,107,2.98130841121495,0.598446233634422,55.1824324324324
"6956736634.jpg",0,0,32,69,7,108,3.76851851851852,0.557136897914997,72.3625
"6957057987.jpg",0,11,58,35,0,104,3.23076923076923,0.626761892986781,59.9836448598131
"6957283590.jpg",0,45,57,4,0,106,2.61320754716981,0.561812622838427,43.0190677966102
"6958947570.jpg",0,3,48,51,0,102,3.47058823529412,0.55768052803139,67.1556603773585
"6959482720.jpg",0,1,26,79,3,109,3.77064220183486,0.502457433666732,75.8739495798319
"6960806686.jpg",0,2,71,32,0,105,3.28571428571429,0.494474968532781,60.9598214285714
"6961079357.jpg",0,18,64,19,1,102,3.02941176470588,0.636448723218111,54.8383620689655
"6961812492.jpg",0,5,62,38,0,105,3.31428571428571,0.560121650836909,63.5263157894737
"6962031247.jpg",2,51,44,1,0,98,2.44897959183673,0.558393294859601,39.1658878504673
"6962153786.jpg",0,4,32,60,8,104,3.69230769230769,0.669399427641421,72.1206896551724
"6962529393.jpg",0,6,73,24,0,103,3.1747572815534,0.513106350364809,59.9285714285714
"6963387147.jpg",0,20,63,18,0,101,2.98019801980198,0.616120086018983,56.171875
"6963905428.jpg",0,0,27,74,7,108,3.81481481481481,0.532111789044513,76.2205882352941
"6965249888.jpg",0,0,47,48,2,97,3.5360824742268,0.541253477088583,69.5733944954128
"6965585396.jpg",0,24,65,13,0,102,2.8921568627451,0.595475727034352,51.6148648648649
"6965747606.jpg",0,1,11,89,4,105,3.91428571428571,0.418658244006642,79.4864864864865
"6966361719.jpg",0,1,36,60,4,101,3.66336633663366,0.570565118505719,71.425
"6966432732.jpg",0,2,41,60,2,105,3.59047619047619,0.566623570867177,68.8581081081081
"6966682968.jpg",0,23,68,13,0,104,2.90384615384615,0.583248864754567,51.6379310344828
"6966797840.jpg",3,48,44,4,1,100,2.52,0.673900151462673,39.3971962616822
"6966908551.jpg",0,13,54,34,1,102,3.22549019607843,0.673499252024224,60.6775700934579
"6967399980.jpg",0,2,34,62,7,105,3.7047619047619,0.618991262579839,76.0509708737864
"6967934649.jpg",0,1,36,59,2,98,3.63265306122449,0.544660210013524,71.7683486238532
"6968409021.jpg",0,18,62,29,0,109,3.10091743119266,0.651848569787555,56.6701680672269
"6970549872.jpg",0,6,55,34,1,96,3.3125,0.603716559496695,63.9357142857143
"697114350.jpg",2,26,63,18,0,109,2.88990825688073,0.68501756589108,52.2217391304348
"6972495879.jpg",0,0,16,75,11,102,3.95098039215686,0.514684388158128,78.8073394495413
"6974364233.jpg",0,1,41,58,0,100,3.57,0.517472489875334,72.9714285714286
"6974453710.jpg",1,25,64,11,0,101,2.84158415841584,0.612089425939163,47.6238532110092
"6974573719.jpg",0,2,32,66,2,102,3.66666666666667,0.551026644579283,75.103982300885
"6974731766.jpg",8,47,46,2,0,103,2.40776699029126,0.663279038134847,35.3995535714286
"6974976461.jpg",0,4,61,40,2,107,3.37383177570093,0.59118308765705,63.7
"69754716.jpg",0,8,46,41,6,101,3.44554455445545,0.72767090809998,65.2272727272727
"6976429442.jpg",4,54,43,1,0,102,2.40196078431373,0.584618076590697,36.8004587155963
"6976437867.jpg",0,1,41,67,2,111,3.63063063063063,0.538143744364542,71.614406779661
"6976768402.jpg",0,10,74,23,1,108,3.13888888888889,0.571247746200316,55.9026548672566
"6977310046.jpg",7,87,18,0,0,112,2.09821428571429,0.464211458273358,30.0148305084746
"6977491270.jpg",0,0,44,60,1,105,3.59047619047619,0.513195833352107,71.0114678899083
"6977554463.jpg",1,39,63,4,0,107,2.65420560747664,0.568061977390618,44.8368644067797
"6978488118.jpg",0,2,22,83,6,113,3.82300884955752,0.53835212347455,74.3333333333333
"6978598944.jpg",0,5,45,55,0,105,3.47619047619048,0.589902829273897,67.9611650485437
"6978651748.jpg",0,0,44,65,1,110,3.60909090909091,0.508558938073631,71.2345132743363
"6978738588.jpg",0,0,34,67,4,105,3.71428571428571,0.531946456861058,72.7115384615385
"6979363295.jpg",0,0,56,43,3,102,3.48039215686275,0.55811550238036,64.9564220183486
"6979435146.jpg",0,0,14,85,3,102,3.8921568627451,0.395691217373967,81.1637168141593
"6979944704.jpg",0,0,31,75,2,108,3.73148148148148,0.485422669308056,76.714953271028
"6980009998.jpg",0,8,66,33,1,108,3.25,0.597893498471106,59.859243697479
"6980277214.jpg",0,9,61,35,0,105,3.24761904761905,0.600976007151834,61.3990825688073
"6981062336.jpg",0,0,28,76,5,109,3.78899082568807,0.51050799854823,75.9070796460177
"6983458217.jpg",0,3,59,36,2,100,3.37,0.580055727033745,67.4759615384615
"6983491967.jpg",0,1,31,63,7,102,3.74509803921569,0.591796635357012,74.2476635514019
"6983896045.jpg",0,9,64,31,2,106,3.24528301886792,0.629607901486041,60.1130434782609
"6985836315.jpg",1,41,61,3,0,106,2.62264150943396,0.559810004991987,44.3304347826087
"6985846441.jpg",0,9,64,28,2,103,3.22330097087379,0.625159412375277,61.4471153846154
"6986641462.jpg",0,0,33,70,9,112,3.78571428571429,0.576234615453057,73.7434782608696
"6986935908.jpg",0,0,48,53,2,103,3.55339805825243,0.537389392902424,68.8415178571429
"6988183211.jpg",0,4,57,47,0,108,3.39814814814815,0.562700677637197,64.9201680672269
"6988927721.jpg",0,0,11,85,12,108,4.00925925925926,0.46353720011966,80.9891304347826
"6989772902.jpg",56,47,3,0,0,106,1.5,0.556348640264187,12.7457627118644
"6991133333.jpg",0,3,71,33,0,107,3.2803738317757,0.510168165455875,65.6004464285714
"6992326754.jpg",0,5,73,20,0,98,3.1530612244898,0.48380026585756,57.4121621621622
"6992423707.jpg",0,3,48,53,0,104,3.48076923076923,0.557051342926048,67.675
"6993179262.jpg",9,58,42,1,0,110,2.31818181818182,0.634364786408574,35.2635135135135
"6993355605.jpg",0,3,60,47,0,110,3.4,0.545204279533844,65.5064655172414
"6993500769.jpg",5,64,40,2,0,111,2.35135135135135,0.597702398563162,35.6080508474576
"6993655335.jpg",0,0,17,72,15,104,3.98076923076923,0.557051342926048,79.3378378378378
"6993723329.jpg",0,4,45,51,3,103,3.51456310679612,0.624092716683751,65.8851351351351
"6994291070.jpg",0,1,61,47,0,109,3.42201834862385,0.51448604310428,66.9300847457627
"6994313445.jpg",0,0,17,80,8,105,3.91428571428571,0.482666585716303,79.0464601769911
"6994871976.jpg",0,2,63,34,2,101,3.35643564356436,0.558285919862602,64.9
"6995068299.jpg",0,4,77,48,0,129,3.34108527131783,0.537589004709449,65.8664122137405
"6995599343.jpg",0,3,58,46,0,107,3.4018691588785,0.547029940957534,68.7678571428571
"6996086039.jpg",6,37,61,8,0,112,2.63392857142857,0.697428167559964,43.3260869565217
"6996264658.jpg",0,5,69,32,0,106,3.25471698113208,0.535613946877644,62.7654867256637
"6996280620.jpg",0,46,57,7,0,110,2.64545454545455,0.599485461888649,44.7884615384615
"6997098854.jpg",0,13,76,13,0,102,3,0.507371404963127,53.25
"6997268609.jpg",8,69,30,0,0,107,2.20560747663551,0.561976259436275,33.4797297297297
"6998687310.jpg",0,11,81,18,0,110,3.06363636363636,0.511828395971184,56.2115384615385
"6998702838.jpg",0,3,67,35,2,107,3.33644859813084,0.565417281767723,63.8325892857143
"6999906899.jpg",0,0,41,56,3,100,3.62,0.546430104025994,69.8528037383178
"7000580898.jpg",0,0,5,79,18,102,4.12745098039216,0.459693583425518,82.6680672268908
"7000869677.jpg",0,1,23,76,1,101,3.76237623762376,0.472197307308823,73.716814159292
"7001480005.jpg",0,6,72,23,1,102,3.18627450980392,0.540084191399139,59.6418918918919
"7001539761.jpg",0,0,19,84,4,107,3.85981308411215,0.444008289291165,80.65
"7001822108.jpg",0,0,35,62,7,104,3.73076923076923,0.578427215227558,75.1026785714286
"7002011797.jpg",0,3,48,47,1,99,3.46464646464646,0.576993108456905,70.2839805825243
"7003526811.jpg",0,1,46,54,4,105,3.58095238095238,0.584757549708759,68.6351351351351
"7003816113.jpg",44,61,3,0,0,108,1.62037037037037,0.542021011983518,16.1016949152542
"7003924615.jpg",2,28,73,5,0,108,2.75,0.565768024851109,45.55
"7004025487.jpg",32,96,21,0,0,149,1.9261744966443,0.593819061207446,24.375
"7004286982.jpg",0,1,36,85,5,127,3.74015748031496,0.537669846552709,77.7116935483871
"7004557180.jpg",0,2,46,52,3,103,3.54368932038835,0.590392010499209,69.972972972973
"7004597260.jpg",0,1,40,66,5,112,3.66964285714286,0.575606109959227,71.8065217391304
"7005072091.jpg",48,53,1,1,0,103,1.5631067961165,0.5717174489413,14.8014018691589
"7005136305.jpg",0,0,29,84,1,114,3.75438596491228,0.452356729556137,78.7544247787611
"7005253045.jpg",1,24,65,17,0,107,2.91588785046729,0.646054722361008,51.2626050420168
"7005672625.jpg",0,4,54,43,1,102,3.40196078431373,0.584618076590697,66.775
"7005727843.jpg",0,2,48,50,5,105,3.55238095238095,0.619878281801423,68.1049107142857
"7005951474.jpg",4,36,56,9,0,105,2.66666666666667,0.688737231721194,45.5647321428571
"7005989775.jpg",2,62,43,1,0,108,2.39814814814815,0.545839228920306,37.6504424778761
"7006026095.jpg",0,2,80,23,0,105,3.2,0.447213595499958,60.0607476635514
"7006133071.jpg",0,2,49,52,3,106,3.52830188679245,0.588906123488388,70.5940594059406
"7006191446.jpg",0,16,71,19,0,106,3.02830188679245,0.576649553885552,53.5762711864407
"7006279642.jpg",0,12,75,13,0,100,3.01,0.502418393795691,53.6032110091743
"7006866482.jpg",0,1,37,67,1,106,3.64150943396226,0.519865902952877,73.2923728813559
"7007091368.jpg",0,1,62,41,3,107,3.42990654205607,0.568217164383648,66.6316964285714
"701112732.jpg",1,15,70,18,0,104,3.00961538461538,0.599274517831503,53.2247706422018
"7011343645.jpg",0,0,50,60,2,112,3.57142857142857,0.532109277442409,70.7125
"7011511225.jpg",0,2,41,58,3,104,3.59615384615385,0.583248864754567,70.9776785714286
"7013076503.jpg",0,1,71,34,1,107,3.32710280373832,0.50982240590043,64.375
"7013643069.jpg",1,35,65,3,0,104,2.67307692307692,0.547586189382175,44.6627358490566
"7016006231.jpg",0,0,35,63,10,108,3.76851851851852,0.605372851533239,78.5802752293578
"70164643.jpg",0,4,26,63,6,99,3.71717171717172,0.639521569268204,73.2394957983193
"7017996705.jpg",0,8,102,29,0,139,3.15107913669065,0.495101644735239,59.0913793103448
"7019402255.jpg",1,2,43,55,2,103,3.53398058252427,0.6233296735855,70.358407079646
"7019640975.jpg",1,0,22,80,5,108,3.81481481481481,0.54939470767855,76.2205882352941
"7021084115.jpg",0,2,35,84,4,125,3.72,0.547722557505166,76.0614754098361
"7021793877.jpg",0,6,70,24,1,101,3.1980198019802,0.548083971307281,59.875
"7023249423.jpg",1,45,57,6,0,109,2.62385321100917,0.605361704329154,44.0592105263158
"7023852485.jpg",0,3,64,32,0,99,3.29292929292929,0.520057399746535,63.3956310679612
"7024265149.jpg",1,44,55,5,0,105,2.60952380952381,0.596387169276516,43.2075892857143
"7024308197.jpg",0,5,83,34,0,122,3.23770491803279,0.515114986577852,61.4772727272727
"7024488001.jpg",0,0,30,73,4,107,3.75700934579439,0.511031540866989,78.3163716814159
"7024783845.jpg",0,32,69,7,0,108,2.76851851851852,0.557136897914997,46.1540178571429
"7025630527.jpg",0,2,60,38,0,100,3.36,0.52261966393479,62.4734513274336
"70272233.jpg",47,44,7,1,0,99,1.61616161616162,0.665583535704905,15.8361344537815
"7029108053.jpg",0,0,19,86,1,106,3.83018867924528,0.401703470668117,79.1747572815534
"7032481793.jpg",44,55,9,0,0,108,1.67592592592593,0.623956380330556,16.8310810810811
"7033122257.jpg",0,11,81,13,0,105,3.01904761904762,0.480003052493347,55.3254716981132
"7033769199.jpg",0,21,74,13,0,108,2.92592592592593,0.558765389780802,54.1504424778761
"7035194341.jpg",0,1,27,71,6,105,3.78095238095238,0.554369919210997,76.8851351351351
"7035272289.jpg",0,0,35,64,4,103,3.69902912621359,0.539334220223537,71.9934210526316
"7036262065.jpg",0,0,44,60,1,105,3.59047619047619,0.513195833352107,71.7763157894737
"7038478039.jpg",1,19,65,18,0,103,2.97087378640777,0.633327822673833,53.3004587155963
"7038768335.jpg",0,7,54,42,1,104,3.35576923076923,0.621902331025801,65.9785714285714
"7041776879.jpg",2,20,58,22,1,103,3,0.727606875108999,54.1490384615385
"7042014185.jpg",0,1,79,31,0,111,3.27027027027027,0.466046153507372,62.9108695652174
"7043681927.jpg",0,2,47,61,0,110,3.53636363636364,0.536336070311266,70.2715517241379
"7043958029.jpg",0,4,80,60,0,144,3.38888888888889,0.543378592935253,68.7068965517241
"7046294773.jpg",0,1,38,68,3,110,3.66363636363636,0.546503023439813,72.9665178571429
"7046586351.jpg",1,23,47,34,1,106,3.10377358490566,0.779856461554901,59.6339285714286
"7046617755.jpg",0,13,84,6,0,103,2.93203883495146,0.426157844326468,52.1217948717949
"7046797651.jpg",0,11,69,27,0,107,3.14953271028037,0.579585706260149,58.3040540540541
"7047135125.jpg",1,16,61,27,1,106,3.10377358490566,0.689088359570525,55.2542372881356
"7048841203.jpg",0,1,28,64,7,100,3.77,0.583528106011228,74.2476635514019
"7051563883.jpg",0,12,68,26,1,107,3.14953271028037,0.611273621185864,57.8891304347826
"7052391619.jpg",0,0,35,64,5,104,3.71153846153846,0.551662569637779,76.8175
"7052971473.jpg",0,1,39,64,2,106,3.63207547169811,0.54029042803915,72.0089285714286
"7054584681.jpg",1,3,50,50,1,105,3.44761904761905,0.619878281801423,65.6621621621622
"7054855385.jpg",1,51,51,1,0,104,2.5,0.539687072220866,38.640625
"7055216867.jpg",0,2,38,71,0,111,3.62162162162162,0.52317308198155,72.1206896551724
"7055266351.jpg",0,0,30,71,6,107,3.77570093457944,0.537436458990222,74.15
"7056790837.jpg",0,3,41,58,2,104,3.56730769230769,0.587316144781357,71.2836538461538
"7057320569.jpg",0,5,41,59,0,105,3.51428571428571,0.590213222786179,70.1544117647059
"7058304697.jpg",0,1,53,65,4,123,3.58536585365854,0.571549938559259,71.0909090909091
"7059458199.jpg",1,31,68,11,0,111,2.8018018018018,0.615257814694115,49.2307692307692
"7061755895.jpg",0,0,17,77,8,102,3.91176470588235,0.489553063022048,79.5306603773585
"7063010793.jpg",0,2,38,63,1,104,3.60576923076923,0.547159819941693,72.3472222222222
"7063436849.jpg",0,14,54,27,1,96,3.15625,0.670084440869012,60.1116504854369
"706409343.jpg",0,2,30,66,3,101,3.69306930693069,0.561116284871964,72.088785046729
"7064847959.jpg",73,36,5,0,0,114,1.40350877192982,0.575599698746193,9.73940677966102
"7066508685.jpg",0,14,73,11,0,98,2.96938775510204,0.506739763884901,53.6788990825688
"7066539033.jpg",0,0,44,65,2,111,3.62162162162162,0.52317308198155,71.2307692307692
"7071306923.jpg",0,9,69,29,0,107,3.18691588785047,0.568527411288765,58.8898305084746
"7072303767.jpg",0,24,67,13,0,104,2.89423076923077,0.589853844506429,52.0197368421053
"7072533905.jpg",0,0,34,65,3,102,3.69607843137255,0.522545477414006,73.2453271028037
"7075654171.jpg",0,1,46,60,2,109,3.57798165137615,0.549302216986366,70.6050420168067
"7076980511.jpg",0,8,56,42,2,108,3.35185185185185,0.645832286536518,62.3550420168067
"7077356639.jpg",0,1,37,61,4,103,3.66019417475728,0.569716098170618,71.0884955752212
"7078293355.jpg",0,0,20,68,17,105,3.97142857142857,0.595772653740548,79.4102564102564
"7081444391.jpg",0,0,45,55,2,102,3.57843137254902,0.534665149393819,67.9839449541284
"7082408177.jpg",1,27,65,9,0,102,2.80392156862745,0.597672311394309,49.9701834862385
"7084961757.jpg",0,5,57,40,2,104,3.375,0.610387430681514,64.2021739130435
"7085413157.jpg",0,6,46,45,0,97,3.4020618556701,0.606557805270051,64.9932432432432
"7085880797.jpg",0,5,57,41,0,103,3.3495145631068,0.572383010806878,65.7547169811321
"7085959839.jpg",1,9,67,32,1,110,3.20909090909091,0.636726930732686,60.0135135135135
"7087645993.jpg",0,2,50,57,1,110,3.51818181818182,0.554081075474067,65.1281512605042
"7089392359.jpg",0,1,31,70,3,105,3.71428571428571,0.531946456861058,71.8310810810811
"7090447613.jpg",1,20,69,14,0,104,2.92307692307692,0.602459484877279,53.6132075471698
"7092360919.jpg",0,26,66,13,0,105,2.87619047619048,0.599603043290984,50.5
"7092910349.jpg",0,12,70,24,1,107,3.13084112149533,0.600064652955856,58.2873831775701
"7094182327.jpg",0,18,76,10,1,105,2.94285714285714,0.551720585437597,51.609243697479
"7095677109.jpg",4,75,22,2,0,103,2.21359223300971,0.535970540544198,31.5472972972973
"7096133531.jpg",1,5,70,51,0,127,3.34645669291339,0.595991274516739,66.4012096774194
"7096952113.jpg",0,8,65,32,1,106,3.24528301886792,0.598590737915664,62.875
"7100857351.jpg",0,2,30,65,4,101,3.7029702970297,0.575231335298166,77.1957547169811
"7102405013.jpg",0,2,60,38,2,102,3.3921568627451,0.565630512031092,64.1776315789474
"7102475637.jpg",1,4,59,37,1,102,3.32352941176471,0.61598773142409,61.7972972972973
"7102713545.jpg",0,1,52,48,1,102,3.48039215686275,0.540084191399139,65.4802631578947
"7102805935.jpg",0,0,35,73,2,110,3.7,0.498621954200784,73.5168067226891
"7104640807.jpg",0,1,43,55,0,99,3.54545454545455,0.520453634013347,70.9663461538462
"7105123297.jpg",2,19,48,38,3,110,3.19090909090909,0.818316178384923,60.5991379310345
"7106381255.jpg",73,29,0,0,0,102,1.2843137254902,0.453314547328504,6.61853448275862
"7107776883.jpg",2,14,68,21,1,106,3.04716981132075,0.667362619666088,54.5210084033613
"7107867443.jpg",2,32,61,12,0,107,2.77570093457944,0.663160119185679,48.0472972972973
"7108939139.jpg",0,0,12,86,11,109,3.99082568807339,0.461387056201525,81.1228813559322
"7109803877.jpg",0,5,38,63,3,109,3.58715596330275,0.626734765423908,68.7875
"7109981551.jpg",0,3,66,37,2,108,3.35185185185185,0.568894892232083,64.1526548672566
"7110105161.jpg",1,31,67,7,0,106,2.75471698113208,0.582463091080284,47.0986842105263
"7111226249.jpg",0,0,52,60,1,113,3.54867256637168,0.517396477610979,67.3525641025641
"7112366827.jpg",0,3,45,50,5,103,3.55339805825243,0.637522092501558,71.6009615384615
"7113461019.jpg",2,23,96,11,0,132,2.87878787878788,0.552997425974477,51.5076335877863
"7113653815.jpg",0,1,35,74,4,114,3.71052631578947,0.54405368375352,72.1652173913044
"7116112855.jpg",3,11,74,20,0,108,3.02777777777778,0.633316936990578,55.7828947368421
"7119041313.jpg",0,2,40,63,3,108,3.62037037037037,0.575473678808797,68.2375
"7119860187.jpg",0,0,43,64,1,108,3.61111111111111,0.508494816289356,70.7234513274336
"7122976485.jpg",0,0,27,71,5,103,3.78640776699029,0.517355368382299,78.5817307692308
"7123405099.jpg",0,12,65,29,0,106,3.16037735849057,0.603746910911237,59.8549107142857
"7123410119.jpg",0,0,24,77,6,107,3.83177570093458,0.504432827557042,77.5334821428571
"7124206301.jpg",8,72,22,3,0,105,2.19047619047619,0.605983594840749,31.7847222222222
"7125445143.jpg",0,6,49,46,2,103,3.42718446601942,0.635578195117856,64.0066371681416
"7125596297.jpg",0,4,40,57,11,112,3.66964285714286,0.702484559249921,73.1875
"7130276433.jpg",0,13,76,17,0,106,3.0377358490566,0.533176077445105,56.171875
"7131604965.jpg",0,9,64,24,0,97,3.15463917525773,0.565320819416709,59.1544117647059
"7131772191.jpg",0,1,25,70,4,100,3.77,0.529054808029367,79.5642201834862
"7131884003.jpg",0,4,69,37,1,111,3.31531531531532,0.555664744934667,63.1546610169492
"7132841089.jpg",0,2,33,70,4,109,3.69724770642202,0.569349647762013,72.3135593220339
"7134278631.jpg",0,3,66,41,1,111,3.36036036036036,0.552560861194046,63.975
"7135099747.jpg",0,1,28,68,2,99,3.71717171717172,0.515878565848711,75.6284403669725
"7136073057.jpg",0,6,66,30,0,102,3.23529411764706,0.548200848288349,62.1689189189189
"7138669275.jpg",0,17,59,27,0,103,3.09708737864078,0.649503024292135,57.4121621621622
"7141084967.jpg",0,4,56,42,3,105,3.41904761904762,0.616768133420437,66.2763157894737
"7141864663.jpg",0,13,70,18,0,101,3.04950495049505,0.554549143426665,53.7702702702703
"7143312581.jpg",0,7,77,16,0,100,3.09,0.473435755030621,56.8577981651376
"7144832397.jpg",0,5,48,53,1,107,3.46728971962617,0.603726743906886,68.6351351351351
"71458295.jpg",0,6,52,46,0,104,3.38461538461538,0.596229126278775,62.9789915966387
"7146833457.jpg",0,34,63,6,0,103,2.72815533980583,0.563500522074354,45.7349137931034
"7148484633.jpg",0,9,63,37,0,109,3.25688073394495,0.599439085416844,58.3305084745763
"7148644865.jpg",0,1,45,62,1,109,3.57798165137615,0.532178923922789,70.4314159292035
"7149494135.jpg",0,2,38,63,4,107,3.64485981308411,0.586842147921673,71.2697368421053
"7149994451.jpg",1,9,57,36,4,107,3.30841121495327,0.719161132825862,62.8391304347826
"7152554103.jpg",0,1,29,73,2,105,3.72380952380952,0.509434794182543,72.8108695652174
"7154088130.jpg",1,2,32,69,3,107,3.66355140186916,0.613433350989744,71.5063025210084
"7154960969.jpg",0,15,77,16,0,108,3.00925925925926,0.538175706470443,54.804347826087
"7155826261.jpg",0,5,49,49,1,104,3.44230769230769,0.604624943152366,69.2834821428571
"7157345124.jpg",0,4,59,46,1,110,3.4,0.577879705586241,62.8050847457627
"7158075991.jpg",0,2,33,61,7,103,3.70873786407767,0.620421551204755,77.1422018348624
"7158901982.jpg",0,10,56,35,2,103,3.28155339805825,0.662991966475378,62.7654867256637
"7159650647.jpg",0,30,90,8,0,128,2.828125,0.519075116315503,50.3051181102362
"7160553409.jpg",0,1,69,58,1,129,3.45736434108527,0.530444270429051,68.546875
"7161322897.jpg",0,2,49,48,1,100,3.48,0.559220236335625,66.6144859813084
"7162655.jpg",0,6,45,40,11,102,3.54901960784314,0.765951824615313,67.4935897435897
"7162678728.jpg",0,4,84,39,1,128,3.2890625,0.534662212151151,63.5297619047619
"7162855925.jpg",63,42,2,0,0,107,1.42990654205607,0.533980240124661,11.8552631578947
"7163084628.jpg",0,1,19,77,6,103,3.85436893203884,0.512735206482347,81.0176991150443
"7163375274.jpg",0,1,46,55,3,105,3.57142857142857,0.569364403678193,70.1674107142857
"7164723575.jpg",0,5,64,38,1,108,3.32407407407407,0.577275322701455,62.3684210526316
"7165207702.jpg",0,4,55,50,2,111,3.45045045045045,0.599071079994819,67.5945945945946
"7165704390.jpg",0,0,32,68,3,103,3.71844660194175,0.512920811993036,75.3263888888889
"7166012405.jpg",0,12,71,23,1,107,3.1214953271028,0.594158361042598,58.4527027027027
"7167005638.jpg",4,77,18,1,0,100,2.16,0.486587789373795,29.695652173913
"7167167089.jpg",0,6,57,36,0,99,3.3030303030303,0.579488610839561,64.8985849056604
"7167430526.jpg",0,2,56,44,1,103,3.42718446601942,0.553100738042354,68.0117924528302
"7167513416.jpg",0,0,26,69,17,112,3.91964285714286,0.61714823452064,77.906779661017
"7167608916.jpg",0,3,46,54,2,105,3.52380952380952,0.589902829273897,66.4054054054054
"7167671368.jpg",0,3,65,40,0,108,3.34259259259259,0.532355671933666,63.8802521008403
"7168526408.jpg",0,2,57,38,2,99,3.4040404040404,0.569983743398538,64.704347826087
"7168884193.jpg",0,0,34,66,6,106,3.73584905660377,0.557236152255086,74.2875
"7169239087.jpg",0,0,14,92,5,111,3.91891891891892,0.40754553867435,79.5148305084746
"7169475537.jpg",0,1,14,80,6,101,3.9009900990099,0.479686366182102,82.618932038835
"7169652147.jpg",0,3,64,43,1,111,3.37837837837838,0.556842625948939,64.9189189189189
"7170927811.jpg",3,46,55,2,0,106,2.52830188679245,0.588906123488388,40.9915254237288
"7171867098.jpg",1,1,35,59,5,101,3.65346534653465,0.63930655501655,68.6061946902655
"7172192793.jpg",0,20,78,11,0,109,2.91743119266055,0.529297934146812,51.8983050847458
"7172324016.jpg",0,25,63,14,0,102,2.8921568627451,0.611876884418025,51.8485576923077
"7173122782.jpg",1,48,46,7,0,102,2.57843137254902,0.636143618347645,43.3396226415094
"7173197243.jpg",0,0,27,81,1,109,3.76146788990826,0.449260350337442,75.3886554621849
"7173633933.jpg",8,61,34,2,0,105,2.28571428571429,0.631151050345041,34.5689655172414
"7175697564.jpg",1,0,42,64,4,111,3.63063063063063,0.601935181166513,71.125
"7175721471.jpg",0,5,71,80,0,156,3.48076923076923,0.561922435769689,71.125
"7176672187.jpg",0,7,75,28,0,110,3.19090909090909,0.533216904166657,59.3392857142857
"71775760.jpg",2,38,57,8,0,105,2.67619047619048,0.642938537785661,45.6875
"7178199774.jpg",0,0,12,82,9,103,3.97087378640777,0.452797636478183,81.4932432432432
"7178723916.jpg",0,31,66,12,0,109,2.8256880733945,0.606203069160939,50.2105263157895
"7179150708.jpg",0,4,70,33,0,107,3.27102803738318,0.52431614864964,63.475
"7179426262.jpg",0,2,57,42,0,101,3.3960396039604,0.530645039942749,65.5486111111111
"7179446780.jpg",0,2,54,49,0,105,3.44761904761905,0.536745040121693,69.0220588235294
"7180497616.jpg",0,20,59,29,0,108,3.08333333333333,0.671516626331212,56.8622881355932
"7181156093.jpg",2,31,59,13,0,105,2.79047619047619,0.675039003078826,46.8728448275862
"7181400642.jpg",1,45,52,5,0,103,2.59223300970874,0.601255112144644,41.65
"7182538268.jpg",0,0,24,79,2,105,3.79047619047619,0.453516984993567,78.5339805825243
"7183220075.jpg",0,0,12,87,11,110,3.99090909090909,0.459266558194944,81.0735294117647
"7185825441.jpg",2,50,62,0,0,114,2.52631578947368,0.535641643443603,41.8119469026549
"7186435015.jpg",0,0,26,71,9,106,3.83962264150943,0.554407318937984,75.1800847457627
"7186783534.jpg",0,23,67,17,0,107,2.94392523364486,0.611706177169599,52.718487394958
"7188136873.jpg",1,26,69,11,0,107,2.8411214953271,0.601092287365109,50.275
"7188151253.jpg",3,57,41,3,0,104,2.42307692307692,0.602459484877279,38.3347457627119
"7188153176.jpg",0,31,80,15,0,126,2.87301587301587,0.593081808645343,52.3109756097561
"7188178353.jpg",0,19,65,15,0,99,2.95959595959596,0.587613504783473,52.0894495412844
"7189264298.jpg",0,0,20,72,13,105,3.93333333333333,0.559303596287842,79.8256302521008
"7189498789.jpg",0,8,46,42,5,101,3.43564356435644,0.712963415389014,64.1995412844037
"7189997672.jpg",0,1,43,56,1,101,3.56435643564356,0.536951423951151,69.625
"7191194360.jpg",1,28,56,13,1,99,2.84848484848485,0.690513508470569,47.7256637168142
"7192279956.jpg",0,1,64,40,0,105,3.37142857142857,0.504920840276033,63.2094594594595
"7192501662.jpg",0,1,51,47,3,102,3.50980392156863,0.575835132469745,67.75
"7192785398.jpg",1,15,74,21,0,111,3.03603603603604,0.601935181166513,56.5978260869565
"7194253160.jpg",0,0,33,73,1,107,3.70093457943925,0.480073761451812,76.2162162162162
"7194624166.jpg",0,1,23,74,9,107,3.85046728971963,0.563073411175464,76.9717391304348
"7194820358.jpg",0,1,16,87,3,107,3.85981308411215,0.444008289291165,80.8716814159292
"7196174704.jpg",0,16,70,15,0,101,2.99009900990099,0.556687515666563,56.1322115384615
"7196416584.jpg",0,14,75,19,0,108,3.0462962962963,0.553396635896595,56.8820754716981
"7200434768.jpg",0,6,84,43,0,133,3.2781954887218,0.541510002406943,64.953007518797
"7202630536.jpg",0,4,39,60,0,103,3.54368932038835,0.573545885630822,66.8526785714286
"7202661434.jpg",0,0,46,59,2,107,3.58878504672897,0.531165877300352,69.40625
"7203007382.jpg",0,60,46,1,0,107,2.44859813084112,0.518227109458397,38.0526315789474
"7203013446.jpg",0,8,73,23,0,104,3.14423076923077,0.529118505469683,57.1458333333333
"7203865570.jpg",0,0,24,82,0,106,3.77358490566038,0.420498997630299,76.4722222222222
"7212441932.jpg",0,6,63,36,0,105,3.28571428571429,0.566946709513841,63.3956310679612
"7213266604.jpg",0,7,76,26,0,109,3.1743119266055,0.524299121177549,58.4527027027027
"7214387770.jpg",0,2,29,80,1,112,3.71428571428571,0.50987671056272,73.7692307692308
"7214440922.jpg",1,6,61,36,3,107,3.31775700934579,0.667268875131512,60.33125
"7214629206.jpg",0,2,56,46,0,104,3.42307692307692,0.534123139365797,68.6176470588235
"7215678842.jpg",0,0,29,78,4,111,3.77477477477477,0.498811035175094,73.6987179487179
"7217797182.jpg",0,4,71,32,0,107,3.26168224299065,0.520095212584592,63.3419811320755
"7219282312.jpg",0,15,75,18,1,109,3.04587155963303,0.583497137333379,55.4639830508475
"7219295732.jpg",1,37,59,4,0,101,2.65346534653465,0.573334868368503,44.125
"7222616846.jpg",0,1,24,78,5,108,3.80555555555556,0.519855000152735,76.1588983050847
"7222733996.jpg",0,0,24,73,3,100,3.79,0.477683805651624,76.9
"7223815722.jpg",0,4,47,56,0,107,3.48598130841122,0.572391309305167,69.2834821428571
"7224064916.jpg",0,2,40,59,1,102,3.57843137254902,0.552873224323927,70.2688679245283
"7225479532.jpg",0,10,63,32,1,106,3.22641509433962,0.621565134585182,61.1298076923077
"7228274052.jpg",0,2,37,55,4,98,3.62244897959184,0.600949525685501,72.55
"7229767436.jpg",0,0,43,54,4,101,3.61386138613861,0.565160101735835,68.8922018348624
"7230853930.jpg",0,1,37,62,2,102,3.63725490196078,0.541161488064193,72.2224770642202
"7232368208.jpg",0,9,65,26,2,102,3.20588235294118,0.618817705272534,62.6924778761062
"7232875546.jpg",0,1,55,44,4,104,3.49038461538462,0.591118608959406,70.3640776699029
"7233783308.jpg",0,9,51,46,1,107,3.36448598130841,0.65000033910711,64.3655462184874
"7236084356.jpg",0,0,22,79,5,106,3.83962264150943,0.480808692830659,78.9344660194175
"7238368946.jpg",7,62,35,7,0,111,2.37837837837838,0.701350049470228,36.8875
"7238571992.jpg",0,2,35,61,0,98,3.60204081632653,0.53225441398212,72.9271844660194
"7238585598.jpg",0,1,59,43,1,104,3.42307692307692,0.534123139365797,66.4889380530973
"7238696504.jpg",0,9,82,15,1,107,3.07476635514019,0.508437016366886,57.5608108108108
"7240407408.jpg",1,4,55,49,1,110,3.40909090909091,0.625093821148232,62.1875
"7241141390.jpg",30,70,11,1,0,112,1.84821428571429,0.618190055451351,22.2045454545455
"7242888546.jpg",0,21,71,8,0,100,2.87,0.525222415609412,49.743119266055
"7247521810.jpg",12,63,29,8,0,112,2.29464285714286,0.755023928469246,34.34375
"7249502132.jpg",0,3,50,43,2,98,3.44897959183673,0.594171848160297,67.3855140186916
"7250719968.jpg",0,0,27,77,2,106,3.76415094339623,0.469079885418106,76.4514563106796
"7250885308.jpg",0,3,45,52,4,104,3.54807692307692,0.62130160417126,69.7743362831858
"7252678814.jpg",0,0,27,61,14,102,3.87254901960784,0.624128201914296,76.9594594594595
"7253127574.jpg",0,1,46,57,3,107,3.57943925233645,0.56697447910303,70.1890756302521
"7253262358.jpg",2,31,68,9,0,110,2.76363636363636,0.619666568039852,45.34375
"7253541416.jpg",0,2,51,83,1,137,3.60583941605839,0.533546186235752,75.0055555555556
"7255289130.jpg",0,1,24,74,3,102,3.77450980392157,0.505550630992575,74.5986842105263
"7255559908.jpg",0,0,16,72,19,107,4.02803738317757,0.573929584880092,80.353813559322
"7259290306.jpg",0,7,69,23,1,100,3.18,0.557411042864304,58.4630434782609
"7259325322.jpg",0,7,68,32,1,108,3.25,0.582052443280648,60.7775423728814
"7259602320.jpg",0,7,71,26,0,104,3.18269230769231,0.535432373634963,59.9911504424779
"7259699596.jpg",0,14,78,14,0,106,3,0.516397779494322,55.2347826086957
"7260057636.jpg",0,5,55,46,0,106,3.38679245283019,0.578516241974426,66.3125
"7260432838.jpg",0,1,56,45,2,104,3.46153846153846,0.556044925946993,69.9635922330097
"7260489840.jpg",0,2,37,65,1,105,3.61904761904762,0.543863535997354,70.5560344827586
"7262794678.jpg",0,3,32,72,3,110,3.68181818181818,0.573606299496747,71.675
"7262954956.jpg",0,1,28,72,4,105,3.75238095238095,0.533150151691889,74.8913043478261
"7263783306.jpg",3,43,57,2,0,105,2.55238095238095,0.588037027565055,40.0401785714286
"7264008364.jpg",0,0,32,65,8,105,3.77142857142857,0.576079970028582,73.9473684210526
"7264923790.jpg",0,0,20,85,8,113,3.89380530973451,0.488489505999418,77.1152173913043
"7264968696.jpg",0,2,44,54,3,103,3.56310679611651,0.588615905800381,70.813679245283
"7265767786.jpg",0,1,44,85,3,133,3.67669172932331,0.530135376942176,76.5845588235294
"7265792384.jpg",2,23,67,13,0,105,2.86666666666667,0.636496822559394,52.2451923076923
"7266979612.jpg",0,2,54,48,1,105,3.45714285714286,0.555195243352965,69.3455882352941
"7267070590.jpg",7,64,28,3,0,102,2.26470588235294,0.628158877995575,34.3142857142857
"7267396470.jpg",0,30,69,8,0,107,2.79439252336449,0.561976259436275,49.7142857142857
"7268649826.jpg",0,1,50,49,0,100,3.48,0.521845985251618,67.1542056074766
"7268981578.jpg",6,59,39,2,0,106,2.34905660377358,0.617868113993033,36.3004807692308
"7269352924.jpg",0,10,71,24,0,105,3.13333333333333,0.55585462035892,58.598623853211
"7269365920.jpg",0,7,73,67,3,150,3.44,0.61828947847641,69.5132450331126
"7270304334.jpg",17,83,6,1,0,107,1.91588785046729,0.497569476083734,23.9565217391304
"7270764894.jpg",0,1,46,53,5,105,3.59047619047619,0.599603043290984,70.2004310344828
"7270896820.jpg",0,5,47,52,0,104,3.45192307692308,0.589220444222254,66.7809734513274
"7271105620.jpg",0,1,19,77,8,105,3.87619047619048,0.531602043450486,77.1152173913043
"7272392080.jpg",0,0,34,66,1,101,3.67326732673267,0.492116061332875,75.25
"7272599674.jpg",0,31,72,5,0,108,2.75925925925926,0.527210439999348,48.9802631578947
"7275267386.jpg",1,30,70,6,0,107,2.75700934579439,0.563699396261691,46.6176470588235
"7276071932.jpg",0,0,10,85,15,110,4.04545454545455,0.476731294622796,79.44375
"7276321940.jpg",1,46,51,3,0,101,2.55445544554455,0.574025217647317,39.6766055045872
"7276446104.jpg",0,1,46,63,0,110,3.56363636363636,0.516290095668838,70.3141025641026
"7276523780.jpg",0,1,29,74,1,105,3.71428571428571,0.494474968532781,74.627358490566
"7277660018.jpg",0,1,38,64,3,106,3.65094339622642,0.552784343210652,71.4478260869565
"7280314854.jpg",1,18,64,21,0,104,3.00961538461538,0.646051371724143,54.8459821428571
"7280808920.jpg",0,1,25,76,6,108,3.80555555555556,0.53753214784685,75.0402542372881
"7281146720.jpg",0,0,30,67,5,102,3.75490196078431,0.534665149393819,73.1327433628319
"7283094026.jpg",0,4,23,60,18,105,3.87619047619048,0.729794993543209,78.34375
"7285012394.jpg",0,3,58,48,1,110,3.42727272727273,0.56599495749514,66.7027027027027
"7286003056.jpg",0,2,44,56,0,102,3.52941176470588,0.539634683047106,70.9285714285714
"7287141628.jpg",0,2,52,50,0,104,3.46153846153846,0.538301480532277,67.0717391304348
"7287423330.jpg",0,2,42,65,3,112,3.61607142857143,0.573365844159199,71.5375
"7288043746.jpg",2,65,86,2,0,155,2.56774193548387,0.546765635572484,43.0432692307692
"7288524676.jpg",0,8,54,44,2,108,3.37037037037037,0.649839557374613,64.25
"7289957138.jpg",2,16,85,24,0,127,3.03149606299213,0.616402876320964,56.6875
"7291000146.jpg",1,2,57,52,1,113,3.44247787610619,0.596688078021165,66.2373949579832
"7292757116.jpg",0,1,15,80,6,102,3.8921568627451,0.485571272110461,77.2388392857143
"7292878318.jpg",0,4,66,33,0,103,3.28155339805825,0.531691266161905,61.1381578947368
"7295291032.jpg",0,5,44,59,1,109,3.51376146788991,0.602689633582207,69.2834821428571
"7295363820.jpg",7,13,40,38,4,102,3.18627450980392,0.951605128158669,60.0441176470588
"7296337218.jpg",0,4,58,39,0,101,3.34653465346535,0.555619358272486,65.5
"7297259404.jpg",0,7,57,45,0,109,3.34862385321101,0.599013800449923,64.1756756756757
"7297786732.jpg",0,2,55,53,0,110,3.46363636363636,0.536336070311266,66.777027027027
"7300513490.jpg",0,7,72,23,1,103,3.1747572815534,0.549994375479608,62.3402777777778
"7300766830.jpg",1,9,60,35,0,105,3.22857142857143,0.639367819640001,59.1216216216216
"7301944302.jpg",0,6,60,37,1,104,3.31730769230769,0.595524131992075,65.535046728972
"7303073674.jpg",0,1,19,79,7,106,3.86792452830189,0.517787816408617,78.6383928571429
"7303973886.jpg",0,6,54,45,0,105,3.37142857142857,0.592535991395376,67.1633663366337
"7304709380.jpg",0,3,29,72,3,107,3.70093457943925,0.569921432371165,77.3514150943396
"7305940242.jpg",0,1,40,60,1,102,3.59803921568627,0.531387198643839,68.7678571428571
"7310636810.jpg",0,1,36,64,3,104,3.66346153846154,0.550561530172921,72.8928571428571
"7312266068.jpg",0,20,71,18,0,109,2.98165137614679,0.592884527139338,53.31875
"7312752876.jpg",1,25,62,19,1,108,2.94444444444444,0.694885633477702,50.5693277310924
"7316131560.jpg",0,0,35,64,4,103,3.69902912621359,0.539334220223537,71.9646017699115
"7316218852.jpg",2,23,70,9,0,104,2.82692307692308,0.598417130425389,48.3478260869565
"7316593310.jpg",0,1,26,72,5,104,3.77884615384615,0.538908115251656,74.8305084745763
"7316816362.jpg",0,26,115,11,0,152,2.90131578947368,0.485005201324641,52.5625
"7317766722.jpg",0,0,38,63,2,103,3.6504854368932,0.518458080898139,73.4428571428571
"7318578602.jpg",0,2,32,89,3,126,3.73809523809524,0.524268197449686,77.89
"7319806894.jpg",0,7,53,44,1,105,3.37142857142857,0.624147770612408,63.4038461538462
"7319912164.jpg",0,3,45,52,2,102,3.51960784313725,0.592534281196727,70.8194444444444
"7319984198.jpg",0,0,40,64,2,106,3.64150943396226,0.519865902952877,73.0873786407767
"7321293264.jpg",2,26,60,13,1,102,2.85294117647059,0.695061202854435,49.0775862068966
"7322656062.jpg",0,0,23,80,4,107,3.82242990654206,0.472110558528953,79.15
"7323620090.jpg",0,3,53,47,0,103,3.42718446601942,0.553100738042354,68.7900943396226
"7325916584.jpg",0,2,35,71,1,109,3.65137614678899,0.533613585898434,75.8668224299065
"7328195954.jpg",0,2,39,65,2,108,3.62037037037037,0.558997644196006,72.1652173913044
"7328979392.jpg",0,1,25,68,12,106,3.85849056603774,0.608490391915115,76.5084745762712
"7329465526.jpg",0,0,32,91,2,125,3.76,0.464896797427197,78.0225409836066
"7331539774.jpg",0,0,35,70,5,110,3.72727272727273,0.540286891324829,74.4539473684211
"7331542456.jpg",0,6,46,45,4,101,3.46534653465347,0.671779077311039,64.5691964285714
"7334314036.jpg",0,0,20,89,1,110,3.82727272727273,0.40317753753441,75.25
"7334526272.jpg",0,2,43,62,0,107,3.5607476635514,0.535134793343113,69.3571428571429
"7337709978.jpg",0,2,65,39,0,106,3.34905660377358,0.517180134966139,63.7139830508475
"7337936636.jpg",0,0,21,75,14,110,3.93636363636364,0.563040121556243,76.55625
"7339049388.jpg",0,1,19,73,13,106,3.92452830188679,0.580609092452912,80.4237288135593
"7339222496.jpg",0,2,57,40,0,99,3.38383838383838,0.528900876232016,65.125
"7339227510.jpg",3,49,51,3,0,106,2.50943396226415,0.605455877341205,40.8883495145631
"7339736582.jpg",0,1,53,50,4,108,3.52777777777778,0.587380265521398,70.8551401869159
"7340239088.jpg",3,43,62,3,0,111,2.58558558558559,0.594955589915881,43.9423076923077
"7342857520.jpg",0,20,61,15,1,97,2.96907216494845,0.636618806786792,51.9121621621622
"7344897910.jpg",1,31,54,20,0,106,2.87735849056604,0.713179736761515,49.7176724137931
"7348582056.jpg",0,0,50,58,3,111,3.57657657657658,0.548544347250886,70.2860169491525
"7348931184.jpg",0,16,85,28,0,129,3.09302325581395,0.578816957048981,58.9333333333333
"7349520418.jpg",0,22,55,28,0,105,3.05714285714286,0.69099386934511,54.9594594594595
"735046558.jpg",12,78,20,0,0,110,2.07272727272727,0.536880061249071,28.8893805309735
"7351425672.jpg",0,0,45,78,8,131,3.7175572519084,0.57210554647931,76.1119402985075
"7352368166.jpg",0,0,47,56,5,108,3.61111111111111,0.577350269189626,73.5694444444444
"7354160932.jpg",0,2,54,44,0,100,3.42,0.535223921797827,67.8325688073395
"7355331384.jpg",1,1,57,46,0,105,3.40952380952381,0.566623570867177,64.7241379310345
"7355344734.jpg",0,0,13,90,6,109,3.93577981651376,0.414443610912138,76.2899159663866
"7355708808.jpg",0,1,56,51,1,109,3.47706422018349,0.537420627649112,67.2920353982301
"73558937.jpg",0,20,51,27,2,100,3.11,0.737111479583199,56.1375
"7355960902.jpg",1,57,39,5,0,102,2.47058823529412,0.608616062833893,39.9137168141593
"7358286276.jpg",87,24,1,0,0,112,1.23214285714286,0.444833056186754,7.05
"7358753494.jpg",1,21,66,14,0,102,2.91176470588235,0.615041513152086,54.1504424778761
"7359378256.jpg",0,5,40,56,2,103,3.53398058252427,0.6233296735855,71.3805309734513
"7360550332.jpg",0,2,40,60,1,103,3.58252427184466,0.551722291692297,72.5763888888889
"7361922724.jpg",0,1,12,84,13,110,3.99090909090909,0.515724386698809,78.4390756302521
"7362254314.jpg",0,14,71,25,0,110,3.1,0.589666365005118,54.9
"7365538478.jpg",0,0,31,69,3,103,3.72815533980583,0.508634750057745,75.0290178571429
"7365681654.jpg",2,80,23,2,0,107,2.23364485981308,0.506177671326723,32.8521739130435
"7367414528.jpg",2,21,62,20,0,105,2.95238095238095,0.684736788017461,52.4324324324324
"7369136066.jpg",8,78,14,1,0,101,2.07920792079208,0.503650043518943,27.6775700934579
"7369281846.jpg",0,3,58,43,0,104,3.38461538461538,0.545194225793602,67.3235294117647
"7369682094.jpg",0,3,69,33,0,105,3.28571428571429,0.513552591013095,60.7586956521739
"7374960236.jpg",1,15,58,33,1,108,3.16666666666667,0.703794787422966,58.6763392857143
"7376214050.jpg",2,54,41,3,0,100,2.45,0.592461054424762,38.1635514018692
"7376910984.jpg",0,26,72,8,0,106,2.83018867924528,0.542861871639687,50.5723684210526
"7380460592.jpg",0,0,43,67,0,110,3.60909090909091,0.490187280170924,68.6638655462185
"7381771262.jpg",0,8,72,32,0,112,3.21428571428571,0.560382292750506,58.3305084745763
"7382035482.jpg",0,4,57,43,1,105,3.39047619047619,0.58004041794248,66.7573529411765
"7382484290.jpg",3,36,60,4,0,103,2.63106796116505,0.61021197316895,43
"7383311936.jpg",10,55,34,6,0,105,2.34285714285714,0.731549612237499,37.0436893203884
"7384140824.jpg",0,0,20,64,23,107,4.02803738317757,0.636291494924962,81.0735294117647
"7387717156.jpg",1,53,44,2,1,101,2.4950495049505,0.610307502431973,39.2689075630252
"7388185182.jpg",0,2,52,46,1,101,3.45544554455446,0.557220826517594,68.0596330275229
"7390518132.jpg",0,2,67,68,2,139,3.50359712230216,0.556569470635816,70.7065217391304
"7391300046.jpg",0,3,62,39,0,104,3.34615384615385,0.535519542113137,65.2205882352941
"7391334516.jpg",0,4,43,59,0,106,3.5188679245283,0.572897931164701,68.4864864864865
"7391355184.jpg",0,1,20,87,3,111,3.82882882882883,0.464638155868215,77.5064102564103
"7392719524.jpg",0,0,32,67,6,105,3.75238095238095,0.550890055709715,76.1142857142857
"7393631040.jpg",0,0,30,75,7,112,3.79464285714286,0.539241924632955,75.7435897435897
"7395359632.jpg",22,76,5,0,0,103,1.83495145631068,0.487029559408928,21.5857142857143
"7399191468.jpg",1,14,74,18,0,107,3.01869158878505,0.582468857556285,55.3125
"7399670298.jpg",3,38,64,0,0,105,2.58095238095238,0.550890055709716,40.4407894736842
"7401378600.jpg",0,0,26,73,4,103,3.78640776699029,0.498044911686416,79.1458333333333
"7402614702.jpg",21,66,13,1,0,101,1.94059405940594,0.613543513994204,23.725
"7405428626.jpg",1,38,68,5,0,112,2.6875,0.569988936197351,44.8368644067797
"7406520610.jpg",0,0,16,80,7,103,3.9126213592233,0.466669386193158,81.2847222222222
"7407428670.jpg",0,5,64,32,0,101,3.26732673267327,0.545730503250659,59.6826086956522
"7408729508.jpg",0,11,33,60,1,105,3.48571428571429,0.694958295847336,67.3683035714286
"7411918198.jpg",3,21,66,16,0,106,2.89622641509434,0.675126023974768,49.3114406779661
"7413044200.jpg",0,0,11,87,9,107,3.98130841121495,0.433966097519735,80.2995689655172
"7417878338.jpg",1,0,12,85,9,107,3.94392523364486,0.529003614870386,80.4869565217391
"7418763178.jpg",0,16,77,14,0,107,2.98130841121495,0.531663612106394,55.0571428571429
"7419326966.jpg",0,1,30,65,3,99,3.70707070707071,0.539321668669481,74.3938679245283
"7424501528.jpg",0,3,46,60,2,111,3.54954954954955,0.58369884418623,67.5021739130435
"7425462410.jpg",0,0,39,70,1,110,3.65454545454545,0.496526718635159,72.9230769230769
"7425526298.jpg",0,43,63,2,0,108,2.62037037037037,0.524495175046054,43.783185840708
"742801177.jpg",1,38,56,13,0,108,2.75,0.671516626331212,46.4864864864865
"7431456352.jpg",2,44,54,8,1,109,2.65137614678899,0.685513416528496,42.0402542372881
"7432159802.jpg",1,17,72,11,0,101,2.92079207920792,0.560056574228563,52.2794117647059
"7432387258.jpg",0,3,26,70,7,106,3.76415094339623,0.61025969167627,72.8728813559322
"7433488844.jpg",0,29,66,4,0,99,2.74747474747475,0.521838084659122,48.6666666666667
"7434980246.jpg",0,4,53,49,0,106,3.42452830188679,0.568173568509905,66.7079646017699
"7437031540.jpg",0,13,65,31,1,110,3.18181818181818,0.637970091931039,56.1155462184874
"7437035640.jpg",1,19,69,19,0,108,2.98148148148148,0.626240547994878,52.7878151260504
"7437582530.jpg",0,5,63,29,1,98,3.26530612244898,0.566250471120867,63.3155339805825
"7442226424.jpg",1,20,74,15,0,110,2.93636363636364,0.594736434219807,53.9957627118644
"7442324444.jpg",1,5,69,30,0,105,3.21904761904762,0.571451464742874,59.7162162162162
"7442416994.jpg",0,1,25,77,3,106,3.77358490566038,0.50300087793021,77.1824324324324
"7442925808.jpg",0,0,13,84,9,106,3.9622641509434,0.456164721750019,80.353813559322
"7443145706.jpg",0,0,23,83,4,110,3.82727272727273,0.466474006062442,75.7435897435897
"7443887988.jpg",40,59,11,2,0,112,1.77678571428571,0.693727643789725,18.4326086956522
"7445548804.jpg",0,16,75,12,0,103,2.96116504854369,0.522481449095346,54.9655963302752
"7445572890.jpg",0,0,18,78,5,101,3.87128712871287,0.461808755582517,80.9446902654867
"7445811974.jpg",0,5,33,73,2,113,3.63716814159292,0.598539097998721,71.3676470588235
"7448603724.jpg",0,0,30,75,4,109,3.76146788990826,0.507336592353515,71.4
"7448606010.jpg",0,30,63,13,0,106,2.83962264150943,0.619320556321587,50.5
"7452245552.jpg",9,66,21,4,0,100,2.2,0.65133894727893,32.1495327102804
"7452954268.jpg",0,1,33,75,3,112,3.71428571428571,0.527249730196496,72.0769230769231
"7455132680.jpg",1,10,62,31,2,106,3.21698113207547,0.676189843462999,61.1529126213592
"7455819414.jpg",0,2,63,35,0,100,3.33,0.513553671720273,62.2967289719626
"7459333336.jpg",0,2,26,62,10,100,3.8,0.635641726163728,74.3738938053097
"7459539092.jpg",0,1,60,47,0,108,3.42592592592593,0.515257012426105,64.9736842105263
"7459547170.jpg",0,3,61,43,1,108,3.38888888888889,0.560929357894812,65.1584821428571
"7460005346.jpg",0,9,64,36,1,110,3.26363636363636,0.615954137564629,62.4166666666667
"7460698156.jpg",0,0,38,61,6,105,3.6952380952381,0.573850180189942,71.5913043478261
"7461279878.jpg",0,4,64,32,0,100,3.28,0.533333333333333,63.1399082568807
"7461618822.jpg",1,8,78,31,1,119,3.19327731092437,0.600526759227796,60.3717948717949
"7463764592.jpg",0,0,18,85,4,107,3.86915887850467,0.43619521658578,79.1891891891892
"7465586874.jpg",0,1,65,37,2,105,3.38095238095238,0.543863535997354,65.320796460177
"7466229858.jpg",0,6,52,48,0,106,3.39622641509434,0.59648566474642,66.7053571428571
"7466614786.jpg",0,0,32,70,5,107,3.74766355140187,0.533649908982546,77.2
"7467164130.jpg",3,17,37,46,0,103,3.22330097087379,0.827612190545925,62.0966981132075
"7468704128.jpg",0,0,17,85,11,113,3.94690265486726,0.497147361823322,79.0254237288136
"7470410498.jpg",0,12,62,27,2,103,3.18446601941748,0.653010716897525,57.8738938053097
"7470463166.jpg",0,0,42,66,0,108,3.61111111111111,0.489770751891229,73.1485849056604
"7470692282.jpg",2,40,52,8,0,102,2.64705882352941,0.65471721389383,44.05
"7470832570.jpg",0,5,65,31,2,103,3.29126213592233,0.587968719342113,63.7
"7472436450.jpg",17,73,13,0,0,103,1.96116504854369,0.540920241612409,26.631067961165
"7473958436.jpg",0,2,16,74,8,100,3.88,0.555595958126829,76.6123853211009
"7478826230.jpg",0,2,74,50,0,126,3.38095238095238,0.519340240800081,67.66
"7480977716.jpg",0,12,75,16,0,103,3.03883495145631,0.522481449095346,57.0841346153846
"7483507340.jpg",6,60,43,4,0,113,2.39823008849558,0.648347115595408,36.703781512605
"7484588674.jpg",0,4,52,44,4,104,3.46153846153846,0.637395747014501,68.1891891891892
"7485150056.jpg",0,2,76,29,0,107,3.25233644859813,0.477680281958733,61.9
"7488642130.jpg",0,6,50,53,0,109,3.43119266055046,0.598871971680218,67.2152173913043
"7490518604.jpg",0,3,55,34,2,94,3.37234042553191,0.586295872922766,66.0480769230769
"7490651104.jpg",0,2,43,55,2,102,3.55882352941176,0.572877562157101,71.725
"7490674084.jpg",0,2,50,48,2,102,3.49019607843137,0.575835132469745,67
"7491724488.jpg",0,2,47,51,1,101,3.5049504950495,0.558994854649622,68.8
"7491939464.jpg",0,22,57,30,1,110,3.09090909090909,0.71092980266709,56.8781512605042
"7492007796.jpg",1,19,53,25,0,98,3.04081632653061,0.702255091358506,53.0553097345133
"7492033480.jpg",1,9,60,35,0,105,3.22857142857143,0.639367819640001,59.3093220338983
"7493136824.jpg",7,72,24,1,0,104,2.18269230769231,0.553267839716467,31.7572815533981
"7495567704.jpg",0,2,73,31,0,106,3.27358490566038,0.488594073759443,62.695652173913
"7497107258.jpg",0,12,86,8,0,106,2.9622641509434,0.434785733806496,53.5
"7499578096.jpg",0,15,80,10,0,105,2.95238095238095,0.487950036474267,53.6293103448276
"7499781424.jpg",0,1,43,59,2,105,3.59047619047619,0.549391938265845,69.7978260869565
"7502944264.jpg",0,1,37,66,5,109,3.68807339449541,0.572474287089111,72.01875
"7504569144.jpg",0,0,41,63,1,105,3.61904761904762,0.507273109208449,70.0847826086956
"7504875900.jpg",13,83,12,1,0,109,2.00917431192661,0.518105752897866,25.8236607142857
"7505379000.jpg",1,18,56,30,0,105,3.0952380952381,0.70060152072522,55.0128205128205
"7505926112.jpg",0,6,59,44,0,109,3.34862385321101,0.583351536049183,63.2765486725664
"7506629916.jpg",4,34,53,8,0,99,2.65656565656566,0.687521668105534,42.6150442477876
"7506684932.jpg",0,2,27,68,6,103,3.75728155339806,0.585210192127677,75.561320754717
"7510638426.jpg",3,17,59,25,1,105,3.03809523809524,0.745806346330672,54.0675675675676
"7510743692.jpg",0,7,56,42,1,106,3.34905660377358,0.617868113993033,65.6004464285714
"7512526314.jpg",0,14,48,44,1,107,3.29906542056075,0.703293509020748,62.0084033613445
"751468322.jpg",12,82,17,0,0,111,2.04504504504505,0.511457585327329,28.9935897435897
"7517892652.jpg",0,25,58,22,1,106,2.99056603773585,0.69686759033164,54.8421052631579
"7519024248.jpg",0,0,52,49,2,103,3.51456310679612,0.539863411736181,70.2410714285714
"7519982836.jpg",0,3,38,65,0,106,3.58490566037736,0.549769207478433,72.6067961165049
"7520058110.jpg",0,2,57,39,1,99,3.39393939393939,0.54991987947377,64.9564220183486
"7520824760.jpg",0,6,80,44,1,131,3.30534351145038,0.566950408508165,64.8289473684211
"7525316320.jpg",0,5,72,24,0,101,3.18811881188119,0.504239452782678,59.052752293578
"7525406860.jpg",1,11,53,37,2,104,3.26923076923077,0.713677325455493,59.5190677966102
"7526135750.jpg",0,25,67,15,0,107,2.90654205607477,0.607076357144042,51.1932773109244
"7526349354.jpg",1,73,52,2,0,128,2.4296875,0.542429555642616,36.875
"7530928692.jpg",1,49,45,8,0,103,2.58252427184466,0.649649556279175,41.947247706422
"7530958636.jpg",0,7,60,35,6,108,3.37037037037037,0.691640236455322,63.5336134453782
"7533737270.jpg",0,0,14,72,22,108,4.07407407407407,0.575248076573871,81.23125
"7535091270.jpg",1,2,51,47,0,101,3.42574257425743,0.5890082283545,65.5135135135135
"7537722246.jpg",1,4,49,46,1,101,3.41584158415842,0.63666830818996,65.535046728972
"7538144396.jpg",0,7,87,16,0,110,3.08181818181818,0.45194418308074,56.1631355932203
"7538254742.jpg",0,16,72,15,1,104,3.00961538461538,0.582848584105705,54.1830357142857
"7538834488.jpg",0,1,45,52,1,99,3.53535353535354,0.540467131911043,67.3650442477876
"7539744490.jpg",0,8,65,31,0,104,3.22115384615385,0.573809121695014,61.0070754716981
"7543000548.jpg",0,0,49,59,3,111,3.58558558558559,0.547198957808492,70.78125
"7543397674.jpg",1,20,69,9,0,99,2.86868686868687,0.565080175753752,46.4115044247788
"7543713322.jpg",0,0,47,58,1,106,3.56603773584906,0.516745639270716,70.0130434782609
"7548332064.jpg",3,44,56,2,0,105,2.54285714285714,0.588815163445454,39.4276315789474
"7550549938.jpg",0,6,38,57,2,103,3.53398058252427,0.638864402756533,66.8589743589744
"7551562932.jpg",1,41,55,1,0,98,2.57142857142857,0.537270689517335,40.9633027522936
"7553660370.jpg",0,13,66,31,0,110,3.16363636363636,0.613715900075111,56.6701680672269
"7555167080.jpg",0,3,63,41,1,108,3.37037037037037,0.556903867483925,64.2268907563025
"7555880012.jpg",0,32,73,5,0,110,2.75454545454545,0.527872024321917,47.5796460176991
"7556722466.jpg",0,1,84,21,0,106,3.18867924528302,0.416635218939035,60.7586956521739
"7557808298.jpg",0,0,29,72,1,102,3.72549019607843,0.470029759856178,75.7610619469027
"7559495698.jpg",38,68,5,0,0,111,1.7027027027027,0.54929036193975,19.094537815126
"7561653238.jpg",0,1,39,57,4,101,3.63366336633663,0.578321230411399,71.4305555555556
"7561935496.jpg",0,1,33,64,3,101,3.68316831683168,0.546455726830764,73.1111111111111
"7562246986.jpg",2,36,60,8,1,107,2.7196261682243,0.670037911112223,44.2605042016807
"7568401328.jpg",0,3,58,42,1,104,3.39423076923077,0.56462495896549,65.6128318584071
"7569119428.jpg",1,4,42,50,10,107,3.5981308411215,0.750594897198368,68.58125
"7570426860.jpg",0,0,36,65,6,107,3.7196261682243,0.562916806135257,73.0127118644068
"7571378378.jpg",0,10,79,11,1,101,3.02970297029703,0.499108115433008,52.9220183486239
"7571885930.jpg",0,0,21,73,9,103,3.88349514563107,0.529538661103847,77.828125
"7572752818.jpg",0,5,49,44,1,99,3.41414141414141,0.606261562231019,67.9611650485437
"7574036406.jpg",0,43,58,5,0,106,2.64150943396226,0.572191763481324,45.0264423076923
"7574416384.jpg",0,0,5,75,23,103,4.1747572815534,0.493629702963101,86.0044642857143
"7575998494.jpg",0,3,51,54,1,109,3.48623853211009,0.571137249170826,68.7368421052632
"7577281784.jpg",0,5,55,49,0,109,3.40366972477064,0.579259841506669,67.3618421052632
"7578229060.jpg",0,0,28,87,6,121,3.81818181818182,0.5,78.275
"7579253532.jpg",0,23,73,17,0,113,2.94690265486726,0.595229667028405,52.4202586206897
"7579386834.jpg",0,15,85,20,1,121,3.05785123966942,0.567120220370088,56.5826271186441
"7581184960.jpg",0,2,62,40,1,105,3.38095238095238,0.543863535997355,65.2321428571429
"7582497202.jpg",0,7,55,45,1,108,3.37037037037037,0.62040976197892,65.95
"7583515.jpg",10,71,23,3,0,107,2.17757009345794,0.626657562173502,31.781512605042
"7586142684.jpg",1,6,79,44,0,130,3.27692307692308,0.584229229401083,64.6337209302326
"7586560076.jpg",0,2,52,50,1,105,3.47619047619048,0.556348640264187,66.2108695652174
"7587404052.jpg",16,79,12,0,0,107,1.96261682242991,0.512581951935674,24.71875
"7588949536.jpg",5,72,22,0,0,99,2.17171717171717,0.495704076477909,29.6100917431193
"7590781464.jpg",0,3,23,71,4,101,3.75247524752475,0.572816560411087,74.644495412844
"7591145832.jpg",0,2,35,68,4,109,3.67889908256881,0.575434360013665,73.1008403361345
"7591870206.jpg",0,8,76,27,0,111,3.17117117117117,0.537229828486737,60.1602564102564
"7592360042.jpg",0,5,56,33,2,96,3.33333333333333,0.609860495983634,64.25
"7593868958.jpg",0,6,64,38,0,108,3.2962962962963,0.567981493368036,64.0972222222222
"7597470314.jpg",0,14,78,12,0,104,2.98076923076923,0.502049570731066,52.9308035714286
"7603371702.jpg",0,2,30,76,3,111,3.72072072072072,0.5422373041587,75.3230088495575
"7605930400.jpg",0,2,39,65,1,107,3.60747663551402,0.545254127107898,73.6933962264151
"7607759408.jpg",6,63,36,0,0,105,2.28571428571429,0.566946709513841,35.0668103448276
"7608025600.jpg",0,0,39,58,3,100,3.64,0.541602560309064,72.2224770642202
"7608257388.jpg",0,16,79,11,0,106,2.95283018867925,0.504872930202633,52.6710526315789
"7613152858.jpg",0,0,27,75,5,107,3.79439252336449,0.509130182355242,73.9241071428571
"7614530994.jpg",0,0,14,81,8,103,3.94174757281553,0.460716465025955,79.4486607142857
"7616384942.jpg",0,1,19,77,6,103,3.85436893203884,0.512735206482347,75.3973214285714
"7617788578.jpg",0,4,73,28,0,105,3.22857142857143,0.504920840276033,62.05
"7617916556.jpg",0,2,44,63,1,110,3.57272727272727,0.549546784229254,70.1890756302521
"7618408824.jpg",0,4,63,36,2,105,3.34285714285714,0.58554004376912,63.7
"7622957154.jpg",0,0,26,83,3,112,3.79464285714286,0.467664175675004,75.8846153846154
"7622984342.jpg",0,0,41,59,1,101,3.6039603960396,0.511452987493319,69.1192660550459
"7625539278.jpg",4,57,39,0,0,100,2.35,0.557320429022713,35.5137614678899
"762560347.jpg",0,7,78,24,0,109,3.15596330275229,0.512335103130853,57.2375
"7627158600.jpg",1,11,57,38,0,107,3.23364485981308,0.667004557880052,61.4485981308411
"7627340946.jpg",66,36,4,0,0,106,1.41509433962264,0.56682784029993,10.7881355932203
"7627752046.jpg",0,4,67,35,1,107,3.30841121495327,0.556458053366161,63.8783783783784
"7628306442.jpg",4,53,48,3,0,108,2.46296296296296,0.617894010297261,38.3541666666667
"7628564828.jpg",0,7,41,54,2,104,3.49038461538462,0.653522082848563,67.2894736842105
"7628769918.jpg",0,1,31,67,3,102,3.70588235294118,0.537471809882315,76.2430555555556
"7629156184.jpg",0,3,35,62,3,103,3.63106796116505,0.593928286126775,70.375
"7630573758.jpg",2,36,66,5,0,109,2.67889908256881,0.591306368309064,45.6513157894737
"763136296.jpg",0,1,34,62,4,101,3.68316831683168,0.564458910272607,70.7087155963303
"7633437372.jpg",0,15,62,29,0,106,3.13207547169811,0.633591000689354,58.1214285714286
"7634190334.jpg",0,1,16,80,4,101,3.86138613861386,0.469674418513443,80.1388888888889
"7635858220.jpg",0,3,74,28,2,107,3.27102803738318,0.542010468776289,60.0672268907563
"7636475996.jpg",20,72,9,0,0,101,1.89108910891089,0.527275831022244,23.1766055045872
"7640299878.jpg",0,2,37,65,2,106,3.63207547169811,0.557639099847156,68.5608108108108
"7641363622.jpg",0,6,59,43,0,108,3.34259259259259,0.58264682938731,66.0833333333333
"7644640634.jpg",1,46,47,4,0,98,2.55102040816327,0.594171848160297,40.2057522123894
"7645259944.jpg",3,56,49,3,1,112,2.49107142857143,0.643687794535501,40.2051282051282
"764877350.jpg",1,28,47,34,0,110,3.03636363636364,0.777283823184827,52.975
"7651161432.jpg",0,0,14,89,6,109,3.92660550458716,0.42396763543382,80.2146017699115
"7651198192.jpg",0,8,57,45,2,112,3.36607142857143,0.643687794535501,63.1978260869565
"7652900928.jpg",0,3,78,25,0,106,3.20754716981132,0.472419932890129,60.4717391304348
"7654676706.jpg",0,17,76,11,1,105,2.96190476190476,0.553377905438143,54.6650485436893
"7655498028.jpg",1,26,66,6,0,99,2.77777777777778,0.563436169819011,45.9509345794393
"7657349694.jpg",1,24,66,6,0,97,2.79381443298969,0.557863191298893,49.3646788990826
"7660049550.jpg",0,3,66,41,0,110,3.34545454545455,0.532199239030855,63.1305309734513
"7660271516.jpg",0,4,45,52,3,104,3.51923076923077,0.62287727649059,67.426724137931
"7660478078.jpg",0,19,60,27,2,108,3.11111111111111,0.701578105421079,57.5714285714286
"7661933374.jpg",0,6,53,34,1,94,3.31914893617021,0.608413518782716,65.5857142857143
"7662529090.jpg",0,7,66,36,0,109,3.26605504587156,0.571583275985521,61.15625
"7664231886.jpg",0,1,57,49,4,111,3.5045045045045,0.585799746638169,67.5202702702703
"7665609968.jpg",0,1,45,64,0,110,3.57272727272727,0.51507710136473,69.3881578947368
"7667669426.jpg",0,0,20,78,6,104,3.86538461538462,0.483869763182389,77.3125
"7668828488.jpg",0,1,42,59,2,104,3.59615384615385,0.548948346186761,70.675
"7670929454.jpg",0,2,37,63,3,105,3.63809523809524,0.573850180189942,71.640625
"7671053258.jpg",0,0,30,79,2,111,3.74774774774775,0.476129632242551,75.5344827586207
"7671701194.jpg",0,0,13,80,15,108,4.01851851851852,0.511210428744952,80.0625
"7672860636.jpg",0,16,67,23,0,106,3.06603773584906,0.605826753870528,56.3701923076923
"7673637784.jpg",0,11,69,27,1,108,3.16666666666667,0.603726743906886,56.9474789915966
"7673801638.jpg",0,0,13,85,3,101,3.9009900990099,0.387426134767636,80.4336283185841
"7674660830.jpg",0,4,52,45,1,102,3.42156862745098,0.587599151267575,68.1323529411765
"7676074992.jpg",0,9,71,23,0,103,3.13592233009709,0.543202986096654,56.8297413793103
"7676832810.jpg",0,9,67,32,1,109,3.22935779816514,0.602971461810648,62.1383928571429
"7678256566.jpg",0,0,15,83,6,104,3.91346153846154,0.443082251959491,78.0924369747899
"7678821440.jpg",0,3,37,50,7,97,3.62886597938144,0.666451855426463,73.3088235294118
"767916820.jpg",0,1,44,55,2,102,3.56862745098039,0.554188442797278,71.2867647058823
"7684026832.jpg",1,16,81,15,0,113,2.97345132743363,0.558380582436363,53.7584033613445
"7685277932.jpg",0,2,66,32,0,100,3.3,0.502518907629606,62.5
"7685698864.jpg",0,16,97,16,0,129,3,0.5,56.3837209302326
"7689540594.jpg",0,1,16,80,1,98,3.8265306122449,0.431384971804293,80.5364077669903
"7690007638.jpg",1,13,60,28,0,102,3.12745098039216,0.655087759632869,58.75
"7692418948.jpg",0,14,67,25,0,106,3.10377358490566,0.600464031403949,58.4630434782609
"7693237184.jpg",0,4,43,55,5,107,3.57009345794393,0.645918236731015,71.875
"7695585576.jpg",0,0,10,80,16,106,4.05660377358491,0.49435265375169,82.9453781512605
"7697080640.jpg",0,1,63,46,1,111,3.42342342342342,0.531713346380437,66.1610169491525
"7697492926.jpg",0,2,81,43,0,126,3.32539682539683,0.503259218762897,65.3366935483871
"7700511938.jpg",0,5,68,30,0,103,3.24271844660194,0.532585617115547,62.0817307692308
"7700955958.jpg",0,2,66,36,1,105,3.34285714285714,0.534008272562172,61.9065217391304
"7703482662.jpg",0,5,42,52,3,102,3.51960784313725,0.640704935978631,70.4903846153846
"7704019566.jpg",0,1,31,62,5,99,3.71717171717172,0.572149617231404,72.037610619469
"7705365342.jpg",0,9,58,32,0,99,3.23232323232323,0.603193589736869,61.6527777777778
"7710623518.jpg",0,20,70,18,0,108,2.98148148148148,0.595645906879944,53.2013274336283
"7710868262.jpg",0,13,69,20,0,102,3.06862745098039,0.567429568562114,53.3947368421053
"7712722502.jpg",1,0,25,73,6,105,3.79047619047619,0.583346415342582,74.6760869565217
"7714207710.jpg",4,72,57,2,0,135,2.42222222222222,0.579071138189927,38.2140287769784
"7714653298.jpg",2,34,65,4,0,105,2.67619047619048,0.58004041794248,46.0066964285714
"7715219180.jpg",1,29,62,9,0,101,2.78217821782178,0.609982957074042,49.378640776699
"7717158358.jpg",0,0,30,70,4,104,3.75,0.51671103264991,75.1756756756757
"7720747032.jpg",0,2,23,77,8,110,3.82727272727273,0.572441910984171,78.3716216216216
"7721291102.jpg",0,2,43,56,4,105,3.59047619047619,0.599603043290984,70.2584033613445
"772323238.jpg",3,24,66,8,0,101,2.78217821782178,0.626162285610362,47.0183486238532
"7726222874.jpg",27,69,8,0,0,104,1.81730769230769,0.553267839716467,22.0063025210084
"7728661610.jpg",0,1,59,79,1,140,3.57142857142857,0.524820725031324,72.1841216216216
"7728764770.jpg",0,0,32,65,2,99,3.6969696969697,0.504157115422901,72.5514018691589
"7730088582.jpg",5,67,45,4,0,121,2.39669421487603,0.625557602503228,36.81875
"7731030916.jpg",3,46,54,6,0,109,2.57798165137615,0.642529405317179,42.86875
"7731352704.jpg",0,0,16,88,6,110,3.90909090909091,0.439880186886929,76.00625
"7731477968.jpg",12,75,16,2,0,105,2.07619047619048,0.583346415342582,28.5948275862069
"7732609964.jpg",0,0,13,91,4,108,3.91666666666667,0.389703937468567,78.4342105263158
"7734376776.jpg",0,0,35,68,4,107,3.71028037383178,0.532160881376848,72.7542016806723
"7734540620.jpg",0,2,36,68,1,107,3.63551401869159,0.538910910208028,73.5048076923077
"7736222330.jpg",0,14,67,25,0,106,3.10377358490566,0.600464031403949,58.3495145631068
"7736601364.jpg",0,2,11,95,6,114,3.92105263157895,0.463628185673106,83.7209821428571
"7736819994.jpg",0,13,67,32,1,113,3.1858407079646,0.634550917780943,58.75
"7737023436.jpg",0,25,66,11,0,102,2.86274509803922,0.580870219248152,50.0021551724138
"7737184960.jpg",0,2,65,36,1,104,3.34615384615385,0.535519542113137,63.1260869565217
"7738480598.jpg",5,75,23,2,0,105,2.20952380952381,0.549391938265845,31.3947368421053
"7739550292.jpg",0,12,70,20,0,102,3.07843137254902,0.557332304127295,56.275
"7741343046.jpg",0,17,80,9,0,106,2.92452830188679,0.491801609392343,53.2991071428571
"774152136.jpg",0,18,69,12,0,99,2.93939393939394,0.54991987947377,54.7836538461538
"7743542184.jpg",0,0,20,80,6,106,3.86792452830189,0.479592519464145,77.0592105263158
"7743779530.jpg",0,5,71,30,1,107,3.25233644859813,0.551044598816994,61.1891304347826
"7744113492.jpg",1,20,70,14,0,105,2.92380952380952,0.599603043290984,52.1205357142857
"7744189800.jpg",0,21,64,22,0,107,3.00934579439252,0.636845514616271,54.25
"7744274780.jpg",0,2,52,49,1,104,3.47115384615385,0.556632223656022,68.546875
"7744803492.jpg",0,0,43,66,0,109,3.60550458715596,0.490999521457359,68.2478991596639
"7745091164.jpg",0,0,32,65,5,102,3.73529411764706,0.543666878717621,72.6766055045872
"7745366610.jpg",3,55,64,5,0,127,2.55905511811024,0.612742252800029,43.768
"7748906306.jpg",0,3,49,54,1,107,3.49532710280374,0.572545322844697,70.2383177570093
"7749694370.jpg",0,1,50,57,0,108,3.51851851851852,0.520270984055541,68.6644736842105
"7749930286.jpg",0,0,25,72,10,107,3.85981308411215,0.55709147195867,77.545652173913
"7751327300.jpg",0,0,25,75,2,102,3.77450980392157,0.464733773359492,73.5282608695652
"7751390858.jpg",1,9,69,21,0,100,3.1,0.577350269189626,55.8200934579439
"7751603360.jpg",8,55,35,4,0,102,2.34313725490196,0.682091977758926,36.0435779816514
"7751690228.jpg",0,0,39,59,2,100,3.63,0.525222415609412,71.6169724770642
"7751952772.jpg",0,1,46,66,0,113,3.57522123893805,0.514179473504584,73.3918918918919
"7753523026.jpg",0,6,73,21,1,101,3.16831683168317,0.530458423077494,58.3715596330275
"7755707532.jpg",0,1,40,59,3,103,3.62135922330097,0.562147577692258,71.2723214285714
"7755789428.jpg",0,4,63,35,0,102,3.30392156862745,0.541161488064193,63.5754716981132
"7756416864.jpg",8,61,36,2,0,107,2.29906542056075,0.632678541748658,37.0200892857143
"7756578200.jpg",39,61,9,0,0,109,1.72477064220183,0.606623313973396,18.3030973451327
"7758019722.jpg",0,7,57,37,3,104,3.34615384615385,0.650156527370256,63.2306034482759
"7758020806.jpg",0,1,55,45,4,105,3.4952380952381,0.590368358344854,67.1473214285714
"7759565946.jpg",0,0,27,64,11,102,3.84313725490196,0.592779959162309,79.0344036697248
"7762883720.jpg",0,1,44,57,1,103,3.56310679611651,0.53632560553216,70.2383177570093
"7763162224.jpg",1,18,67,16,0,102,2.96078431372549,0.612114799099203,53.575
"7765078282.jpg",0,2,58,43,0,103,3.39805825242718,0.530257167080327,65.4433962264151
"7765809112.jpg",0,22,75,12,0,109,2.90825688073395,0.55346190614119,51.4705882352941
"7766392832.jpg",17,77,13,1,0,108,1.98148148148148,0.563392286788467,25.3849557522124
"7767174802.jpg",0,6,82,18,0,106,3.11320754716981,0.464363460212572,56.8847826086957
"7767472114.jpg",0,3,56,45,0,104,3.40384615384615,0.548948346186761,66.1238938053097
"7769931466.jpg",5,32,55,14,0,106,2.73584905660377,0.747081773970629,46.9642857142857
"7769932398.jpg",0,2,46,56,4,108,3.57407407407407,0.599122468932278,69.5553097345133
"7772663024.jpg",0,9,63,32,1,105,3.23809523809524,0.612746175392287,58.8986486486486
"7777135010.jpg",3,62,60,3,0,128,2.4921875,0.588553461603408,38.8888888888889
"7778203492.jpg",8,42,48,9,1,108,2.56481481481481,0.788624120078206,41.21875
"7780172596.jpg",0,1,37,55,4,97,3.63917525773196,0.580688653854005,73.8082524271845
"7783320848.jpg",0,1,40,56,3,100,3.61,0.566666666666667,72.3738532110092
"7785216770.jpg",0,5,71,25,1,102,3.2156862745098,0.538193733390896,59.875
"7785223076.jpg",52,48,5,0,0,105,1.55238095238095,0.588037027565055,14.2152777777778
"7786382886.jpg",0,6,65,29,0,100,3.23,0.547814758929522,59.6752336448598
"7787028496.jpg",1,23,69,9,0,102,2.84313725490196,0.575835132469745,48.1536697247706
"7788471088.jpg",1,19,51,32,1,104,3.125,0.746350343304977,56.531512605042
"7788745946.jpg",0,1,30,81,0,112,3.71428571428571,0.473221115270889,72.8108695652174
"7789853112.jpg",0,1,32,71,7,111,3.75675675675676,0.575503198256909,74.9004237288136
"7793934458.jpg",0,11,67,24,0,102,3.12745098039216,0.574569466497057,59.1880530973451
"7795324248.jpg",0,2,44,60,3,109,3.58715596330275,0.580724470498192,72.7894736842105
"7795515978.jpg",1,15,70,27,0,113,3.08849557522124,0.63467542497684,55.0833333333333
"7796133504.jpg",0,3,40,61,1,105,3.57142857142857,0.569364403678193,71.3851351351351
"7797268116.jpg",0,5,51,48,1,105,3.42857142857143,0.602193791596495,64.8445945945946
"7797743908.jpg",0,2,30,68,4,104,3.71153846153846,0.568989513495208,73.6717391304348
"7801382324.jpg",3,6,64,34,0,107,3.20560747663551,0.669247927055513,62.0647321428571
"7802615964.jpg",0,1,47,83,1,132,3.63636363636364,0.513522891299858,74.4007352941177
"7802695886.jpg",0,0,20,83,7,110,3.88181818181818,0.483333572996595,75.1136363636364
"7806389418.jpg",0,1,38,60,3,102,3.63725490196078,0.559158060267284,71.7683486238532
"7807631220.jpg",0,0,11,81,12,104,4.00961538461539,0.472448534366542,81.3638392857143
"7809493264.jpg",0,0,22,71,10,103,3.88349514563107,0.547739935316853,78.4910714285714
"7810003032.jpg",0,2,34,60,11,107,3.74766355140187,0.660095161005968,75.1806722689076
"7810074740.jpg",0,1,26,62,12,101,3.84158415841584,0.628214505838997,75.3217391304348
"7811282766.jpg",0,3,29,72,1,105,3.67619047619048,0.545880342186223,71.2364864864865
"7811388288.jpg",14,66,30,1,0,111,2.16216216216216,0.64017810789499,30.7139830508475
"7814162374.jpg",0,9,50,39,3,101,3.35643564356436,0.686791939612596,63.0223214285714
"7816938468.jpg",0,16,57,37,0,110,3.19090909090909,0.670416200257701,59.9391891891892
"7819211312.jpg",0,21,75,6,0,102,2.85294117647059,0.495465753949974,50.1316964285714
"7819353184.jpg",0,0,26,75,1,102,3.75490196078431,0.454597515593999,76
"7819666996.jpg",0,0,31,70,4,105,3.74285714285714,0.519403715601092,72.722972972973
"7820783548.jpg",3,37,54,7,0,101,2.64356435643564,0.657026002770691,42.3256880733945
"7822391242.jpg",0,16,57,32,0,105,3.15238095238095,0.661887632529297,60.0441176470588
"7823568906.jpg",0,2,51,55,0,108,3.49074074074074,0.538175706470443,70.3154205607477
"7823939538.jpg",0,2,29,67,7,105,3.75238095238095,0.600976007151834,74.8913043478261
"7826230260.jpg",0,7,47,52,2,108,3.4537037037037,0.646836431667194,68.004347826087
"7826703034.jpg",0,3,42,47,1,93,3.49462365591398,0.582790437277536,70.4110576923077
"7832796652.jpg",0,2,29,70,6,107,3.74766355140187,0.584282465030387,73.031512605042
"7833281270.jpg",0,2,57,41,1,101,3.40594059405941,0.550966747123312,62.6100917431193
"7838423662.jpg",0,2,58,45,3,108,3.4537037037037,0.586200489757354,65.9778761061947
"7839484666.jpg",0,2,45,52,2,101,3.53465346534653,0.57557547612183,70.75
"7840986296.jpg",0,3,39,61,2,105,3.59047619047619,0.583346415342582,69.9413043478261
"7841725264.jpg",0,3,54,48,0,105,3.42857142857143,0.552218303703395,63.4324324324324
"7841765362.jpg",1,1,68,64,0,134,3.45522388059702,0.556785506166025,70.1635338345865
"7841859142.jpg",1,8,68,27,0,104,3.16346153846154,0.593010697902438,60.9554455445545
"7841962592.jpg",0,2,46,52,3,103,3.54368932038835,0.590392010499209,69.0442477876106
"7842127896.jpg",0,1,49,54,3,107,3.55140186915888,0.570230752031589,69.6756756756757
"7843258130.jpg",0,0,43,61,1,105,3.6,0.511408311956759,68.0405405405405
"7843358908.jpg",1,19,72,14,1,107,2.95327102803738,0.620151800803238,53.4364406779661
"7843799770.jpg",0,4,50,53,4,111,3.51351351351351,0.630510108993502,65.6827731092437
"7844179556.jpg",0,0,28,79,3,110,3.77272727272727,0.481951135919931,72.70625
"7845980046.jpg",0,0,24,71,4,99,3.7979797979798,0.494454925202593,75.7798165137615
"7846766204.jpg",0,0,24,84,0,108,3.77777777777778,0.417677900612944,76.4285714285714
"7850123296.jpg",1,14,68,18,1,102,3.03921568627451,0.628081608928551,54.4322429906542
"7853457684.jpg",0,3,53,52,0,108,3.4537037037037,0.553396635896595,68.8422330097087
"7854876374.jpg",2,16,64,30,1,113,3.10619469026549,0.711673478730729,56.3235294117647
"7856175732.jpg",0,0,17,74,7,98,3.89795918367347,0.486726831627486,79.8669724770642
"7856451374.jpg",0,1,47,51,2,101,3.53465346534653,0.557931114666382,68.875
"7859713146.jpg",0,0,16,82,11,109,3.95412844036697,0.497871787394763,77.5572033898305
"7861079240.jpg",0,2,33,72,2,109,3.67889908256881,0.542298502346539,70.5656779661017
"7863241080.jpg",1,14,59,29,1,104,3.14423076923077,0.688579080507115,58.896017699115
"7866144530.jpg",0,0,25,75,3,103,3.78640776699029,0.477954904692351,75.9311926605505
"7866480612.jpg",0,3,42,50,5,100,3.57,0.639681107421439,72.4481132075472
"7867041724.jpg",0,0,36,68,4,108,3.7037037037037,0.534059733773752,73.7302631578947
"7867646032.jpg",0,2,33,106,8,149,3.80536912751678,0.541242968233372,82.125
"7868631444.jpg",0,19,70,15,0,104,2.96153846153846,0.573239422405291,53.4933628318584
"7870300862.jpg",1,29,68,8,0,106,2.78301886792453,0.585616760447309,48.5423728813559
"7870688128.jpg",0,9,90,56,1,156,3.31410256410256,0.588102330128916,64.6353503184713
"7871237210.jpg",0,2,35,56,11,104,3.73076923076923,0.671627052526057,73.8152173913043
"7871346190.jpg",0,1,36,60,4,101,3.66336633663366,0.570565118505719,71.4305555555556
"7875370780.jpg",0,5,51,48,1,105,3.42857142857143,0.602193791596495,67.6407766990291
"7875374202.jpg",0,1,47,57,0,105,3.53333333333333,0.520108469949126,70.4059633027523
"7875422248.jpg",0,1,28,80,4,113,3.76991150442478,0.517701816367335,74.1217948717949
"7877688978.jpg",0,55,47,8,0,110,2.57272727272727,0.627490866326171,43.3782051282051
"7878410170.jpg",1,41,62,1,0,105,2.6,0.529876618439831,41.8913043478261
"7880797072.jpg",0,17,85,7,0,109,2.90825688073395,0.462306704425587,53.1985981308411
"7881174736.jpg",0,4,85,52,0,141,3.34042553191489,0.532243059862725,65.505033557047
"7883125264.jpg",3,41,44,14,0,102,2.67647058823529,0.746765496690343,45.4410377358491
"7887126684.jpg",0,1,24,74,5,104,3.79807692307692,0.528412307616814,77.2546728971963
"7889791504.jpg",0,6,51,45,0,102,3.38235294117647,0.597753511355474,66.175
"7892040540.jpg",0,0,39,60,6,105,3.68571428571429,0.577032956569235,71.3760869565217
"7892635308.jpg",0,0,37,65,2,104,3.66346153846154,0.51408466914511,70.4551282051282
"7893560424.jpg",0,9,71,24,1,105,3.16190476190476,0.573850180189942,57.8965517241379
"7896479602.jpg",0,1,55,43,3,102,3.47058823529412,0.575160457214671,65.7697368421053
"7897296676.jpg",0,0,66,35,2,103,3.37864077669903,0.526112357610771,64.421875
"7899104502.jpg",4,14,58,24,0,100,3.02,0.738275358555671,51.0840707964602
"7900291786.jpg",0,3,71,32,0,106,3.27358490566038,0.507712308261743,64.0535714285714
"7900303150.jpg",9,59,36,1,0,105,2.27619047619048,0.627805060619293,34.1486486486486
"7902540732.jpg",0,2,38,68,1,109,3.62385321100917,0.540729802206447,71.8185840707965
"7903006270.jpg",0,1,27,66,12,106,3.83962264150943,0.619320556321587,76.0126050420168
"7903635044.jpg",0,16,67,21,0,104,3.04807692307692,0.597402267951459,56.1946902654867
"7903686666.jpg",0,6,58,33,2,99,3.31313131313131,0.616879319499211,60.5752212389381
"7903714372.jpg",0,26,66,8,0,100,2.82,0.557411042864304,49.6
"7904253618.jpg",0,47,51,6,0,104,2.60576923076923,0.59802700252003,43.5641592920354
"7904310752.jpg",0,0,59,47,1,107,3.45794392523365,0.519077080686367,67.3650442477876
"7904631250.jpg",0,0,30,79,2,111,3.74774774774775,0.476129632242551,76.8012820512821
"7906332480.jpg",0,2,57,41,1,101,3.40594059405941,0.550966747123312,65.2
"7908624656.jpg",0,2,15,78,7,102,3.88235294117647,0.532026159690691,82.1768867924528
"7908884988.jpg",0,1,41,56,0,98,3.56122448979592,0.51904604270297,70.9722222222222
"7909059554.jpg",1,12,42,52,3,110,3.4,0.756622140979355,61.5466101694915
"7911339166.jpg",0,1,34,66,3,104,3.68269230769231,0.544423148479607,72.2629310344828
"7911502338.jpg",0,21,75,13,0,109,2.92660550458716,0.556217750098803,50.9380530973451
"7911673358.jpg",0,2,35,60,6,103,3.67961165048544,0.613789135296507,74.128640776699
"7913897946.jpg",0,10,69,28,0,107,3.16822429906542,0.574390264219721,59.9802631578947
"7914158128.jpg",0,5,49,50,1,105,3.44761904761905,0.604167456106596,65.0460526315789
"7914531096.jpg",0,0,25,74,5,104,3.80769230769231,0.503905582867573,76.6495535714286
"7914714726.jpg",0,0,17,76,8,101,3.91089108910891,0.491914828013755,76.9717391304348
"7915207374.jpg",0,19,62,20,0,101,3.00990099009901,0.624420523444745,54.925
"7915889156.jpg",0,22,65,15,0,102,2.93137254901961,0.60131545437867,50.722972972973
"7917906506.jpg",0,7,70,29,0,106,3.20754716981132,0.547148123621374,61.9410377358491
"7919265884.jpg",10,88,7,0,0,105,1.97142857142857,0.403283228807451,26.2702702702703
"7919270808.jpg",1,59,47,1,0,108,2.44444444444444,0.535354425937356,39.2828947368421
"7919700760.jpg",0,1,18,79,8,106,3.88679245283019,0.522279886960478,78.2700892857143
"7920824878.jpg",0,4,58,37,0,99,3.33333333333333,0.553283335172488,62.5
"7921753876.jpg",0,1,28,77,6,112,3.78571428571429,0.544068282488785,76.5783898305085
"7923574034.jpg",0,14,60,37,0,111,3.20720720720721,0.648314137059512,57.6590909090909
"7924068268.jpg",0,2,35,58,10,105,3.72380952380952,0.657723903017621,73.2586206896552
"7924366.jpg",70,36,2,0,0,108,1.37037037037037,0.522263094664423,10.4978991596639
"7926649668.jpg",0,28,63,5,0,96,2.76041666666667,0.537925678033424,47.5649038461538
"7927998516.jpg",0,0,37,62,3,102,3.66666666666667,0.532755462513791,71.9054054054054
"7928561010.jpg",2,51,47,6,0,106,2.5377358490566,0.635078222431983,43.6116504854369
"7929212614.jpg",0,5,30,60,6,101,3.66336633663366,0.667491239234977,71.9652777777778
"7929526740.jpg",0,2,32,68,5,107,3.71028037383178,0.582922788414288,73.031512605042
"7931367844.jpg",0,1,19,70,14,104,3.93269230769231,0.595524131992075,82.1642857142857
"7934073070.jpg",1,24,93,11,0,129,2.88372093023256,0.539500738193775,53.0984251968504
"7934781744.jpg",0,11,65,43,1,120,3.28333333333333,0.637528491152209,63.1546610169492
"7935628474.jpg",0,0,19,86,6,111,3.88288288288288,0.461986594428468,77.1377118644068
"7937116986.jpg",0,3,38,59,1,101,3.57425742574257,0.57177853498475,72.0711009174312
"7940282852.jpg",0,38,56,6,0,100,2.68,0.583960701597377,43.4285714285714
"7940912870.jpg",0,11,80,17,0,108,3.05555555555556,0.508494816289357,55.777027027027
"7942038522.jpg",0,24,51,30,0,105,3.05714285714286,0.718285504471631,55.5089285714286
"7945344572.jpg",0,10,68,26,0,104,3.15384615384615,0.5706278397006,58.3571428571429
"7946144914.jpg",0,22,73,17,1,113,2.97345132743363,0.619045593046703,54.1743697478992
"7946380974.jpg",0,3,54,50,0,107,3.4392523364486,0.552482734186941,67.9930555555556
"7946509460.jpg",0,9,97,21,0,127,3.09448818897638,0.47864011841323,58.618
"7946535104.jpg",0,11,54,48,1,114,3.34210526315789,0.662910548944017,63.4642857142857
"7946918290.jpg",5,70,27,2,0,104,2.25,0.570300550978694,32.9976635514019
"79475896.jpg",5,35,63,2,0,105,2.59047619047619,0.615430401227124,42.86875
"7951947544.jpg",0,24,63,11,0,98,2.86734693877551,0.58570171328868,48.7905405405405
"7954181598.jpg",0,2,56,42,2,102,3.43137254901961,0.571775139655522,64.8638392857143
"7954324384.jpg",1,4,69,25,1,100,3.21,0.573752489486468,62.3543689320388
"7954849148.jpg",0,1,18,80,4,103,3.84466019417476,0.480140534030996,79.1822429906542
"7955276034.jpg",3,46,42,10,0,101,2.58415841584158,0.71087729929536,40.5558035714286
"7955555286.jpg",0,0,38,62,2,102,3.64705882352941,0.519844965912666,73.0597345132743
"7955776040.jpg",0,26,53,20,1,100,2.96,0.709531072916714,53.027027027027
"7956634196.jpg",0,24,76,9,0,109,2.86238532110092,0.535203144337233,51.5487288135593
"7957309250.jpg",0,3,55,41,1,100,3.4,0.568535243614961,63.5810810810811
"7957627098.jpg",4,52,47,2,0,105,2.44761904761905,0.604167456106596,38.4745762711864
"7959317086.jpg",0,11,58,33,0,102,3.2156862745098,0.623427939421494,60.2232142857143
"7963365940.jpg",1,36,62,5,0,104,2.68269230769231,0.578991810008362,45.1703539823009
"7964487966.jpg",0,0,14,79,8,101,3.94059405940594,0.465226443320193,79.975
"7964545096.jpg",32,73,5,0,0,110,1.75454545454545,0.527872024321917,20.5762711864407
"7965307114.jpg",0,0,33,69,5,107,3.73831775700935,0.537928391778789,73.7941176470588
"7967382050.jpg",12,55,36,2,0,105,2.26666666666667,0.683130051063973,33.7027027027027
"7969243650.jpg",0,5,86,41,0,132,3.27272727272727,0.525544560772339,64.6698473282443
"7969415278.jpg",0,12,77,12,1,102,3.01960784313725,0.526155346500202,55.6944444444444
"7969516070.jpg",0,0,41,68,2,111,3.64864864864865,0.516080484361758,70.0320512820513
"7969586312.jpg",1,8,41,52,3,105,3.45714285714286,0.720957848823508,66.3429203539823
"7971560974.jpg",0,3,35,61,0,99,3.58585858585859,0.553469594506218,73.3276699029126
"7972772456.jpg",0,3,48,53,0,104,3.48076923076923,0.557051342926048,67.7891304347826
"7973547250.jpg",0,2,47,58,5,112,3.58928571428571,0.608551247089857,70.8782051282051
"7974391613.jpg",0,0,24,71,2,97,3.77319587628866,0.467821962199458,77.9471153846154
"7974813040.jpg",0,1,53,88,0,142,3.61267605633803,0.503161516153142,74.4893617021277
"7974813912.jpg",1,16,64,19,1,101,3.02970297029703,0.655064050983634,56.275
"7975750167.jpg",0,0,50,55,2,107,3.55140186915888,0.536122431451909,71.640625
"7977665407.jpg",10,86,12,0,0,108,2.01851851851852,0.453057762434833,27.7605042016807
"7978014444.jpg",0,7,62,37,0,106,3.28301886792453,0.581536830609117,60.6081081081081
"7978282630.jpg",0,24,77,7,0,108,2.84259259259259,0.514500702288051,50.9852941176471
"7979358830.jpg",0,1,46,67,1,115,3.59130434782609,0.528082465880476,72.7171052631579
"7979712862.jpg",1,9,70,23,0,103,3.11650485436893,0.582438600210717,56.0474137931034
"7979893598.jpg",1,18,78,8,1,106,2.90566037735849,0.561092503820596,52.1941964285714
"7980164509.jpg",0,15,76,13,0,104,2.98076923076923,0.521029027213842,54.002358490566
"7980394491.jpg",0,14,78,27,2,121,3.1404958677686,0.623241327309186,58.75
"7981422171.jpg",4,24,58,19,0,105,2.87619047619048,0.742853620729886,49.1621621621622
"7981733981.jpg",3,69,33,3,0,108,2.33333333333333,0.580041893427398,35.8877118644068
"7983035556.jpg",0,1,40,61,1,103,3.60194174757282,0.530257167080327,72.671875
"7983388187.jpg",0,0,21,86,4,111,3.84684684684685,0.451224560062508,74.8340336134454
"7983529291.jpg",5,36,57,5,0,103,2.60194174757282,0.661842434676179,45.462389380531
"7983700558.jpg",0,2,45,56,1,104,3.53846153846154,0.556044925946993,68.1891891891892
"7984667593.jpg",0,18,78,13,0,109,2.95412844036697,0.533772754756828,53.2731092436975
"7985643395.jpg",0,2,47,51,1,101,3.5049504950495,0.558994854649622,69.9350961538462
"7987564601.jpg",0,10,67,26,0,103,3.15533980582524,0.573213876407266,58.4553571428571
"7987926613.jpg",0,5,52,48,2,107,3.4392523364486,0.617016101643941,68.5137614678899
"7989292953.jpg",2,33,51,16,1,103,2.81553398058252,0.750784854897729,49.0212264150943
"7989520325.jpg",0,23,82,7,0,112,2.85714285714286,0.499678146088309,50.010593220339
"7991164057.jpg",0,5,61,35,1,102,3.31372549019608,0.5798666995481,60.8861607142857
"7991223182.jpg",0,4,58,41,0,103,3.35922330097087,0.557557153177668,65.3648648648649
"7991449337.jpg",0,0,21,65,13,99,3.91919191919192,0.583388547612185,80.8509174311927
"7992243526.jpg",18,71,22,0,0,111,2.03603603603604,0.601935181166513,26.8879310344828
"7992863678.jpg",0,3,57,42,0,102,3.38235294117647,0.54580520311164,63.7284482758621
"7993315454.jpg",0,12,68,27,0,107,3.14018691588785,0.589988777169262,58.9
"7993457702.jpg",1,17,68,18,0,104,2.99038461538462,0.615262077045495,53.5847826086957
"7994018610.jpg",0,2,33,69,8,112,3.74107142857143,0.611386486842354,72.2436440677966
"7994058325.jpg",1,20,61,16,0,98,2.93877551020408,0.639205797984946,50.8855140186916
"7994313310.jpg",1,1,61,69,0,132,3.5,0.559443562154969,70.0858778625954
"7996052982.jpg",0,3,52,44,0,99,3.41414141414141,0.553469594506218,64.8050458715596
"7996349699.jpg",0,12,73,23,0,108,3.10185185185185,0.562700677637197,57.0855263157895
"7998024612.jpg",0,6,57,34,1,98,3.30612244897959,0.599108672401358,62.7635135135135
"7998388938.jpg",0,0,15,84,7,106,3.92452830188679,0.451412876317967,79.1239130434783
"7998553110.jpg",0,2,24,78,7,111,3.81081081081081,0.564293822779869,77.6970338983051
"7999186610.jpg",0,17,84,8,0,109,2.91743119266055,0.473920613116298,52.2522123893805
"7999779242.jpg",0,0,48,58,1,107,3.5607476635514,0.51720530016433,69.475
"7999886083.jpg",0,1,41,63,1,106,3.60377358490566,0.528776580473741,71.5913043478261
"8000756995.jpg",4,40,52,6,0,102,2.58823529411765,0.66530631933266,40.8876146788991
"8000770201.jpg",1,9,69,28,0,107,3.1588785046729,0.601092287365109,60.2428571428571
"8001662105.jpg",0,8,69,29,0,106,3.19811320754717,0.559247986917716,60.5915178571429
"8002007313.jpg",0,0,26,72,3,101,3.77227722772277,0.487466678221433,75.1714285714286
"8003027258.jpg",0,20,69,13,0,102,2.93137254901961,0.567429568562114,52.0420560747664
"8003457683.jpg",0,14,98,18,0,130,3.03076923076923,0.497099518033221,56.4763779527559
"8003576007.jpg",0,3,66,40,0,109,3.3394495412844,0.530900414150486,65.4078947368421
"8003923043.jpg",1,14,77,9,0,101,2.93069306930693,0.514925737219927,53.7847222222222
"8005430981.jpg",0,1,26,67,7,101,3.79207920792079,0.571258814954628,75.625
"8005792260.jpg",0,2,39,58,0,99,3.56565656565657,0.537598897624298,70.225
"8006234274.jpg",0,0,26,79,5,110,3.80909090909091,0.497617342124099,76.3451327433628
"8008251007.jpg",11,82,46,2,0,141,2.27659574468085,0.622281321070456,33.8244680851064
"8008341376.jpg",0,4,51,49,1,105,3.44761904761905,0.588037027565055,66.7130434782609
"8009325601.jpg",1,0,19,90,1,111,3.81081081081081,0.476988917605459,74.6153846153846
"8009623425.jpg",0,2,34,68,2,106,3.66037735849057,0.550095964837135,73.0127118644068
"8010069396.jpg",0,1,30,63,9,103,3.77669902912621,0.60927534641092,73.8275862068966
"8010819148.jpg",0,0,53,51,0,104,3.49038461538462,0.502328409725477,67.2972972972973
"8012731043.jpg",1,4,67,32,2,106,3.28301886792453,0.613416924652503,60.0783898305085
"8015526971.jpg",0,0,32,56,19,107,3.8785046728972,0.682811617627173,76.7752100840336
"8015637389.jpg",0,0,47,54,0,101,3.53465346534653,0.501285476263647,68.0117924528302
"8015825692.jpg",0,2,58,50,1,111,3.45045045045045,0.551670829698929,66.5875
"8016728166.jpg",1,2,35,68,3,109,3.64220183486239,0.616485495606262,70.3
"8016790601.jpg",0,7,61,53,4,125,3.432,0.651747031867723,68.609756097561
"8016871394.jpg",0,1,36,66,4,107,3.68224299065421,0.559617976856677,75.1743119266055
"8016925192.jpg",0,2,51,49,1,103,3.47572815533981,0.557386411433294,64.7165178571429
"8017805417.jpg",0,2,30,61,3,96,3.67708333333333,0.571144587955517,75.8970588235294
"80184044.jpg",94,10,0,0,0,104,1.09615384615385,0.296229731410389,3.91176470588235
"8019221019.jpg",0,54,83,3,0,140,2.63571428571429,0.525750088150381,44.3972602739726
"8020716606.jpg",0,2,33,74,1,110,3.67272727272727,0.526527326788343,73.275641025641
"8020739978.jpg",0,1,44,57,3,105,3.59047619047619,0.566623570867177,70.8303571428571
"8020768393.jpg",0,0,30,70,3,103,3.7378640776699,0.504123487994673,72.8191964285714
"8021300262.jpg",0,0,44,69,7,120,3.69166666666667,0.576804196614842,74.4809322033898
"8021353022.jpg",0,0,31,70,4,105,3.74285714285714,0.519403715601092,74.9553571428571
"8021456503.jpg",0,0,35,72,2,109,3.69724770642202,0.50008494011783,72.7542016806723
"8021464988.jpg",0,0,35,61,3,99,3.67676767676768,0.531234273779869,74.125
"8022493551.jpg",0,12,68,25,1,106,3.14150943396226,0.608490391915115,57.7794117647059
"8023712580.jpg",0,1,36,67,4,108,3.68518518518519,0.55783540513105,72.4075630252101
"8023758470.jpg",0,0,54,51,2,107,3.51401869158878,0.538419875108153,67.2796610169491
"8025466958.jpg",1,3,86,50,1,141,3.33333333333333,0.569042637953892,64.9234693877551
"8026326591.jpg",0,1,33,62,4,100,3.69,0.563090318750649,72.2224770642202
"8027425918.jpg",0,0,26,72,3,101,3.77227722772277,0.487466678221433,75.1
"8030242803.jpg",1,13,66,26,0,106,3.10377358490566,0.631389175631893,58.9086538461538
"8033033726.jpg",0,0,17,84,5,106,3.88679245283019,0.443379977144857,79.3378378378378
"8033437927.jpg",1,5,60,32,2,100,3.29,0.640312423743285,63.4
"8034708472.jpg",0,9,88,42,0,139,3.23741007194245,0.559279217981445,62.8177083333333
"8034781018.jpg",0,0,14,84,4,102,3.90196078431373,0.410500875448437,79.2614678899083
"8035433785.jpg",0,0,30,68,3,101,3.73267326732673,0.507761540664728,74.35
"8035478082.jpg",7,69,22,0,0,98,2.1530612244898,0.524690204450119,28.7570093457944
"8036033409.jpg",0,3,63,38,3,107,3.38317757009346,0.593118713070191,65.6004464285714
"8036386438.jpg",0,0,25,85,1,111,3.78378378378378,0.43495883620084,75.25
"8036607222.jpg",0,0,42,58,4,104,3.63461538461538,0.558390410586359,74.1903669724771
"8039052171.jpg",0,8,44,46,4,102,3.45098039215686,0.69833537547616,65.0111607142857
"8039894154.jpg",2,41,55,3,0,101,2.58415841584158,0.587661922072092,41.2924107142857
"8040007574.jpg",0,1,19,69,11,100,3.9,0.577350269189626,78.9587155963303
"8040267298.jpg",0,0,30,64,6,100,3.76,0.552679423766206,74.35
"8040993311.jpg",14,79,13,3,0,109,2.04587155963303,0.599155595646713,28.896186440678
"8041277931.jpg",1,2,30,58,15,106,3.79245283018868,0.739587801955547,75.25
"80417582.jpg",2,51,48,2,0,103,2.48543689320388,0.575037554952665,38.7836134453782
"8041921391.jpg",0,2,34,66,1,103,3.64077669902913,0.539687072220866,71.95
"8041987489.jpg",6,45,40,12,0,103,2.56310679611651,0.775480912302499,43.4181415929204
"8042065108.jpg",0,0,42,62,2,106,3.62264150943396,0.524682764719683,70.7693965517241
"8042361563.jpg",0,1,32,67,2,102,3.68627450980392,0.526155346500202,74.3008849557522
"8042697281.jpg",0,6,59,39,3,107,3.36448598130841,0.635320797952543,61.9661016949153
"8042762603.jpg",0,0,27,75,5,107,3.79439252336449,0.509130182355242,73.7941176470588
"8043120593.jpg",0,2,47,59,4,112,3.58035714285714,0.594848649947965,70.4551282051282
"8043238323.jpg",0,2,26,76,3,107,3.74766355140187,0.533649908982546,75.6216216216216
"8043482690.jpg",0,13,54,33,4,104,3.26923076923077,0.727153904340382,61.1283783783784
"8044678667.jpg",0,0,27,76,8,111,3.82882882882883,0.537229828486737,78.9166666666667
"8044704113.jpg",0,2,53,42,3,100,3.46,0.593227774062537,68.8071428571429
"8044706176.jpg",1,60,46,2,0,109,2.44954128440367,0.552540237048483,39.0769230769231
"8045159223.jpg",0,33,60,12,0,105,2.8,0.62634470725607,47.2995689655172
"8045790915.jpg",0,17,69,22,0,108,3.0462962962963,0.601932390702485,55.0063025210084
"8046864953.jpg",0,2,59,45,1,107,3.42056074766355,0.550083753101153,68.1891891891892
"8048106336.jpg",0,0,44,61,1,106,3.59433962264151,0.512292734149835,71.0173913043478
"8049709940.jpg",0,22,58,22,0,102,3,0.660033002475206,53.4518348623853
"80498915.jpg",0,5,55,42,1,103,3.37864077669903,0.596008041371744,63.8109243697479
"8050471028.jpg",0,1,19,79,7,106,3.86792452830189,0.517787816408617,75.8189655172414
"8050482362.jpg",0,4,66,34,0,104,3.28846153846154,0.533773467878652,63.3169642857143
"8050953362.jpg",0,2,47,75,2,126,3.61111111111111,0.55095876030385,72.9879032258064
"8051569032.jpg",0,2,28,77,1,108,3.71296296296296,0.512478418527609,77.2935779816514
"8053452721.jpg",0,16,84,11,0,111,2.95495495495495,0.493362993552459,53.0868644067797
"8054439590.jpg",3,66,40,0,0,109,2.3394495412844,0.530900414150486,37.3846153846154
"8055471009.jpg",0,3,71,34,0,108,3.28703703703704,0.512478418527609,61.7433628318584
"8055570957.jpg",3,48,67,3,0,121,2.57851239669421,0.588105235986759,43.83125
"8056188485.jpg",0,30,63,17,0,110,2.88181818181818,0.645830923166245,50.9159663865546
"8056693769.jpg",0,5,51,46,4,106,3.4622641509434,0.649901506118417,68.4732142857143
"8058467090.jpg",9,48,38,8,0,103,2.43689320388349,0.762733768892044,38.35
"8059797614.jpg",0,6,64,34,0,104,3.26923076923077,0.561391634768236,60.6775700934579
"8060303212.jpg",2,45,46,14,0,107,2.67289719626168,0.723926673741429,45.1571428571429
"8060465172.jpg",0,5,56,39,1,101,3.35643564356436,0.593028809010854,61.5491071428571
"8060595540.jpg",0,2,61,40,1,104,3.38461538461538,0.545194225793602,65.1584821428571
"8062771626.jpg",0,0,17,76,15,108,3.98148148148148,0.546552175027866,79.6176470588235
"8064104833.jpg",0,5,55,44,0,104,3.375,0.577700496864656,66.8526785714286
"8064361291.jpg",2,56,44,1,0,103,2.42718446601942,0.553100738042354,38.4806034482759
"8065579848.jpg",1,3,60,42,2,108,3.37962962962963,0.622289901377863,65.1747787610619
"8066151099.jpg",0,11,81,19,1,112,3.08928571428571,0.546134185216919,57.5512820512821
"8066534702.jpg",0,6,59,33,1,99,3.29292929292929,0.593373703573349,61.8716216216216
"8066713457.jpg",0,4,61,40,2,107,3.37383177570093,0.59118308765705,65.5878378378378
"8067632249.jpg",1,31,56,12,0,100,2.79,0.655897873301949,47.8509174311927
"8069073334.jpg",0,8,79,19,0,106,3.10377358490566,0.496257331154079,57.745652173913
"8070731836.jpg",0,0,47,61,3,111,3.6036036036036,0.544046777388577,70.4314159292035
"8072726562.jpg",0,18,81,9,0,108,2.91666666666667,0.495305060345378,53.1052631578947
"8072879274.jpg",0,3,45,53,1,102,3.50980392156863,0.575835132469745,71.2345132743363
"8073301888.jpg",0,3,59,44,0,106,3.38679245283019,0.544596918952884,64.7565789473684
"8073500928.jpg",2,20,74,15,0,111,2.91891891891892,0.619899333985111,50.3601694915254
"8073658473.jpg",0,0,19,75,6,100,3.87,0.48523658709391,74.9579646017699
"8074116162.jpg",8,73,27,1,0,109,2.19266055045872,0.568901869755062,32.1281512605042
"8074309631.jpg",0,3,52,46,3,104,3.47115384615385,0.60670574383033,70.2839805825243
"8075121778.jpg",0,2,27,73,1,103,3.70873786407767,0.516987274868333,75.8445945945946
"8076181424.jpg",0,1,16,76,8,101,3.9009900990099,0.519710505859743,81.775
"8077318332.jpg",2,13,79,12,0,106,2.95283018867925,0.558604988157329,52.2217391304348
"8077601732.jpg",1,4,57,38,2,102,3.35294117647059,0.639415866217659,64.9
"8077634378.jpg",0,3,60,55,3,121,3.47933884297521,0.593003282083652,68.44375
"8078070846.jpg",38,64,8,0,0,110,1.72727272727273,0.589029537881659,20.3205128205128
"8078731890.jpg",0,1,53,49,2,105,3.4952380952381,0.556842221884494,67.4419642857143
"8079522861.jpg",0,9,62,28,2,101,3.22772277227723,0.630574152956048,59.052752293578
"8081563599.jpg",6,60,34,1,0,101,2.2970297029703,0.592360607323707,35.8857142857143
"8081688318.jpg",0,3,48,50,0,101,3.46534653465347,0.557931114666382,65.0287610619469
"8082249517.jpg",0,6,54,86,2,148,3.56756756756757,0.596613597330142,73.578431372549
"8083120146.jpg",0,0,16,85,5,106,3.89622641509434,0.434889045138311,77.3486842105263
"8083395637.jpg",0,0,35,63,10,108,3.76851851851852,0.605372851533239,74.5263157894737
"8083559682.jpg",0,0,12,86,12,110,4,0.469237132203465,77.45
"8084074435.jpg",7,67,25,0,0,99,2.18181818181818,0.541419833394177,29.4428571428571
"8084640023.jpg",27,59,14,2,0,102,1.91176470588235,0.69085885960195,23.9334862385321
"8086705362.jpg",0,0,35,65,5,105,3.71428571428571,0.549725206078275,74.0021008403361
"8086991348.jpg",0,2,32,68,4,106,3.69811320754717,0.571877631278959,72.6946902654867
"8087032429.jpg",0,12,65,28,0,105,3.15238095238095,0.600976007151834,60.8529411764706
"8087906672.jpg",0,0,37,66,3,106,3.67924528301887,0.526392390510218,73.1138392857143
"8088105369.jpg",0,3,55,47,1,106,3.43396226415094,0.569358334309913,68.3995535714286
"8088110789.jpg",0,0,19,70,11,100,3.92,0.544578420951158,78.7967289719626
"8088364175.jpg",4,57,45,2,0,108,2.41666666666667,0.597893498471106,37.50625
"8089499290.jpg",0,2,51,53,3,109,3.52293577981651,0.586835996321222,68.925
"8090282985.jpg",1,44,84,1,0,130,2.65384615384615,0.509012396272169,44.8125
"8090361774.jpg",10,53,36,2,0,101,2.2970297029703,0.671484243380968,35.9861111111111
"8091151386.jpg",15,82,13,1,0,111,2,0.539359889970594,27.6377118644068
"8093852043.jpg",1,27,63,14,0,105,2.85714285714286,0.641940738766369,47.5840517241379
"8094310910.jpg",0,0,34,66,5,105,3.72380952380952,0.545880342186223,72.8407079646018
"8094870766.jpg",0,1,45,62,2,110,3.59090909090909,0.546808161946805,71.3347457627119
"80954980.jpg",0,8,51,44,3,106,3.39622641509434,0.67159008590514,64.59375
"8095635777.jpg",0,13,81,13,0,107,3,0.495260556543649,55.3616071428571
"8095851163.jpg",0,16,74,14,0,104,2.98076923076923,0.539341008015854,55.4054054054054
"8096129179.jpg",0,1,29,67,3,100,3.72,0.533333333333333,73.3577981651376
"8100293037.jpg",0,5,41,57,4,107,3.5607476635514,0.646873031393711,69.4308035714286
"8100313754.jpg",0,1,6,76,23,106,4.14150943396226,0.542282288907294,85.0252100840336
"81006585.jpg",24,68,11,0,0,103,1.87378640776699,0.571883912025026,23.046218487395
"8100783568.jpg",0,5,71,31,0,107,3.24299065420561,0.529170256429054,59.6512605042017
"8101870815.jpg",0,5,54,39,0,98,3.3469387755102,0.576195141921331,61.4017857142857
"8102502953.jpg",0,3,62,36,1,102,3.34313725490196,0.553925648926753,66.1238938053097
"8102673511.jpg",5,72,23,0,0,100,2.18,0.50010099990003,29.7614678899083
"8103481984.jpg",0,32,63,12,0,107,2.81308411214953,0.61630121772686,47.8
"8103867208.jpg",0,1,56,49,0,106,3.45283018867925,0.51882790011439,70.0200892857143
"8104089685.jpg",0,10,64,29,1,104,3.20192307692308,0.613438624054357,60.2364864864865
"8105160200.jpg",0,8,62,33,1,104,3.25961538461538,0.607320908240659,63.0367647058824
"8106242836.jpg",0,11,61,32,0,104,3.20192307692308,0.613438624054357,62.6822429906542
"8106557639.jpg",0,0,64,42,1,107,3.41121495327103,0.513097714553428,66.554054054054
"8106933398.jpg",0,7,30,66,2,105,3.6,0.64450338663549,74.5291262135922
"8107402006.jpg",0,0,54,54,2,110,3.52727272727273,0.536880061249071,68.6923076923077
"8107454103.jpg",0,2,22,74,12,110,3.87272727272727,0.607432420208976,77.7457983193277
"8108582186.jpg",0,5,55,43,2,105,3.4,0.61394061351492,65.6973684210526
"8108590859.jpg",6,76,17,2,0,101,2.14851485148515,0.536397960731794,28.9288990825688
"8108709244.jpg",0,1,32,65,4,102,3.70588235294118,0.555587910790175,71.0114678899083
"8108820426.jpg",0,1,15,78,10,104,3.93269230769231,0.526288028433379,81.6495327102804
"8108912190.jpg",0,2,51,54,4,111,3.54054054054054,0.599754249426513,67.2796610169491
"8109380358.jpg",0,39,85,2,0,126,2.70634920634921,0.490998335108547,47.5487804878049
"8109558815.jpg",0,13,61,30,0,104,3.16346153846154,0.624897302989097,59.4779411764706
"8109560495.jpg",0,0,24,79,2,105,3.79047619047619,0.453516984993567,77.1911764705882
"8110370052.jpg",0,3,56,42,2,103,3.41747572815534,0.586185272268683,67
"8113113251.jpg",0,3,60,45,1,109,3.40366972477064,0.563048350911192,67
"8113190555.jpg",0,0,31,73,4,108,3.75,0.513827492052328,78.2171052631579
"8113244210.jpg",0,0,23,84,3,110,3.81818181818182,0.452958028754517,77.0833333333333
"8113245382.jpg",0,1,8,90,11,110,4.00909090909091,0.459266558194944,79.03125
"8113369457.jpg",0,2,38,63,2,105,3.61904761904762,0.561264924094064,73.1875
"8113498731.jpg",0,0,46,60,2,108,3.59259259259259,0.530156687066959,72.1
"8114138182.jpg",0,0,27,73,7,107,3.81308411214953,0.534310367043445,78.9344660194175
"8114369605.jpg",0,0,25,68,11,104,3.86538461538462,0.575514835919073,79.4906542056075
"8115151138.jpg",0,5,58,45,0,108,3.37037037037037,0.573440063479698,64.59375
"8115433304.jpg",2,27,53,20,0,102,2.8921568627451,0.729937780409583,50.8966346153846
"8116678978.jpg",0,0,21,78,4,103,3.83495145631068,0.466465377708571,78.5353982300885
"8116711629.jpg",1,0,19,76,6,102,3.84313725490196,0.55837632434446,77.1357142857143
"8118290739.jpg",1,6,75,26,0,108,3.16666666666667,0.555347832401704,57.6644736842105
"8120535413.jpg",2,36,61,8,0,107,2.70093457943925,0.632678541748658,46.825
"8120735257.jpg",0,3,36,69,0,108,3.61111111111111,0.544013010656216,72.7594339622642
"8120809574.jpg",0,17,68,23,0,108,3.05555555555556,0.608864936503513,55.1824324324324
"8121424411.jpg",1,39,52,9,0,101,2.68316831683168,0.647003756856279,43.9151376146789
"8121591181.jpg",0,15,63,23,0,101,3.07920792079208,0.611280104646498,57.2571428571429
"8121860471.jpg",0,2,56,45,3,106,3.4622641509434,0.588371898941911,66.2373949579832
"8121986127.jpg",1,0,30,71,8,110,3.77272727272727,0.615683269417158,75.3947368421053
"8122853098.jpg",5,55,68,5,0,133,2.54887218045113,0.633247586861304,42.0091240875912
"8123324192.jpg",0,4,65,34,0,103,3.29126213592233,0.535615240179964,64.1995412844037
"8125828960.jpg",0,16,68,17,0,101,3.00990099009901,0.574370081131503,53.0826086956522
"8125869229.jpg",0,3,78,49,0,130,3.35384615384615,0.526234811584218,66.2204724409449
"8126953338.jpg",0,5,92,43,0,140,3.27142857142857,0.520692084306853,63.7111486486486
"8127311442.jpg",0,35,66,6,0,107,2.72897196261682,0.559145126770676,47.1845794392523
"8127846229.jpg",1,37,52,13,0,103,2.74757281553398,0.681958635424635,46.1540178571429
"8128148667.jpg",0,2,33,58,6,99,3.68686868686869,0.616879319499211,73.45
"8128298263.jpg",0,2,16,92,4,114,3.85964912280702,0.477404356959037,81.9802631578947
"8128596449.jpg",2,26,67,12,0,107,2.83177570093458,0.636707054887574,52
"8128896956.jpg",4,34,52,12,1,103,2.72815533980583,0.756594210368004,47.8028846153846
"8129021372.jpg",0,22,63,11,0,96,2.88541666666667,0.578014599463528,50.0240384615385
"8129206186.jpg",0,4,49,75,4,132,3.59848484848485,0.603549911732149,72.875
"81292981.jpg",42,56,7,0,0,105,1.66666666666667,0.599144689515278,17.6375
"8130387818.jpg",0,10,73,19,0,102,3.08823529411765,0.528456395467316,57.4121621621622
"8130446271.jpg",0,2,80,31,0,113,3.25663716814159,0.477694632396556,60.9547413793103
"8130469512.jpg",0,14,69,20,1,104,3.07692307692308,0.602459484877279,56.9719827586207
"8130745750.jpg",0,14,68,20,0,102,3.05882352941176,0.577182117076204,57.3221153846154
"8131856300.jpg",0,1,50,50,2,103,3.51456310679612,0.557727842651489,69.304054054054
"8132171428.jpg",0,3,56,44,1,104,3.41346153846154,0.567922067043096,67.445945945946
"8132808180.jpg",0,13,57,25,1,96,3.14583333333333,0.648547635172405,57.285046728972
"8132835141.jpg",0,0,3,79,20,102,4.16666666666667,0.446844455036313,83.7270642201835
"8134031054.jpg",0,37,66,4,0,107,2.69158878504673,0.539238018529624,46.2710084033613
"8135725807.jpg",0,1,44,55,5,105,3.60952380952381,0.596387169276516,71.125
"8136167992.jpg",0,7,64,36,0,107,3.27102803738318,0.575770090678299,63.2219626168224
"8137649050.jpg",0,5,44,60,1,110,3.51818181818182,0.601707328988215,69.1673728813559
"8137709650.jpg",0,5,72,76,1,154,3.47402597402597,0.573921858770456,69.4483870967742
"8137767984.jpg",48,50,4,0,0,102,1.56862745098039,0.571775139655522,14.2616822429907
"8138101923.jpg",0,8,60,35,0,103,3.2621359223301,0.5934473075465,63.3071428571429
"8141906514.jpg",0,12,64,29,0,105,3.16190476190476,0.606436779693949,58.3849557522124
"8142530403.jpg",0,3,63,43,2,111,3.3963963963964,0.576498510276074,67.1434782608696
"8142555462.jpg",0,37,57,8,0,102,2.7156862745098,0.603249467802339,47.6736111111111
"8142580716.jpg",1,27,67,20,0,115,2.92173913043478,0.664221296971209,50.1413043478261
"8142588958.jpg",0,1,45,59,0,105,3.55238095238095,0.518521425656133,68.6941964285714
"8142609774.jpg",0,4,47,57,1,109,3.5045871559633,0.587270100187506,65.6716101694915
"8142864218.jpg",0,3,75,53,0,131,3.38167938931298,0.532887854664426,66.25
"8144270233.jpg",0,2,46,57,0,105,3.52380952380952,0.538788493096354,69.6756756756757
"8144691822.jpg",0,3,30,63,8,104,3.73076923076923,0.642065375354044,75.6428571428571
"8145791705.jpg",1,16,59,34,1,111,3.16216216216216,0.707627798165887,58.54375
"8148747862.jpg",0,1,33,72,0,106,3.66981132075472,0.492258122634042,75.0049504950495
"8150322605.jpg",0,2,50,54,0,106,3.49056603773585,0.538875071993994,68.4513888888889
"8152475637.jpg",2,49,49,3,0,103,2.51456310679612,0.591841222578484,39.2299107142857
"8152535252.jpg",35,62,7,0,0,104,1.73076923076923,0.578427215227558,17.802752293578
"8152567908.jpg",0,13,72,28,0,113,3.13274336283186,0.590163790502885,57.9180672268908
"8152645114.jpg",0,6,65,34,0,105,3.26666666666667,0.559303596287842,63.0575221238938
"8154204617.jpg",0,2,38,67,5,112,3.66964285714286,0.591050261687119,73.3461538461538
"8154345084.jpg",0,0,36,69,1,106,3.66981132075472,0.492258122634042,74.7740384615385
"8154496951.jpg",0,22,61,15,0,98,2.92857142857143,0.613423719621123,50.651376146789
"8155106995.jpg",1,11,64,29,2,107,3.18691588785047,0.674758393119209,61.1381578947368
"8156018718.jpg",0,2,18,83,5,108,3.84259259259259,0.514500702288051,80.5066371681416
"8156608688.jpg",0,0,11,80,17,108,4.05555555555556,0.508494816289357,82.5592105263158
"8157038620.jpg",0,3,32,65,5,105,3.68571428571429,0.609449400220044,71.3108108108108
"8157117322.jpg",0,0,23,75,4,102,3.81372549019608,0.48195953482134,79.6305309734513
"8157884969.jpg",2,58,61,13,1,135,2.65185185185185,0.705188854968595,45.3283582089552
"8157886874.jpg",0,3,49,56,3,111,3.53153153153153,0.600300225187664,71.1961206896552
"8158011851.jpg",0,1,42,62,0,105,3.58095238095238,0.514799295860353,69.2239130434783
"8158072489.jpg",0,2,31,61,12,106,3.78301886792453,0.661955501038323,75.9612068965517
"8158344434.jpg",0,1,40,63,1,105,3.60952380952381,0.527972138237027,72.4276315789474
"8158453521.jpg",0,2,54,47,1,104,3.45192307692308,0.55528891618072,68.8922018348624
"8159044184.jpg",0,12,47,44,3,106,3.35849056603774,0.71963852361589,63.3092105263158
"8159815111.jpg",3,63,63,1,0,130,2.47692307692308,0.559836418735328,39.625
"8161767113.jpg",1,5,55,47,2,110,3.4,0.65244775529884,65.0287610619469
"8162335542.jpg",2,49,51,3,0,105,2.52380952380952,0.589902829273897,38.95
"8162764501.jpg",0,0,27,69,10,106,3.83962264150943,0.571327484320177,78.55
"8163644568.jpg",35,69,4,0,0,108,1.71296296296296,0.53040146892859,18.8172268907563
"8164370728.jpg",1,13,68,22,0,104,3.06730769230769,0.611609734645443,58.2647058823529
"8164688693.jpg",0,3,48,55,3,109,3.53211009174312,0.601984485764307,69.5651260504202
"8165044722.jpg",2,32,55,18,0,107,2.83177570093458,0.720141250667825,49.4048672566372
"8165323576.jpg",28,64,12,0,0,104,1.84615384615385,0.603697840726373,22.2455752212389
"8166756819.jpg",1,29,57,21,0,108,2.90740740740741,0.704286435954755,53.0683962264151
"8167486220.jpg",0,0,40,58,7,105,3.68571428571429,0.593462553323967,72.1652173913044
"8167676296.jpg",5,39,55,5,0,104,2.57692307692308,0.663797660308635,43.5758928571429
"8167934912.jpg",0,1,23,82,6,112,3.83035714285714,0.517937574191457,74.6153846153846
"8169167251.jpg",0,9,70,23,0,102,3.13725490196078,0.545716273546388,58.8285714285714
"8171751224.jpg",0,1,74,61,2,138,3.46376811594203,0.542492494345536,68.1538461538462
"8171907364.jpg",7,79,19,0,0,105,2.11428571428571,0.486634551602316,29.5855263157895
"8172599370.jpg",0,6,69,31,0,106,3.23584905660377,0.544266860183807,63.4642857142857
"8174015928.jpg",2,44,48,8,0,102,2.6078431372549,0.662381881793784,45.0973451327434
"8175674967.jpg",0,4,43,56,6,109,3.58715596330275,0.655616887540276,69.9413043478261
"8175828572.jpg",0,1,38,68,2,109,3.65137614678899,0.533613585898434,70.7754237288136
"8176025549.jpg",0,1,19,79,3,102,3.82352941176471,0.475368844930275,76.75
"8176328950.jpg",0,1,55,47,1,104,3.46153846153846,0.538301480532277,70.392523364486
"8176381032.jpg",0,13,74,16,0,103,3.02912621359223,0.532406867113158,55.8702830188679
"8177148898.jpg",0,4,71,24,2,101,3.23762376237624,0.550427376708048,61.6
"8177168382.jpg",1,38,59,4,0,102,2.64705882352941,0.574146957824214,42.3934782608696
"8178464033.jpg",0,0,27,73,4,104,3.77884615384615,0.50158449460463,75.9129464285714
"8178540063.jpg",1,34,60,7,0,102,2.7156862745098,0.603249467802339,47.1852678571429
"8178731250.jpg",0,2,45,62,1,110,3.56363636363636,0.550683857210433,67.4159663865546
"8178834291.jpg",0,21,75,6,0,102,2.85294117647059,0.495465753949974,51.3561320754717
"8179375247.jpg",0,0,17,84,2,103,3.85436893203884,0.406027309771425,80.3455882352941
"8179397976.jpg",0,0,42,58,2,102,3.6078431372549,0.529465688920931,71.0093457943925
"8179500414.jpg",0,0,25,70,3,98,3.77551020408163,0.487590588884804,78.8543689320388
"8179614383.jpg",0,8,81,21,0,110,3.11818181818182,0.501956140154561,57.6923076923077
"8179882827.jpg",0,0,44,55,3,102,3.59803921568627,0.549703861256738,73.0347222222222
"8181726766.jpg",2,53,46,2,0,103,2.46601941747573,0.574209328172611,40.6163366336634
"8182062575.jpg",0,46,53,6,0,105,2.61904761904762,0.594541717190521,43.1108695652174
"8182393998.jpg",5,43,51,6,0,105,2.55238095238095,0.679096577205453,42.25
"8183741020.jpg",0,2,48,55,0,105,3.5047619047619,0.539298146522395,66.6283783783784
"8183781293.jpg",5,48,49,3,0,105,2.47619047619048,0.636928297124296,38.9073275862069
"8183790186.jpg",0,5,58,44,0,107,3.36448598130841,0.572853225702578,64.695945945946
"8184075727.jpg",0,0,40,63,0,103,3.61165048543689,0.489758037673144,71.6725663716814
"8184338593.jpg",1,40,65,1,0,107,2.61682242990654,0.525659689990427,42.3223684210526
"8184978499.jpg",0,1,41,64,1,107,3.60747663551402,0.527668587846476,73.675
"8185021640.jpg",0,0,27,81,4,112,3.79464285714286,0.486546810931692,76.1034482758621
"8185807831.jpg",1,5,70,30,2,108,3.25,0.613325545121892,61.2323008849558
"8185829074.jpg",0,1,47,53,6,107,3.5981308411215,0.612138427495947,73.4247787610619
"8186224852.jpg",0,4,54,44,4,106,3.45283018867925,0.634441268574515,66.6533613445378
"8186599780.jpg",0,31,85,18,1,135,2.91851851851852,0.623565240956495,53.3533834586466
"818793256.jpg",1,11,66,29,1,108,3.16666666666667,0.648506551750675,58.6113445378151
"8188022955.jpg",0,4,65,38,0,107,3.31775700934579,0.542498253907659,65.2877358490566
"8188461365.jpg",0,7,67,34,0,108,3.25,0.565768024851109,61.9459459459459
"8188524067.jpg",1,30,68,2,0,101,2.7029702970297,0.5204719868628,45.5202702702703
"8189076643.jpg",0,2,17,75,7,101,3.86138613861386,0.548264588867401,79
"8189726942.jpg",0,5,67,35,0,107,3.2803738317757,0.545900545979958,62.9826086956522
"8191059336.jpg",0,1,47,74,1,123,3.60975609756098,0.522198165096879,73.3409090909091
"8192678214.jpg",0,0,34,74,0,108,3.68518518518519,0.466607324516545,75.6150442477876
"8192992760.jpg",0,7,71,27,0,105,3.19047619047619,0.538788493096354,60.0135135135135
"8194129270.jpg",0,2,42,56,0,100,3.54,0.539734315485991,68.3107476635514
"8194417466.jpg",0,0,17,82,9,108,3.92592592592593,0.487290884048434,80.8243243243243
"8195268203.jpg",13,74,16,1,0,104,2.04807692307692,0.563963224241827,26.3340707964602
"8195491375.jpg",1,28,59,15,1,104,2.875,0.692364739164868,50.651376146789
"8195543723.jpg",0,2,36,62,8,108,3.7037037037037,0.630372375623148,76.7287735849057
"8195809276.jpg",0,19,79,11,0,109,2.92660550458716,0.521863151111417,52.9264705882353
"8195917264.jpg",0,0,35,70,1,106,3.67924528301887,0.488869830007768,75.3986486486486
"8196266010.jpg",6,50,41,3,0,100,2.41,0.652810551509101,36.5733944954128
"8197822329.jpg",2,62,37,2,0,103,2.37864077669903,0.562147577692258,37.135
"8199545794.jpg",0,0,23,71,10,104,3.875,0.551916343738285,77.6592920353982
"8199731208.jpg",0,3,43,52,1,99,3.51515151515152,0.577885596397065,70.1730769230769
"8199832249.jpg",1,6,62,36,0,105,3.26666666666667,0.608697642933518,61.9883177570093
"8200520446.jpg",0,18,83,6,0,107,2.88785046728972,0.462297437614845,51.475
"8201445603.jpg",0,2,38,61,3,104,3.625,0.577700496864656,71.1615044247788
"8201535489.jpg",0,1,32,58,7,98,3.72448979591837,0.605483741937365,70.6504424778761
"8201796429.jpg",0,1,28,76,1,106,3.72641509433962,0.488594073759443,76.8705357142857
"8203037764.jpg",0,3,47,48,5,103,3.53398058252427,0.638864402756533,67.75
"8203914551.jpg",0,4,26,71,6,107,3.73831775700935,0.619440535744331,78.7196261682243
"8206370859.jpg",0,1,21,71,6,99,3.82828282828283,0.535293244836351,77.9747706422018
"8207139364.jpg",0,31,62,9,0,102,2.7843137254902,0.590811674948363,46.1857798165138
"8207322738.jpg",0,7,63,28,1,99,3.23232323232323,0.586032715327688,60.4151376146789
"8207527983.jpg",0,3,68,28,0,99,3.25252525252525,0.501903201160737,59.7523364485981
"8208615482.jpg",0,0,36,61,3,100,3.67,0.532859638121892,71.6597222222222
"8208757707.jpg",0,42,63,6,0,111,2.67567567567568,0.574648701574388,45.5926724137931
"8209638994.jpg",0,3,57,61,0,121,3.47933884297521,0.549229362436117,69.26875
"8209647019.jpg",0,0,27,71,7,105,3.80952380952381,0.538788493096354,75.1052631578947
"8210031777.jpg",0,2,54,49,0,105,3.44761904761905,0.536745040121693,65.1747787610619
"8210857374.jpg",0,1,54,50,0,105,3.46666666666667,0.520108469949126,67.3928571428571
"8210890973.jpg",0,1,28,78,4,111,3.76576576576577,0.52144824470725,73.031512605042
"8211686846.jpg",1,16,77,11,0,105,2.93333333333333,0.541839223007843,52.3922018348624
"8212033390.jpg",0,0,40,62,0,102,3.6078431372549,0.490642390492787,70.0581896551724
"8212081020.jpg",0,28,73,3,0,104,2.75961538461538,0.492569886770648,47.2
"8212301132.jpg",0,13,75,12,1,101,3.00990099009901,0.538424544480478,54.8214285714286
"8213284057.jpg",1,23,54,29,0,107,3.03738317757009,0.725872716697915,58.1029411764706
"8213296844.jpg",0,31,73,5,0,109,2.76146788990826,0.525270346068951,48.3411214953271
"8214901795.jpg",0,3,54,47,0,104,3.42307692307692,0.552000909178717,67.3891509433962
"8215066958.jpg",0,3,65,35,0,103,3.31067961165049,0.524481559398295,62.9115044247788
"8215413789.jpg",0,3,66,38,0,107,3.32710280373832,0.528002661059965,65.4285714285714
"8216118608.jpg",0,0,52,54,0,106,3.50943396226415,0.502285879874493,68.8491379310345
"8216243918.jpg",1,14,100,21,0,136,3.03676470588235,0.536215659147948,56.2160714285714
"8216954885.jpg",0,0,27,81,3,111,3.78378378378378,0.474924020821042,76.2987288135593
"8217034676.jpg",53,45,5,0,0,103,1.53398058252427,0.591036543453699,11.95
"8218123958.jpg",10,84,14,0,0,108,2.03703703703704,0.472138224769331,27.4279661016949
"82183009.jpg",6,60,36,3,0,105,2.34285714285714,0.632889761766969,36.13125
"8218739759.jpg",0,4,67,72,2,145,3.49655172413793,0.578841490621023,71.0684931506849
"8218987987.jpg",0,1,12,72,19,104,4.04807692307692,0.58092339772589,84.9009433962264
"8219032452.jpg",6,50,46,4,0,106,2.45283018867925,0.663785327772224,40.7132352941176
"8219528225.jpg",0,14,74,12,0,100,2.98,0.51207638319124,53.575
"8220742117.jpg",32,60,8,1,0,101,1.78217821782178,0.626162285610362,20.125
"8221139072.jpg",0,0,42,65,2,109,3.63302752293578,0.521048630322929,72.6410256410256
"8222142608.jpg",9,80,15,1,0,105,2.07619047619048,0.513195833352107,26.6826086956522
"8222741744.jpg",1,18,70,22,0,111,3.01801801801802,0.632196488184172,54.2631578947368
"8223457724.jpg",4,67,36,2,0,109,2.3302752293578,0.578232393873932,35.3172268907563
"8225184235.jpg",3,48,50,3,0,104,2.50961538461538,0.607320908240659,40.3402777777778
"8225506418.jpg",0,1,29,68,7,105,3.77142857142857,0.576079970028582,73.4322033898305
"8226831484.jpg",1,14,70,28,0,113,3.10619469026549,0.631930599975852,54.5538793103448
"8228733135.jpg",0,10,65,29,0,104,3.18269230769231,0.587316144781357,59.9181415929204
"8228800442.jpg",0,1,42,60,3,106,3.61320754716981,0.561812622838427,70.7234513274336
"8228841274.jpg",0,5,68,36,0,109,3.28440366972477,0.545889405419606,61.84375
"8229120528.jpg",0,29,94,5,0,128,2.8125,0.481957948961244,48.4375
"8229585759.jpg",0,22,50,34,2,108,3.14814814814815,0.758932043733749,55.93125
"8229993789.jpg",0,5,63,38,0,106,3.31132075471698,0.558283211063718,63.8040540540541
"8230351643.jpg",12,71,21,1,0,105,2.1047619047619,0.587101903155359,29.8341584158416
"8230377264.jpg",3,68,58,1,0,130,2.43846153846154,0.556899586704851,38.742125984252
"8230394579.jpg",0,4,57,45,3,109,3.43119266055046,0.614138548686427,66.7053571428571
"8230396549.jpg",1,20,65,14,1,101,2.94059405940594,0.645318249830544,51.475
"8230450365.jpg",0,9,65,23,0,97,3.14432989690722,0.55882485929645,59.2948113207547
"8230728519.jpg",0,1,49,54,1,105,3.52380952380952,0.538788493096354,69.8263888888889
"8231125615.jpg",0,8,56,40,2,106,3.33962264150943,0.64567118939582,61.9504310344828
"8231492407.jpg",0,1,61,44,0,106,3.40566037735849,0.512292734149835,66.4107142857143
"8232299487.jpg",1,20,68,11,0,100,2.89,0.584220105194208,48.7477876106195
"8232391054.jpg",0,5,74,25,1,105,3.20952380952381,0.531602043450486,59.754347826087
"8232440995.jpg",1,3,41,52,3,100,3.53,0.65835730681321,69.9518348623853
"8232481457.jpg",2,35,66,3,0,106,2.66037735849057,0.567144769505739,45.2700892857143
"8233745351.jpg",0,3,53,76,0,132,3.5530303030303,0.543025085377762,71.3959854014599
"8234020680.jpg",4,78,54,1,0,137,2.37956204379562,0.557454652090167,37.6131386861314
"8236704145.jpg",0,4,57,75,3,139,3.55395683453237,0.591885489690235,72.679347826087
"8236758432.jpg",0,4,38,68,3,113,3.61946902654867,0.602355259300589,70.9875
"823805862.jpg",5,75,27,0,0,107,2.20560747663551,0.509130182355242,32.1974789915966
"8238462203.jpg",0,0,21,67,20,108,3.99074074074074,0.618943482848146,79.4096638655462
"8239827069.jpg",0,15,66,26,0,107,3.10280373831776,0.613289605621399,58.2
"8240021404.jpg",2,11,64,32,1,110,3.17272727272727,0.688824166443729,58.9690265486726
"8240214052.jpg",7,54,32,7,0,100,2.39,0.723278171336114,37.4696261682243
"8240220210.jpg",1,41,66,5,0,113,2.66371681415929,0.576482862293695,45.2310924369748
"8241257694.jpg",0,2,48,52,0,102,3.49019607843137,0.540353716921064,69.6971153846154
"82421401.jpg",31,65,7,1,0,104,1.78846153846154,0.602149497985196,21.55625
"8242266673.jpg",0,1,35,60,3,99,3.65656565656566,0.556256000410033,70.8694690265487
"8242599767.jpg",0,1,43,56,1,101,3.56435643564356,0.536951423951151,72.0089285714286
"8242811234.jpg",0,3,56,41,0,100,3.38,0.546430104025994,66.394495412844
"8242906564.jpg",33,58,13,1,0,105,1.82857142857143,0.671638966334519,22.6460396039604
"8244017611.jpg",0,8,61,35,0,104,3.25961538461538,0.591118608959406,62.2196261682243
"8244040268.jpg",0,0,36,58,4,98,3.6734693877551,0.551950808432706,73.6458333333333
"8245350767.jpg",0,0,29,69,2,100,3.73,0.489382212074519,74.2476635514019
"8246007228.jpg",0,13,79,8,0,100,2.95,0.457816513022367,51.4252336448598
"8246184591.jpg",1,31,92,12,0,136,2.84558823529412,0.56932287878234,50.15625
"8246479044.jpg",0,1,68,37,1,107,3.35514018691589,0.518567265129718,63.9152173913043
"8246841627.jpg",0,0,13,71,16,100,4.03,0.540388935878782,82.2889908256881
"8247215463.jpg",0,2,37,59,3,101,3.62376237623762,0.580542593588358,70.5467289719626
"8247844062.jpg",1,4,55,40,3,103,3.38834951456311,0.660258560594255,66.688679245283
"8248519358.jpg",0,1,27,73,3,104,3.75,0.51671103264991,73.8026315789474
"8248564902.jpg",0,1,39,65,2,107,3.63551401869159,0.538910910208028,74.0921052631579
"8249630967.jpg",0,6,76,25,0,107,3.17757009345794,0.510513690836126,60.283185840708
"8250498441.jpg",1,4,86,31,0,122,3.20491803278689,0.529127218219362,60.8125
"8251327289.jpg",0,31,64,14,1,110,2.86363636363636,0.656335010777253,49.9260869565217
"8252742940.jpg",0,2,14,64,28,108,4.09259259259259,0.677226849954842,83.5
"8253280616.jpg",0,7,66,26,0,99,3.19191919191919,0.54728956773763,61.7570093457944
"8253601805.jpg",0,2,56,44,2,104,3.44230769230769,0.571608581483598,66.4602803738318
"8256049516.jpg",0,5,57,40,0,102,3.34313725490196,0.571520432475467,63.1084905660377
"8256076417.jpg",0,4,90,18,0,112,3.125,0.427121098088625,57.8411016949153
"8256731117.jpg",0,26,71,10,0,107,2.85046728971963,0.563073411175464,48.1118421052632
"8256977391.jpg",0,1,51,53,3,108,3.53703703703704,0.570717304456499,69.2434210526316
"8257636356.jpg",0,0,41,56,1,98,3.59183673469388,0.514465686068376,71.9345794392523
"8257779790.jpg",23,76,7,1,0,107,1.86915887850467,0.550884574245936,22.9533898305085
"8258234240.jpg",0,1,39,69,3,112,3.66071428571429,0.546134185216919,73.0641025641026
"8259404043.jpg",0,1,27,73,0,101,3.71287128712871,0.476164544319846,74.65
"8259557757.jpg",0,4,57,33,0,94,3.30851063829787,0.549224198588989,63.3509615384615
"8260840073.jpg",2,20,76,9,0,107,2.85981308411215,0.573775942905748,49.5294117647059
"8261560586.jpg",0,3,46,52,0,101,3.48514851485149,0.558817705269592,65.466814159292
"8262387641.jpg",0,2,50,55,1,108,3.50925925925926,0.555269916184919,70.4059633027523
"8262794558.jpg",0,34,59,10,0,103,2.76699029126214,0.613634040124025,44.5334821428571
"8262966434.jpg",0,3,74,29,1,107,3.26168224299065,0.520095212584592,63.1696428571429
"8263016549.jpg",0,15,77,9,2,103,2.98058252427184,0.559772056624729,54.5471698113208
"8263420706.jpg",2,28,66,10,0,106,2.79245283018868,0.628179245455057,47.0741525423729
"826373.jpg",0,8,23,48,28,107,3.89719626168224,0.878834771420425,77.7457983193277
"8266041849.jpg",0,2,42,55,4,103,3.59223300970874,0.601255112144644,68.1785714285714
"8266134524.jpg",1,33,63,7,0,104,2.73076923076923,0.594975225571673,46.6129807692308
"8266648992.jpg",0,0,35,65,4,104,3.70192307692308,0.537520515613129,73.3
"8267105534.jpg",0,0,24,74,12,110,3.89090909090909,0.564149998686089,78.61875
"8267153015.jpg",0,0,36,68,1,105,3.66666666666667,0.493548116792825,75.5420353982301
"8267201129.jpg",0,1,42,60,9,112,3.6875,0.630047188279941,71.8782608695652
"8267353806.jpg",0,2,52,49,3,106,3.5,0.589592272353571,70.7566964285714
"8267786798.jpg",0,28,71,10,0,109,2.8348623853211,0.569498828859231,51.4407894736842
"8268523027.jpg",3,38,56,9,0,106,2.66981132075472,0.672191839301104,42.9866071428571
"8268756631.jpg",0,0,36,72,0,108,3.66666666666667,0.473602222778315,72.1302521008403
"8268859988.jpg",2,44,56,2,0,104,2.55769230769231,0.571608581483598,41.604347826087
"8269777387.jpg",0,15,67,12,1,95,2.98947368421053,0.574173538191797,54.6642857142857
"8269784088.jpg",4,32,63,14,0,113,2.76991150442478,0.707218514896842,45.7652173913043
"8270648540.jpg",0,4,63,34,1,102,3.31372549019608,0.562533029294091,60.85
"8270671503.jpg",2,14,69,24,0,109,3.05504587155963,0.650282878407844,55.1449579831933
"827067298.jpg",0,0,48,58,1,107,3.5607476635514,0.51720530016433,69.7013274336283
"8270913623.jpg",1,4,58,41,0,104,3.33653846153846,0.601140936628686,62.425
"8272075374.jpg",1,9,55,40,0,105,3.27619047619048,0.657723903017621,62.9906542056075
"8272706512.jpg",0,7,67,35,1,110,3.27272727272727,0.589029537881659,59.09375
"8273944978.jpg",0,18,73,8,0,99,2.8989898989899,0.504974226356835,51.7452830188679
"8273957786.jpg",0,40,58,7,0,105,2.68571428571429,0.593462553323967,44.7544642857143
"8274584258.jpg",0,1,19,75,10,105,3.8952380952381,0.553377905438143,76.1418918918919
"8274829582.jpg",0,0,6,99,8,113,4.01769911504425,0.353106137548202,80.0448717948718
"8275793121.jpg",0,22,44,34,3,103,3.1747572815534,0.797387701430451,59.5981308411215
"8278414113.jpg",0,15,105,25,0,145,3.06896551724138,0.522483019577791,58.31
"8279922752.jpg",0,0,32,64,6,102,3.74509803921569,0.557332304127295,73.975
"8281818195.jpg",7,63,49,2,0,121,2.3801652892562,0.622577951573234,36.95625
"8282376526.jpg",0,5,74,26,0,105,3.2,0.50763402928912,60.3394495412844
"82824130.jpg",20,58,24,3,0,105,2.0952380952381,0.727532837268552,29.4625
"8282451903.jpg",0,0,29,68,3,100,3.74,0.504925236990086,75.1743119266055
"8282948203.jpg",1,18,96,9,0,124,2.91129032258065,0.49406389722356,52.75
"8283257984.jpg",5,52,45,3,0,105,2.43809523809524,0.634335047416547,37.1565217391304
"8283451606.jpg",0,4,49,56,1,110,3.49090909090909,0.586475314409746,65.4875
"8283511236.jpg",0,0,19,78,12,109,3.93577981651376,0.531859584605752,80.796218487395
"8284022272.jpg",0,1,46,64,1,112,3.58035714285714,0.530822799315218,70.6271551724138
"8285094496.jpg",0,7,64,35,1,107,3.2803738317757,0.595492384238558,61.0378151260504
"8286418266.jpg",0,0,34,72,1,107,3.69158878504673,0.483915144465277,73.1138392857143
"8287040167.jpg",5,34,54,10,1,104,2.69230769230769,0.751398993941031,45.0743243243243
"8287545136.jpg",1,40,56,7,0,104,2.66346153846154,0.617080141812204,43.6
"8288312901.jpg",0,2,38,61,3,104,3.625,0.577700496864656,71.7763157894737
"8288373596.jpg",0,0,15,80,7,102,3.92156862745098,0.460010213184165,83.6617647058823
"8289927707.jpg",0,3,58,47,0,108,3.40740740740741,0.547501325685026,66.1081081081081
"8291626660.jpg",0,4,52,56,1,113,3.47787610619469,0.583972619415979,65.3220338983051
"8292084929.jpg",0,0,39,64,3,106,3.66037735849057,0.532501597633735,71.5444915254237
"8292596709.jpg",4,23,59,19,0,105,2.88571428571429,0.737906155622444,49.4331896551724
"8292826193.jpg",0,4,82,17,0,103,3.12621359223301,0.435656179655773,57.3378378378378
"8293206684.jpg",0,5,46,45,4,100,3.48,0.658740763836119,66.1674311926605
"8293797976.jpg",0,8,72,19,0,99,3.11111111111111,0.512872838774715,58.2740384615385
"8296218747.jpg",1,14,88,25,0,128,3.0703125,0.577581077923094,57.25
"8297827964.jpg",0,6,64,32,1,103,3.27184466019417,0.58063816746346,62.2857142857143
"8297923368.jpg",1,2,55,69,0,127,3.51181102362205,0.575507253581685,70.8976377952756
"8299135149.jpg",0,8,47,46,7,108,3.48148148148148,0.729632880180694,65.4875
"8299281180.jpg",0,1,30,72,4,107,3.73831775700935,0.537928391778789,75.4690265486726
"8300309247.jpg",2,59,41,9,0,111,2.51351351351351,0.672375231614351,41.6760869565217
"8301114122.jpg",0,26,102,12,0,140,2.9,0.513136777592472,53.8673469387755
"8301271447.jpg",0,2,63,40,1,106,3.37735849056604,0.542530757323038,63.5263157894737
"8302396098.jpg",0,3,40,60,1,104,3.56730769230769,0.57054603512134,69.6052631578947
"8302682948.jpg",0,2,43,63,4,112,3.61607142857143,0.588868753854719,70.64375
"8303486295.jpg",0,2,14,78,13,107,3.95327102803738,0.572699294966035,77.2076271186441
"8303662528.jpg",0,5,56,43,1,105,3.38095238095238,0.594541717190521,65.6004464285714
"8303933730.jpg",1,17,51,40,1,110,3.20909090909091,0.743108454497696,57.0861344537815
"8303968382.jpg",0,1,69,32,0,102,3.30392156862745,0.48316644706539,64.7083333333333
"8304043296.jpg",0,2,27,73,10,112,3.8125,0.608220710295557,77.224358974359
"8304558173.jpg",0,0,12,84,15,111,4.02702702702703,0.494689240551525,79.8256302521008
"8304722901.jpg",0,3,61,37,1,102,3.35294117647059,0.556635202786152,63.7916666666667
"8305212885.jpg",2,36,67,3,0,108,2.65740740740741,0.566379500873785,44.5963302752294
"8305612260.jpg",0,6,75,24,0,105,3.17142857142857,0.508715253153676,60.3066037735849
"8305620668.jpg",10,70,22,2,0,104,2.15384615384615,0.603697840726373,30.6116071428571
"8305669061.jpg",0,1,34,64,3,102,3.67647058823529,0.547935182729598,72.9714285714286
"8306155022.jpg",0,0,13,84,13,110,4,0.488397491897474,77.65625
"8306749332.jpg",0,2,33,69,3,107,3.68224299065421,0.559617976856677,72.5245535714286
"8306770184.jpg",0,2,53,43,1,99,3.43434343434343,0.556256000410033,65.3808411214953
"8307817608.jpg",19,50,34,3,0,106,2.19811320754717,0.761199696228385,33.5580357142857
"8308200442.jpg",0,2,50,53,0,105,3.48571428571429,0.53912831557927,67.2844827586207
"8308350290.jpg",0,0,61,43,0,104,3.41346153846154,0.494838934727131,63.5565217391304
"8308811931.jpg",0,37,67,2,0,106,2.66981132075472,0.511239355240586,45.2570093457944
"8309215514.jpg",26,60,15,0,0,101,1.89108910891089,0.630888105752675,23.8042452830189
"8310254529.jpg",0,2,30,75,2,109,3.70642201834862,0.532338521744318,71.19375
"8310618188.jpg",0,8,72,28,0,108,3.18518518518519,0.54939470767855,60.4594594594595
"8310619532.jpg",0,10,65,25,2,102,3.18627450980392,0.625060664887306,61.6703539823009
"8311563943.jpg",0,2,42,63,2,109,3.59633027522936,0.563048350911192,70.7905405405405
"8314358374.jpg",0,19,76,7,0,102,2.88235294117647,0.493404371889006,48.9862385321101
"8314966745.jpg",8,73,19,1,0,101,2.12871287128713,0.541541620498991,30.4225663716814
"8316898244.jpg",0,3,41,65,1,110,3.58181818181818,0.564741041277403,68.30625
"8317893385.jpg",0,0,27,76,5,108,3.7962962962963,0.5071315569563,75.18125
"8318268016.jpg",0,1,58,47,2,108,3.46296296296296,0.554099858167321,65.466814159292
"8319445883.jpg",0,4,36,65,5,110,3.64545454545455,0.629348922873686,72.3834745762712
"8320017511.jpg",0,0,23,73,10,106,3.87735849056604,0.546901752971605,77.0280172413793
"8320098796.jpg",0,16,76,17,0,109,3.00917431192661,0.552693955297959,55.2836134453782
"8320423007.jpg",6,49,39,1,0,95,2.36842105263158,0.619756842828639,36.1029411764706
"8320489600.jpg",0,11,80,40,1,132,3.23484848484848,0.603549911732149,62.9666666666667
"8320909145.jpg",0,9,58,34,1,102,3.26470588235294,0.628158877995575,60.4908256880734
"8321029602.jpg",0,5,71,28,0,104,3.22115384615385,0.520580907214179,61.2027027027027
"8321126258.jpg",0,20,69,23,1,113,3.04424778761062,0.646272008895379,55.3065217391304
"8321155777.jpg",0,12,81,13,0,106,3.00943396226415,0.487857961742534,53.2731092436975
"8321480608.jpg",1,25,76,13,0,115,2.87826086956522,0.594533962952917,51.478813559322
"8321682395.jpg",0,7,56,36,0,99,3.29292929292929,0.593373703573349,63.9724770642202
"8321981131.jpg",1,12,58,31,2,104,3.20192307692308,0.702005555427188,59.6261061946903
"8322388606.jpg",0,16,73,23,0,112,3.0625,0.589414887757265,55.4358974358974
"8322413607.jpg",0,2,31,75,4,112,3.72321428571429,0.556854444704245,72.9230769230769
"8322643928.jpg",12,68,22,1,0,103,2.11650485436893,0.599034695282898,29.9115044247788
"8322994549.jpg",0,10,75,16,0,101,3.05940594059406,0.50639475072749,54.3600917431193
"8323120996.jpg",0,2,53,49,1,105,3.46666666666667,0.55585462035892,67.3618421052632
"8325420861.jpg",0,3,55,50,0,108,3.43518518518519,0.551516992869059,68.5894495412844
"8325732255.jpg",0,1,43,56,6,106,3.63207547169811,0.60671593255922,71.3676470588235
"8329144701.jpg",0,20,51,28,2,101,3.11881188118812,0.738743916562042,55.5711009174312
"8329938246.jpg",0,0,54,48,2,104,3.5,0.539687072220866,66.3310810810811
"8329958275.jpg",0,0,22,75,9,106,3.87735849056604,0.529201198369576,76.625
"8329986781.jpg",0,2,64,35,3,104,3.375,0.577700496864656,63.8974358974359
"8330723470.jpg",0,0,43,61,4,108,3.63888888888889,0.554646192409083,71.7542372881356
"8330807035.jpg",6,61,38,2,0,107,2.33644859813084,0.613433350989744,34.9705882352941
"8331586612.jpg",0,7,54,48,0,109,3.37614678899083,0.605361704329154,62.05
"8331607175.jpg",0,1,37,71,1,110,3.65454545454545,0.514672134637003,70.7754237288136
"8331758509.jpg",0,6,77,65,3,151,3.43046357615894,0.605639428206084,68.3026315789474
"8332215391.jpg",0,0,31,70,2,103,3.71844660194175,0.493436841184705,75.6355140186916
"8333161105.jpg",0,0,42,60,3,105,3.62857142857143,0.541670188774122,70.7964601769911
"8333619480.jpg",2,24,58,20,0,104,2.92307692307692,0.706314208419796,52.4369565217391
"8333683532.jpg",0,0,42,65,0,107,3.60747663551402,0.490610119691074,70.3717391304348
"8333814090.jpg",2,32,56,14,0,104,2.78846153846154,0.692162460909833,46.2351694915254
"8333982072.jpg",1,23,75,9,0,108,2.85185185185185,0.560620730989526,50.2027027027027
"8334203333.jpg",0,34,70,8,0,112,2.76785714285714,0.569212239856606,48.0320512820513
"8334314471.jpg",1,11,73,16,0,101,3.02970297029703,0.555975638756852,55.9214285714286
"8336846212.jpg",0,1,58,48,0,107,3.4392523364486,0.51720530016433,68.375
"8337813363.jpg",0,2,40,68,1,111,3.61261261261261,0.5422373041587,68.7331932773109
"8338842182.jpg",0,3,58,48,0,109,3.41284403669725,0.547908636177939,67.2920353982301
"8339157161.jpg",0,5,52,43,4,104,3.44230769230769,0.651017472166813,65.9778761061947
"8339210713.jpg",0,11,42,56,1,110,3.42727272727273,0.683475883068022,63.7
"8339615907.jpg",3,44,51,6,0,104,2.57692307692308,0.649006824388667,41.7873831775701
"8341991106.jpg",0,0,25,74,6,105,3.81904761904762,0.514799295860353,75.6659663865546
"8342894979.jpg",0,27,75,4,0,106,2.78301886792453,0.497703621524604,49.0398230088496
"8343118972.jpg",0,1,25,67,12,105,3.85714285714286,0.611249845502127,74.3581081081081
"8343579007.jpg",0,6,64,37,0,107,3.28971962616822,0.566507769341593,61.404347826087
"8345197886.jpg",0,4,64,36,1,105,3.32380952380952,0.563219421909541,64.1776315789474
"8345496530.jpg",0,2,31,64,9,106,3.75471698113208,0.629607901486041,72.8716216216216
"8346047313.jpg",0,0,53,58,0,111,3.52252252252252,0.501757762033485,70.2715517241379
"8346245093.jpg",0,31,64,8,0,103,2.77669902912621,0.576195072410062,49.7361111111111
"8346970641.jpg",0,19,68,11,0,98,2.91836734693878,0.550041598947089,51.6891891891892
"8347284037.jpg",0,8,75,29,1,113,3.20353982300885,0.569449797664976,57.9809322033898
"8348001072.jpg",0,13,57,33,0,103,3.19417475728155,0.642578330117777,61.5264423076923
"8348113359.jpg",21,71,11,0,0,103,1.90291262135922,0.551549743668783,22.3389423076923
"8349327834.jpg",3,37,87,6,0,133,2.7218045112782,0.581968751877034,47.25
"8350531104.jpg",0,4,48,52,1,105,3.47619047619048,0.589902829273897,70.6
"8350532456.jpg",0,3,44,60,3,110,3.57272727272727,0.597534550981236,66.8613445378151
"8350811947.jpg",1,2,24,64,20,111,3.9009009009009,0.737994271411062,80.5066371681416
"8351013561.jpg",0,19,79,12,0,110,2.93636363636364,0.529449648952236,52.6858974358974
"8351568109.jpg",0,3,75,25,1,104,3.23076923076923,0.506861066174239,61.404347826087
"8351745980.jpg",0,4,73,20,0,97,3.16494845360825,0.471708163025924,61.5257009345794
"8351819316.jpg",0,1,50,47,6,104,3.55769230769231,0.620474655090888,67.426724137931
"8351907965.jpg",0,1,30,64,4,99,3.71717171717172,0.55402799679505,77.0745192307692
"8352296647.jpg",59,47,1,0,0,107,1.45794392523364,0.519077080686367,11.8844537815126
"8352587213.jpg",0,8,64,34,1,107,3.26168224299065,0.604018752022585,63.8040540540541
"8352959449.jpg",0,3,84,20,0,107,3.1588785046729,0.437607834910552,59.0966386554622
"8353048335.jpg",0,4,68,33,2,107,3.30841121495327,0.573160963154644,62.2163865546218
"8353276755.jpg",0,2,43,61,1,107,3.57009345794393,0.551364508625548,71.125
"8353492181.jpg",9,78,22,0,0,109,2.11926605504587,0.52218860368506,29.9449152542373
"8353646596.jpg",0,1,56,46,1,104,3.45192307692308,0.537520515613129,67.2334905660377
"8354332729.jpg",0,19,77,10,0,106,2.91509433962264,0.518568074757916,53.1052631578947
"8354479425.jpg",4,26,61,10,0,101,2.76237623762376,0.680419206834803,46.6351351351351
"8354529751.jpg",0,0,40,62,1,103,3.62135922330097,0.507135454975797,69.5384615384615
"8354584594.jpg",0,5,62,38,3,108,3.36111111111111,0.618383985800151,63.9336283185841
"8354855845.jpg",0,3,41,57,1,102,3.54901960784314,0.573808726891872,67.454128440367
"8356375190.jpg",0,1,30,90,3,124,3.76612903225806,0.495653809288772,78.6311475409836
"8356442304.jpg",0,3,54,44,1,102,3.42156862745098,0.570500466583819,63.5183486238532
"8357037213.jpg",0,0,44,55,3,102,3.59803921568627,0.549703861256738,69.1949541284404
"8357323256.jpg",0,0,74,35,1,110,3.33636363636364,0.493578446722732,62.8384955752212
"8357910475.jpg",0,1,29,71,6,107,3.76635514018692,0.559302787883853,73.031512605042
"8357913829.jpg",2,51,53,3,0,109,2.52293577981651,0.586835996321222,41.49375
"8358094625.jpg",0,0,19,83,2,104,3.83653846153846,0.42060005500872,74.5810810810811
"8358374077.jpg",0,2,50,49,1,102,3.48039215686275,0.55811550238036,67
"8358381896.jpg",0,5,75,21,0,101,3.15841584158416,0.484410430674789,57.85
"8358982372.jpg",0,2,52,54,0,108,3.48148148148148,0.537934462211864,69.3130841121495
"8360589310.jpg",0,1,61,44,0,106,3.40566037735849,0.512292734149835,64.9375
"8360975985.jpg",3,57,47,2,0,109,2.44036697247706,0.584224599450234,39.1302521008403
"8362126677.jpg",0,3,61,42,1,107,3.38317757009346,0.560405173724722,64.9932432432432
"8362183655.jpg",0,4,42,56,0,102,3.50980392156863,0.575835132469745,71.8714285714286
"8362338513.jpg",0,29,78,5,0,112,2.78571428571429,0.50987671056272,48.8782051282051
"8362730833.jpg",0,5,90,59,0,154,3.35064935064935,0.542717292195432,66.8935483870968
"8364603294.jpg",1,0,19,73,14,107,3.92523364485981,0.624966936173566,80.0565217391304
"8365545870.jpg",0,3,43,77,1,124,3.61290322580645,0.551563592945256,74.1680327868852
"8373140830.jpg",0,5,68,36,0,109,3.28440366972477,0.545889405419606,64.0328947368421
"8373449722.jpg",0,4,72,31,0,107,3.25233644859813,0.515668789853311,61.1764705882353
"8373530988.jpg",28,61,16,0,0,105,1.88571428571429,0.640226608233452,23.7279411764706
"8374149596.jpg",17,71,13,0,0,101,1.96039603960396,0.546274511197583,24.2079439252336
"8374735482.jpg",0,3,54,46,0,103,3.41747572815534,0.551722291692297,64.3243243243243
"8375094776.jpg",0,1,40,60,3,104,3.625,0.560642834922123,69.2297297297297
"8375633718.jpg",2,41,75,10,0,128,2.7265625,0.623867083436268,47.4226190476191
"8375881781.jpg",0,22,60,27,0,109,3.04587155963303,0.671997038972167,53.6625
"8376951271.jpg",0,2,33,68,8,111,3.73873873873874,0.613658354930964,71.9915966386555
"8377051997.jpg",2,32,65,5,0,104,2.70192307692308,0.589220444222254,45.0491071428571
"8377086521.jpg",0,4,44,50,6,104,3.55769230769231,0.665763640336886,67.0743243243243
"8377336301.jpg",0,1,44,55,4,104,3.59615384615385,0.583248864754567,74.1805555555556
"8377341554.jpg",0,2,29,64,8,103,3.75728155339806,0.617807943656135,77.6283783783784
"8377908446.jpg",0,1,31,68,6,106,3.74528301886792,0.57006801189427,74.4809322033898
"8379165496.jpg",0,17,75,13,0,105,2.96190476190476,0.535720390685605,55.1725663716814
"8379707865.jpg",0,2,37,67,2,108,3.63888888888889,0.554646192409083,71.0903361344538
"8380369304.jpg",6,49,44,1,0,100,2.4,0.619546918189723,36.925
"8380814455.jpg",0,23,64,19,0,106,2.9622641509434,0.631318021163235,55.1802884615385
"8381849363.jpg",0,1,42,62,4,109,3.63302752293578,0.571880433934363,72.8525641025641
"8382215237.jpg",0,0,14,85,9,108,3.9537037037037,0.461291548477137,77.2775423728814
"8385356062.jpg",0,5,55,40,2,102,3.38235294117647,0.614093836914049,63.838785046729
"8385411442.jpg",0,4,55,58,1,118,3.47457627118644,0.580478205555074,68.974358974359
"8385499383.jpg",0,2,50,53,0,105,3.48571428571429,0.53912831557927,69.5631067961165
"8385552455.jpg",0,2,14,78,7,101,3.89108910891089,0.527275831022244,77.0915178571429
"8386378049.jpg",0,3,55,45,0,103,3.40776699029126,0.550167411310688,66.6283783783784
"8387369354.jpg",0,1,23,76,7,107,3.83177570093458,0.540544472336732,75.8739495798319
"8387487827.jpg",0,6,57,51,0,114,3.39473684210526,0.589261140070359,65.0588235294118
"8388736592.jpg",0,22,79,7,0,108,2.86111111111111,0.501555213709073,51.5023364485981
"8390342452.jpg",0,14,68,17,0,99,3.03030303030303,0.561603852219212,57.2281553398058
"8390448317.jpg",0,2,49,50,1,102,3.49019607843137,0.55837632434446,69.3362831858407
"8391472456.jpg",0,1,56,49,3,109,3.4954128440367,0.571285963468144,66.5619469026549
"8391500206.jpg",0,37,61,6,0,104,2.70192307692308,0.572506118885479,46.2635135135135
"8391854291.jpg",0,24,76,5,0,105,2.81904761904762,0.495769649925795,49.0775862068966
"8392357033.jpg",0,5,45,53,3,106,3.50943396226415,0.63613839492853,66.5805084745763
"8392513010.jpg",39,58,10,1,0,108,1.75,0.657451892273652,19.1061946902655
"8393106944.jpg",29,62,9,1,0,101,1.82178217821782,0.622832876524038,22.2257281553398
"8393175128.jpg",0,2,44,58,1,105,3.55238095238095,0.554369919210997,68.9324324324324
"83935018.jpg",1,39,57,9,0,106,2.69811320754717,0.635007481332078,44.65625
"8395711832.jpg",5,50,54,2,0,111,2.47747747747748,0.615657030361531,38.3012820512821
"8395743743.jpg",0,4,38,53,13,108,3.69444444444444,0.729336317602829,71.0903361344538
"8396870268.jpg",0,31,67,12,1,111,2.84684684684685,0.635298043129053,49.9406779661017
"8397014400.jpg",0,14,75,15,0,104,3.00961538461538,0.530528081075412,52.989224137931
"8397266843.jpg",0,2,40,56,1,99,3.56565656565657,0.556256000410033,72.9495192307692
"8397860756.jpg",0,12,79,18,0,109,3.05504587155963,0.524137075393682,56.3928571428571
"8397958686.jpg",0,3,69,29,0,101,3.25742574257426,0.503059943675397,60.6004672897196
"8398198583.jpg",0,0,22,71,13,106,3.91509433962264,0.571012876650771,78.2310924369748
"8398239689.jpg",2,9,74,22,0,107,3.08411214953271,0.600652087901185,56.4137168141593
"8398319915.jpg",0,1,48,59,2,110,3.56363636363636,0.550683857210433,70.4551282051282
"8398445064.jpg",0,10,51,41,1,103,3.32038834951456,0.659970175098692,64.1526548672566
"8398548523.jpg",0,9,72,27,0,108,3.16666666666667,0.555347832401704,59.9181415929204
"8399489944.jpg",0,5,76,31,0,112,3.23214285714286,0.519565703206553,60.8653846153846
"8399629946.jpg",0,3,60,45,1,109,3.40366972477064,0.563048350911192,64.9894957983193
"8399674675.jpg",0,1,58,45,0,104,3.42307692307692,0.515625884026218,65.8950892857143
"8400156034.jpg",0,8,75,25,0,108,3.15740740740741,0.532355671933666,57.375
"8400557154.jpg",0,5,67,33,0,105,3.26666666666667,0.541839223007843,63.3169642857143
"8400786727.jpg",0,1,21,80,0,102,3.77450980392157,0.442917035010996,74.0088495575221
"8401142586.jpg",0,3,63,37,2,105,3.36190476190476,0.573850180189942,63.2306034482759
"8401260771.jpg",0,11,67,23,1,102,3.13725490196078,0.597672311394309,56.8130434782609
"8401416435.jpg",0,0,28,63,11,102,3.83333333333333,0.59840271438293,74.1903669724771
"84018414.jpg",0,9,50,40,3,102,3.36274509803922,0.686348000613413,62.2857142857143
"8402267016.jpg",4,21,60,20,0,105,2.91428571428571,0.735295410470745,50.2027027027027
"8402295544.jpg",0,8,65,27,1,101,3.20792079207921,0.588503724426079,62.5576923076923
"8403125101.jpg",0,3,50,52,0,105,3.46666666666667,0.55585462035892,67
"8403312891.jpg",2,34,64,4,0,104,2.67307692307692,0.581966997568077,43.825
"8403342715.jpg",0,28,67,7,0,102,2.79411764705882,0.551114717247404,48.8655660377358
"8404206319.jpg",0,4,59,46,1,110,3.4,0.577879705586241,62.4625
"8404905802.jpg",1,31,68,10,0,110,2.79090909090909,0.607226429442794,46.5847457627119
"8405074808.jpg",0,5,56,47,1,109,3.40366972477064,0.595029816480527,65.1974789915966
"8405979865.jpg",1,23,95,9,0,128,2.875,0.51741331199832,52.1240157480315
"8406395791.jpg",0,2,50,54,2,108,3.51851851851852,0.571626331798371,69.0442477876106
"8406491085.jpg",0,0,38,68,0,106,3.64150943396226,0.481835364992828,72.625
"8407650196.jpg",0,21,85,33,6,145,3.16551724137931,0.71699404444536,60.7142857142857
"8407751062.jpg",1,9,77,16,0,103,3.04854368932039,0.530974700787572,57.1605504587156
"8410633059.jpg",0,1,64,37,1,103,3.36893203883495,0.52375513029704,65.2321428571429
"8410894233.jpg",2,34,59,10,0,105,2.73333333333333,0.654373844377301,47.9926470588235
"8412239545.jpg",0,0,8,81,19,108,4.10185185185185,0.491798431751438,85.5275423728814
"8412287695.jpg",0,1,49,51,1,102,3.50980392156863,0.540353716921064,65.9868421052632
"8412460969.jpg",6,56,45,2,0,109,2.39449541284404,0.623881942533605,38.3421052631579
"8413383096.jpg",4,29,61,4,0,98,2.66326530612245,0.624976330290277,46.2222222222222
"8413515646.jpg",0,0,10,73,17,100,4.07,0.517472489875334,82.5833333333333
"8416061748.jpg",0,4,38,62,3,107,3.5981308411215,0.612138427495947,72.625
"8417110649.jpg",0,34,60,10,0,104,2.76923076923077,0.611075277500422,48.0176991150442
"8417199212.jpg",0,4,52,48,1,105,3.43809523809524,0.587101903155359,64.2008928571429
"8417650354.jpg",0,4,45,58,0,107,3.50467289719626,0.572545322844697,69.304054054054
"8417733554.jpg",0,4,46,51,3,104,3.50961538461538,0.623102047271884,67.5689655172414
"8418843841.jpg",0,6,66,27,0,99,3.21212121212121,0.539703759874809,57.7278761061947
"8418966442.jpg",0,40,58,7,1,106,2.70754716981132,0.631958122965747,46.5483193277311
"8419228451.jpg",0,0,32,71,1,104,3.70192307692308,0.480287286444829,76.4632352941177
"8419805674.jpg",0,1,16,79,11,107,3.93457943925234,0.536779847310727,81.325
"8420816712.jpg",2,48,58,6,0,114,2.59649122807018,0.620009966314617,42.3922413793103
"8421578109.jpg",0,7,71,34,0,112,3.24107142857143,0.557431944931732,61.4766949152542
"8421980802.jpg",0,6,43,57,4,110,3.53636363636364,0.659124700752914,66.8625
"8423036726.jpg",0,0,37,67,2,106,3.66981132075472,0.511239355240586,72.8029661016949
"8423951722.jpg",0,7,64,30,2,103,3.2621359223301,0.609743839633862,63.5940366972477
"8425720386.jpg",0,15,65,14,0,94,2.98936170212766,0.558313143934069,54.7428571428571
"8427357000.jpg",1,0,37,63,9,110,3.71818181818182,0.651488319817822,70.7125
"8427536839.jpg",0,3,54,37,2,96,3.39583333333333,0.589007491091076,66.1102941176471
"8427827661.jpg",1,12,71,22,0,106,3.07547169811321,0.59678684409646,54.4827586206897
"8428610140.jpg",0,2,51,51,0,104,3.47115384615385,0.538908115251656,68.1
"8428991513.jpg",9,70,26,1,0,106,2.17924528301887,0.582231664109591,31.1551724137931
"8429194888.jpg",1,9,71,28,0,109,3.15596330275229,0.595885769667891,58.896017699115
"8429377035.jpg",0,20,62,22,0,104,3.01923076923077,0.638273904602475,54.2754237288136
"8430005179.jpg",0,0,34,65,0,99,3.65656565656566,0.477271500229107,71.3948598130841
"8430044905.jpg",2,15,69,19,0,105,3,0.635488909302243,53.712389380531
"8430084372.jpg",0,25,68,7,0,100,2.82,0.538985204347068,50.0995145631068
"8430377800.jpg",1,19,64,18,0,102,2.97058823529412,0.636448723218111,53.65
"8430770537.jpg",0,1,32,62,10,105,3.77142857142857,0.624147770612408,74.2543103448276
"8431773301.jpg",0,6,53,47,4,110,3.44545454545455,0.657858126368209,66.9263392857143
"8431868669.jpg",0,2,51,53,2,108,3.50925925925926,0.571853362851923,67.3495762711864
"8432266484.jpg",15,59,30,4,0,108,2.21296296296296,0.724096935808469,33.2039473684211
"8433107122.jpg",0,1,42,58,3,104,3.60576923076923,0.56462495896549,70.5357142857143
"8433138741.jpg",0,1,33,71,2,107,3.69158878504673,0.521449629494023,71.9915966386555
"8434015762.jpg",0,31,65,10,1,107,2.82242990654206,0.626657562173502,49.15
"8434381156.jpg",6,98,36,1,0,141,2.22695035460993,0.526020020344706,31.2689655172414
"8434827647.jpg",0,0,20,85,3,108,3.84259259259259,0.435826361656464,77.5657894736842
"8435700290.jpg",0,1,39,66,1,107,3.62616822429907,0.523474684219319,74.5870535714286
"8435902776.jpg",0,5,41,50,3,99,3.51515151515152,0.644658371220304,70.09375
"8436817796.jpg",0,1,37,61,1,100,3.62,0.527620922996651,71.9197247706422
"8436929518.jpg",0,23,78,5,0,106,2.83018867924528,0.487397327174951,49.2086956521739
"8437453575.jpg",6,30,52,8,1,97,2.6701030927835,0.759956817366071,44.5285714285714
"8437525605.jpg",0,20,45,40,0,105,3.19047619047619,0.735046284456319,59.7523364485981
"8437609150.jpg",0,0,16,81,7,104,3.91346153846154,0.464477510467029,80.0379464285714
"8438194819.jpg",0,0,26,66,7,99,3.80808080808081,0.54728956773763,76.006880733945
"8438205347.jpg",0,0,52,50,2,104,3.51923076923077,0.539341008015854,71.2028301886792
"8438601990.jpg",0,5,57,43,1,106,3.37735849056604,0.592859578470624,66.475
"8438721601.jpg",0,0,22,76,11,109,3.89908256880734,0.54339389792714,77.4021739130435
"8438943296.jpg",1,20,55,28,1,105,3.07619047619048,0.729794993543209,53.6293103448276
"8439178228.jpg",2,32,61,10,0,105,2.75238095238095,0.647197395594628,46.7569444444444
"8439638054.jpg",0,7,46,53,1,107,3.44859813084112,0.632957193399142,67.7857142857143
"8439881076.jpg",0,6,69,32,0,107,3.24299065420561,0.546707494751528,60.8310810810811
"8441623412.jpg",0,2,37,76,1,116,3.6551724137931,0.529206925516846,75.8289473684211
"8442013836.jpg",1,41,82,7,0,131,2.72519083969466,0.569121254006207,46.7843511450382
"8442383096.jpg",2,42,45,11,1,101,2.67326732673267,0.736327520755392,43.15
"8442848364.jpg",0,0,45,62,3,110,3.61818181818182,0.541520424645821,68.4558823529412
"8442858810.jpg",2,20,61,21,0,104,2.97115384615385,0.689121162134474,53.078125
"8443583255.jpg",0,2,32,71,8,113,3.75221238938053,0.605495273240478,72.8108695652174
"8443782912.jpg",0,6,54,45,1,106,3.38679245283019,0.610554076494007,64.9375
"8444194286.jpg",0,14,76,11,0,101,2.97029702970297,0.499108115433008,50.802752293578
"8444203927.jpg",0,5,60,43,0,108,3.35185185185185,0.568894892232083,62.4625
"8444344132.jpg",0,29,63,9,0,101,2.8019801980198,0.583434691807027,48.925
"8444615248.jpg",0,0,46,52,1,99,3.54545454545455,0.520453634013347,72.2063106796116
"8445666777.jpg",0,1,35,71,4,111,3.7027027027027,0.54929036193975,72.0769230769231
"8446141044.jpg",0,2,63,44,1,110,3.4,0.545204279533844,63.3333333333333
"8447352918.jpg",3,37,57,6,0,103,2.64077669902913,0.639460080650747,43.6642857142857
"8448710097.jpg",0,9,65,25,1,100,3.18,0.592546294487706,60.6422018348624
"8449030791.jpg",0,5,63,37,1,106,3.32075471698113,0.578127845662116,63.25
"8449623916.jpg",0,3,32,67,2,104,3.65384615384615,0.5706278397006,70.9
"8450680026.jpg",0,5,57,43,2,107,3.39252336448598,0.610552013542993,61.9661016949153
"8450836581.jpg",0,0,47,54,6,107,3.61682242990654,0.593118713070191,70.5357142857143
"8450870263.jpg",0,10,65,23,0,98,3.13265306122449,0.567827385961847,56.2972972972973
"8451346661.jpg",0,0,18,89,3,110,3.86363636363636,0.417007089180775,76.7881355932203
"8451439208.jpg",0,0,50,52,2,104,3.53846153846154,0.538301480532277,66.9256756756757
"8451928629.jpg",0,0,20,86,4,110,3.85454545454545,0.445906223661714,73.7941176470588
"8452429942.jpg",16,71,16,0,0,103,2,0.560112033611204,25.6736111111111
"8452437121.jpg",0,4,41,54,1,100,3.52,0.594248528085104,68.0023364485981
"8452461056.jpg",0,0,23,71,8,102,3.85294117647059,0.533938455005121,76.6012931034483
"8452514438.jpg",4,48,53,1,0,106,2.4811320754717,0.589287415935903,40.7767857142857
"8452772155.jpg",0,6,33,53,3,95,3.55789473684211,0.663898695708535,71.8058252427184
"8454542185.jpg",0,3,49,53,2,107,3.50467289719626,0.588792044137521,69.75
"8454689689.jpg",0,3,50,53,4,110,3.52727272727273,0.616427870421885,69.7254464285714
"8454945247.jpg",1,28,67,9,1,106,2.82075471698113,0.629393809815986,49.46875
"8455329161.jpg",0,2,17,80,3,102,3.82352941176471,0.495759537405347,79.6129807692308
"8456262039.jpg",0,27,65,13,0,105,2.86666666666667,0.605530070819498,49.1973684210526
"8456415044.jpg",0,2,20,76,5,103,3.81553398058252,0.537743521041616,80.4646226415094
"8456644085.jpg",0,7,72,23,0,102,3.15686274509804,0.521708883566678,58.2873831775701
"8457028188.jpg",0,1,21,86,4,112,3.83035714285714,0.48189552262217,77.8589743589744
"8458155212.jpg",0,0,49,56,1,106,3.54716981132075,0.51882790011439,67.5593220338983
"8458232440.jpg",0,7,64,37,0,108,3.27777777777778,0.577350269189626,62.5405405405405
"8458755761.jpg",0,1,49,55,0,105,3.51428571428571,0.520988072251728,70.3490099009901
"8459688085.jpg",1,35,91,13,0,140,2.82857142857143,0.586942536901053,49.8219178082192
"8459996431.jpg",0,2,51,48,1,102,3.47058823529412,0.55768052803139,68.575
"8460154333.jpg",1,41,48,12,0,102,2.69607843137255,0.686348000613413,44.6720183486239
"8460289501.jpg",0,4,62,34,1,101,3.31683168316832,0.564458910272607,65.0287610619469
"8460376605.jpg",0,0,24,72,7,103,3.83495145631068,0.525750395161586,78.7857142857143
"8460764072.jpg",1,51,49,0,0,101,2.47524752475248,0.521422274283341,38.875
"8461148661.jpg",0,32,63,4,0,99,2.71717171717172,0.535293244836351,47.0183486238532
"8461542458.jpg",2,49,42,5,1,99,2.53535353535354,0.674811104531185,41.4097222222222
"8462442319.jpg",0,1,24,63,17,105,3.91428571428571,0.652130911148003,79.5608108108108
"8463119506.jpg",0,0,30,67,10,107,3.81308411214953,0.584885751164282,74.3411016949153
"8463181410.jpg",0,36,64,7,0,107,2.72897196261682,0.575770090678299,47.1116071428571
"8463190672.jpg",0,2,57,48,0,107,3.42990654205607,0.533980240124661,67.7236842105263
"8463285530.jpg",0,41,104,5,0,150,2.76,0.500737710816309,49.4951923076923
"8464327703.jpg",0,3,65,69,0,137,3.48175182481752,0.543709883997159,69.40625
"8464428247.jpg",23,74,5,0,0,102,1.82352941176471,0.495759537405347,19.179203539823
"8465039467.jpg",1,26,65,9,0,101,2.81188118811881,0.595195283703235,49.3646788990826
"8465276999.jpg",0,2,41,67,0,110,3.59090909090909,0.529764610103801,72.1918103448276
"8465545790.jpg",0,8,69,32,0,109,3.22018348623853,0.566957411770768,62.4509345794393
"8465866576.jpg",0,0,32,71,1,104,3.70192307692308,0.480287286444829,72.2179487179487
"8466537488.jpg",0,1,33,66,1,101,3.66336633663366,0.515310153650639,74.5199115044248
"8466719811.jpg",0,1,47,62,1,111,3.56756756756757,0.532944165958765,72.0064102564103
"8467715346.jpg",0,3,73,61,0,137,3.42335766423358,0.538552358823638,68.65
"8467804997.jpg",0,9,61,33,1,104,3.25,0.619269848798622,61.9782608695652
"8468013032.jpg",1,13,66,23,0,103,3.07766990291262,0.621341376100057,56.3142857142857
"8468299060.jpg",0,8,66,27,0,101,3.18811881188119,0.560586679954647,58.6728971962617
"8468581524.jpg",1,10,57,42,0,110,3.27272727272727,0.662343502846624,61.3783185840708
"8468743988.jpg",0,2,25,73,3,103,3.74757281553398,0.537212241292896,77.9256756756757
"8469388516.jpg",0,11,69,19,4,103,3.15533980582524,0.653156461953887,58.603982300885
"8471068172.jpg",1,7,66,38,1,113,3.27433628318584,0.63030303951211,60.724358974359
"8471534118.jpg",0,14,63,29,0,106,3.14150943396226,0.623945651559997,57.3504464285714
"8471619926.jpg",3,20,76,9,0,108,2.84259259259259,0.598472151883554,49.1716101694915
"8472852630.jpg",1,4,36,60,4,105,3.59047619047619,0.675039003078826,67.8175675675676
"8472898292.jpg",15,69,30,0,0,114,2.13157894736842,0.617060658723285,29.5576923076923
"8473031499.jpg",0,11,58,32,0,101,3.20792079207921,0.621559839165439,56.8175675675676
"8473167636.jpg",0,5,56,42,5,108,3.43518518518519,0.659554482145832,67.0736607142857
"8473442365.jpg",0,1,31,75,4,111,3.73873873873874,0.534478704596811,73.6282051282051
"8473611231.jpg",52,48,2,0,0,102,1.50980392156863,0.540353716921064,13.2593457943925
"8473751363.jpg",0,2,43,54,3,102,3.56862745098039,0.588836811456376,71.575
"8474310923.jpg",0,4,65,38,1,108,3.33333333333333,0.563699396261691,64.6927966101695
"8474312023.jpg",0,2,48,57,2,109,3.54128440366972,0.569797073880386,68.5921052631579
"8474594407.jpg",0,6,58,36,1,101,3.31683168316832,0.598843770432772,62.4080188679245
"8475086246.jpg",0,0,54,52,0,106,3.49056603773585,0.502285879874493,69.4029126213592
"8477555984.jpg",0,4,67,39,0,110,3.31818181818182,0.540672672802991,63.0223214285714
"8481080192.jpg",0,5,56,42,2,105,3.39047619047619,0.612297660381309,63.3413043478261
"8481265200.jpg",0,0,38,65,2,105,3.65714285714286,0.515687954032345,70.3970588235294
"8481450412.jpg",5,52,38,4,0,99,2.41414141414141,0.654811096145075,37.225
"8481724236.jpg",5,51,50,5,0,111,2.4954954954955,0.658840218922945,42.0384615384615
"8482992711.jpg",0,18,70,22,0,110,3.03636363636364,0.604680106910321,56.7923728813559
"8484679828.jpg",0,1,40,64,5,110,3.66363636363636,0.579105173811527,68.925
"8484786490.jpg",0,7,86,57,2,152,3.35526315789474,0.591416469353935,67.4729299363057
"8485122834.jpg",0,1,49,66,5,121,3.6198347107438,0.581036406591811,73.325
"8485208349.jpg",0,17,74,39,2,132,3.1969696969697,0.67041509232809,61.3394160583942
"8485295618.jpg",0,22,72,11,0,105,2.8952380952381,0.553377905438143,50.95
"8485747318.jpg",0,2,40,59,1,102,3.57843137254902,0.552873224323927,72.6009174311927
"8486309874.jpg",0,3,39,64,6,112,3.65178571428571,0.625434212102243,73.1525423728814
"8486814802.jpg",0,2,30,68,3,103,3.69902912621359,0.557215617370319,73.4766355140187
"8486846186.jpg",0,1,31,68,1,101,3.68316831683168,0.508540914171258,75.5555555555556
"8486986414.jpg",0,9,82,36,2,129,3.24031007751938,0.596542037999649,61.6732283464567
"8488083858.jpg",0,4,47,75,1,127,3.5748031496063,0.570709458778464,74.0807086614173
"8488084256.jpg",0,4,58,58,1,121,3.46280991735537,0.577946397659414,68.44375
"8488319324.jpg",0,0,19,81,10,110,3.91818181818182,0.509214509003966,80.9396551724138
"8488394767.jpg",0,1,54,49,1,105,3.47619047619048,0.538788493096354,69.2647058823529
"8488457246.jpg",0,3,69,34,1,107,3.30841121495327,0.539238018529624,65.0287610619469
"8488826556.jpg",0,0,42,61,2,105,3.61904761904762,0.525886657519257,74.1450892857143
"8489199003.jpg",0,0,20,82,2,104,3.82692307692308,0.428188954123246,77.4054054054054
"8489243270.jpg",0,6,76,16,0,98,3.10204081632653,0.465063922407555,57.4633027522936
"8491632656.jpg",3,63,34,1,0,101,2.32673267326733,0.549707392911704,34.8325688073394
"8492640738.jpg",0,17,61,17,0,95,3,0.601416767025641,53.8970588235294
"8492768208.jpg",0,1,41,61,1,104,3.59615384615385,0.530967806041971,71.3108108108108
"8493065081.jpg",0,1,30,63,8,102,3.76470588235294,0.599941756054806,75.6428571428571
"8494026131.jpg",4,54,43,6,0,107,2.47663551401869,0.663691710548945,40.1875
"8494992418.jpg",0,1,57,43,4,105,3.47619047619048,0.589902829273897,69.002427184466
"8496798280.jpg",0,9,36,58,2,105,3.5047619047619,0.681116299848575,66.554054054054
"8496923161.jpg",0,7,57,39,4,107,3.37383177570093,0.666210976923401,65.9205607476636
"8497413134.jpg",0,4,47,54,1,106,3.49056603773585,0.589516073028878,68.5072115384615
"8497829320.jpg",0,5,58,37,0,100,3.32,0.566399223876658,62.0347222222222
"8498158756.jpg",0,0,13,83,9,105,3.96190476190476,0.458337495818594,83.3366336633663
"8498176247.jpg",0,9,97,21,0,127,3.09448818897638,0.47864011841323,58.618
"8498192267.jpg",2,60,41,3,0,106,2.42452830188679,0.584695495964266,37.5152173913043
"8498296013.jpg",1,39,57,2,0,99,2.60606060606061,0.54991987947377,43.625
"8499771607.jpg",0,5,47,43,1,96,3.41666666666667,0.609860495983634,66.0480769230769
"8501012764.jpg",0,27,59,18,0,104,2.91346153846154,0.655233996934956,51.2173913043478
"8501628435.jpg",0,1,56,42,0,99,3.41414141414141,0.515278823077628,64.7640186915888
"8501698385.jpg",0,2,50,56,2,110,3.52727272727273,0.570032848065116,69.0810810810811
"8501713418.jpg",0,0,20,69,15,104,3.95192307692308,0.58092339772589,77.6970338983051
"8502191647.jpg",0,0,53,51,0,104,3.49038461538462,0.502328409725477,70.8551401869159
"8502941912.jpg",0,10,80,9,1,100,3.01,0.481894409826699,53.8154205607477
"8503429334.jpg",0,2,32,68,2,104,3.67307692307692,0.547586189382175,73.2413043478261
"8503728878.jpg",4,54,46,1,0,105,2.41904761904762,0.584757549708759,36.9159482758621
"8503871115.jpg",0,2,71,33,0,106,3.29245283018868,0.496981002455262,60.4868421052632
"8503982189.jpg",0,0,25,77,5,107,3.81308411214953,0.497746641649642,77.3474576271186
"8504046996.jpg",2,41,55,9,0,107,2.66355140186916,0.657954595463405,45.6285714285714
"8504332753.jpg",0,36,66,5,0,107,2.71028037383178,0.549602700317316,46.5483193277311
"8504503946.jpg",0,1,53,47,0,101,3.45544554455446,0.520091385724615,67.5689655172414
"8505294712.jpg",0,0,51,54,2,107,3.54205607476635,0.536944075507108,70.2282608695652
"8506109338.jpg",0,13,70,24,0,107,3.10280373831776,0.581711518973664,57.9180672268908
"8506145736.jpg",2,75,30,0,0,107,2.26168224299065,0.482455366947875,33.8526785714286
"8506515372.jpg",0,2,48,61,1,112,3.54464285714286,0.551629737047747,71.0135135135135
"8506941154.jpg",0,7,75,22,1,105,3.16190476190476,0.539298146522395,58.3881578947368
"8507000235.jpg",40,58,6,1,0,105,1.6952380952381,0.622090296497492,16.4403669724771
"8507554609.jpg",0,3,75,28,0,106,3.23584905660377,0.488961714198037,62.4086956521739
"8509120510.jpg",0,4,91,33,0,128,3.2265625,0.489493451011019,62.25
"8509241021.jpg",8,69,27,1,0,105,2.2,0.578459492631407,31.3986486486486
"8510093470.jpg",0,3,38,62,5,108,3.63888888888889,0.618383985800151,71.8616071428571
"8510431014.jpg",0,20,56,29,0,105,3.08571428571429,0.680981838037009,58.9101941747573
"8511131771.jpg",2,37,55,11,1,106,2.73584905660377,0.707805283857251,46.7433035714286
"8511620322.jpg",0,9,86,13,0,108,3.03703703703704,0.451910294752497,56.2594339622642
"8511720535.jpg",0,9,56,37,1,103,3.29126213592233,0.63602731414348,60.9054054054054
"85119046.jpg",6,60,37,2,0,105,2.33333333333333,0.614983843856998,35.03125
"8512098446.jpg",0,13,70,24,0,107,3.10280373831776,0.581711518973664,56.61875
"8512455050.jpg",0,9,69,25,0,103,3.15533980582524,0.55584737560646,57.1294642857143
"8514709398.jpg",1,46,55,3,0,105,2.57142857142857,0.569364403678193,40.6148648648649
"8515006370.jpg",0,21,68,22,1,112,3.02678571428571,0.650153432044687,52.8181818181818
"8515263910.jpg",0,19,58,28,0,105,3.08571428571429,0.666712452640188,57.9324324324324
"8515582085.jpg",0,3,56,48,2,109,3.44954128440367,0.585096360093473,67.6875
"8515635261.jpg",0,0,16,83,9,108,3.93518518518519,0.478962042632966,79.6305309734513
"8516080909.jpg",1,0,55,47,3,106,3.4811320754717,0.605233242335575,67.6292372881356
"8517283347.jpg",0,2,54,47,2,105,3.46666666666667,0.572891899231546,65.405462184874
"8517500456.jpg",0,0,40,70,1,111,3.64864864864865,0.498153839849949,70.5961538461538
"8517575081.jpg",0,0,23,81,4,108,3.82407407407407,0.470209810073959,77.3991596638655
"8517833832.jpg",7,62,30,3,0,102,2.2843137254902,0.635227424470831,34.9166666666667
"8518560636.jpg",0,14,71,24,0,109,3.09174311926605,0.585966823793358,55.0195652173913
"8518610606.jpg",0,16,68,22,0,106,3.05660377358491,0.598890858635405,54.9196428571429
"8519367340.jpg",0,3,62,41,0,106,3.35849056603774,0.537873754798121,67.2209821428571
"8520265759.jpg",0,21,69,13,0,103,2.92233009708738,0.572050326669033,52.8362831858407
"8520990466.jpg",0,9,77,20,0,106,3.10377358490566,0.515091213060161,58.0929203539823
"8521866643.jpg",0,1,16,76,11,104,3.93269230769231,0.544423148479607,77.8513513513514
"8522041587.jpg",0,7,74,23,1,105,3.17142857142857,0.545208902396822,58.8973214285714
"8522094125.jpg",0,3,60,38,1,102,3.36274509803922,0.559158060267284,65.8676470588235
"8522481331.jpg",6,31,58,8,0,103,2.66019417475728,0.707846749480456,46.4135514018692
"8522515607.jpg",0,27,66,11,0,104,2.84615384615385,0.587395613849414,51.0448113207547
"8522546794.jpg",11,71,22,0,0,104,2.10576923076923,0.555960975629318,28.8632075471698
"8523298395.jpg",0,3,58,41,0,102,3.37254901960784,0.543577599321548,66.7620192307692
"8523540447.jpg",0,5,43,49,5,102,3.52941176470588,0.670538166498752,66.545871559633
"8523976721.jpg",0,6,55,44,4,109,3.42201834862385,0.65678196931384,64.8827433628319
"85240920.jpg",0,46,43,12,0,101,2.66336633663366,0.682308254717357,43.8863636363636
"8524995451.jpg",0,19,73,11,0,103,2.92233009708738,0.536680435611023,52.3581081081081
"8525376754.jpg",0,34,97,5,0,136,2.78676470588235,0.493034267238114,49.2625
"8527988312.jpg",0,0,24,81,1,106,3.78301886792453,0.436538701303618,76.9717391304348
"8528201518.jpg",0,0,29,68,10,107,3.82242990654206,0.579737808534454,79.4864864864865
"8528934790.jpg",0,0,43,63,1,107,3.60747663551402,0.509476411693017,72.7894736842105
"8529310556.jpg",0,3,45,54,1,103,3.51456310679612,0.575037554952665,70.975
"8529310804.jpg",0,3,47,54,1,105,3.5047619047619,0.573850180189942,66.7847826086957
"8529412192.jpg",0,25,60,15,0,100,2.9,0.627645914460848,51.325
"8529490962.jpg",1,4,76,24,0,105,3.17142857142857,0.527277894493955,60.9927184466019
"8529541053.jpg",0,9,79,18,0,106,3.08490566037736,0.499865210942422,57.285046728972
"8529705971.jpg",0,0,28,73,2,103,3.74757281553398,0.479346912771086,75.7610619469027
"8530273249.jpg",0,10,68,23,0,101,3.12871287128713,0.55970289148143,57.8160377358491
"8530355188.jpg",4,56,36,2,0,98,2.36734693877551,0.598757392000356,36.6432038834951
"8530869068.jpg",0,1,61,43,0,105,3.4,0.511408311956759,64.345652173913
"8531375153.jpg",0,2,37,55,4,98,3.62244897959184,0.600949525685501,72.2981651376147
"8531633123.jpg",0,0,20,73,14,107,3.94392523364486,0.563542965178822,80.3325892857143
"8532549490.jpg",1,1,44,64,1,111,3.56756756756757,0.581871926264654,66.9306722689076
"8532727626.jpg",0,0,48,57,4,109,3.59633027522936,0.563048350911192,70.4663865546218
"8533373653.jpg",0,3,76,28,1,108,3.25,0.513827492052328,59.6184210526316
"8533805271.jpg",0,12,65,25,2,104,3.16346153846154,0.64024535532185,57.7368421052632
"8534896880.jpg",0,0,42,60,3,105,3.62857142857143,0.541670188774122,71.3075221238938
"8535035859.jpg",2,22,77,4,0,105,2.79047619047619,0.531602043450486,47.5586956521739
"8535232822.jpg",0,1,45,53,4,103,3.58252427184466,0.586185272268683,68.7522123893805
"8537113381.jpg",0,38,65,4,0,107,2.68224299065421,0.542498253907659,47.0379464285714
"8539118741.jpg",4,14,62,26,1,107,3.05607476635514,0.750242422467874,52.9264705882353
"8539488665.jpg",0,1,59,40,1,101,3.40594059405941,0.53250761162226,63.607476635514
"8539498079.jpg",1,11,63,27,0,102,3.13725490196078,0.62993345061479,57.775
"8539554428.jpg",0,1,43,63,1,108,3.59259259259259,0.530156687066959,70.4314159292035
"8539670364.jpg",1,6,74,24,2,107,3.18691588785047,0.600798856892478,58.3881578947368
"8540532034.jpg",0,22,66,14,0,102,2.92156862745098,0.591796635357012,52.6949541284404
"8541006859.jpg",0,7,55,40,0,102,3.32352941176471,0.599699012061032,61.328125
"8544556866.jpg",0,1,63,45,0,109,3.40366972477064,0.511339309957935,65.453125
"8545406642.jpg",0,1,44,55,2,102,3.56862745098039,0.554188442797278,68.65
"8545722241.jpg",1,22,67,16,2,108,2.96296296296296,0.682572455856477,52.5625
"8545905705.jpg",8,82,18,2,0,110,2.12727272727273,0.543672373500889,29.875
"8546237134.jpg",0,24,70,11,0,105,2.87619047619048,0.566623570867177,49.1369565217391
"8546536299.jpg",0,4,37,59,8,108,3.65740740740741,0.672031889500316,70.575
"8546547724.jpg",0,0,16,82,11,109,3.95412844036697,0.497871787394763,80.8910256410256
"8546838188.jpg",0,30,73,3,0,106,2.74528301886792,0.498785587196151,48.3097345132743
"8546849368.jpg",1,7,50,41,1,100,3.34,0.669991708074726,63.1399082568807
"8547424731.jpg",0,1,36,64,4,105,3.67619047619048,0.563219421909541,73.4766355140187
"8549362115.jpg",0,11,60,36,0,107,3.23364485981308,0.623130248541874,59.9802631578947
"8549600155.jpg",0,0,36,66,3,105,3.68571428571429,0.524666298969855,70.7162162162162
"8550306054.jpg",2,20,70,8,0,100,2.84,0.581186525805423,46.0464601769912
"8550575599.jpg",0,9,73,24,0,106,3.14150943396226,0.542282288907294,57.3621495327103
"8550746603.jpg",0,1,12,78,15,106,4.00943396226415,0.543275480744748,82.1621621621622
"8551222492.jpg",0,0,19,78,7,104,3.88461538461538,0.488860222000338,77.1482300884956
"8551620615.jpg",0,1,41,60,3,105,3.61904761904762,0.561264924094064,70.9040178571429
"8552101917.jpg",11,56,29,3,0,99,2.24242424242424,0.686471443449481,32.5486111111111
"8552550792.jpg",1,31,62,5,0,99,2.71717171717172,0.572149617231404,46.9861111111111
"8552590099.jpg",0,0,35,71,0,106,3.66981132075472,0.47251501590063,70.5869565217391
"8552740610.jpg",4,74,24,0,0,102,2.19607843137255,0.488262542715799,30.8211009174312
"8553006135.jpg",0,5,47,47,1,100,3.44,0.608359277155375,65.875
"8553130419.jpg",0,10,63,31,1,105,3.21904761904762,0.619878281801423,62.8378378378378
"8553449461.jpg",0,2,39,68,1,110,3.61818181818182,0.541520424645821,71.2307692307692
"8553471741.jpg",0,18,64,20,1,103,3.03883495145631,0.640501183925179,53.078125
"8554033162.jpg",0,0,32,72,1,105,3.7047619047619,0.478857002981088,74.9415887850467
"8554330315.jpg",0,2,32,63,5,102,3.69607843137255,0.593516382889227,74.3738938053097
"8555190491.jpg",0,2,39,62,0,103,3.58252427184466,0.533656859801263,70.9391891891892
"8556005393.jpg",5,53,43,3,0,104,2.42307692307692,0.633870950884253,37.609375
"8556290824.jpg",0,5,51,42,1,99,3.39393939393939,0.603022689155527,67.5606796116505
"8556730555.jpg",0,12,60,23,1,96,3.13541666666667,0.626095531077397,58.518691588785
"8556786880.jpg",0,1,35,71,3,110,3.69090909090909,0.53750109102436,73.4247787610619
"8558582535.jpg",0,9,69,27,1,106,3.18867924528302,0.587378478571482,58.3340336134454
"8559592041.jpg",0,4,79,24,0,107,3.18691588785047,0.478418012563485,60.214953271028
"8560160557.jpg",0,15,65,28,0,108,3.12037037037037,0.622289901377863,57.44375
"8560249138.jpg",0,13,79,18,0,110,3.04545454545455,0.531336615369542,56.1631355932203
"8560249157.jpg",6,70,31,3,0,110,2.28181818181818,0.607775583006932,33.93125
"8561557613.jpg",0,2,72,27,0,101,3.24752475247525,0.477617851300795,63.4642857142857
"8562649420.jpg",0,5,66,37,2,110,3.32727272727273,0.592136404274997,62.4555084745763
"8564299084.jpg",0,2,60,38,0,100,3.36,0.52261966393479,63.775
"8564706371.jpg",0,0,41,63,2,106,3.63207547169811,0.522365894352903,69.5868644067797
"8565023764.jpg",0,7,79,17,1,104,3.11538461538462,0.508332364091029,59.1842105263158
"8565939221.jpg",1,52,48,4,0,105,2.52380952380952,0.589902829273897,39.8108695652174
"8565941333.jpg",0,2,35,64,2,103,3.64077669902913,0.557557153177668,73.0401785714286
"8565990156.jpg",0,3,38,61,1,103,3.58252427184466,0.569214660991312,72.5259433962264
"8566161884.jpg",0,23,61,17,0,101,2.94059405940594,0.629631355290027,49.9159292035398
"8567636458.jpg",1,18,61,32,0,112,3.10714285714286,0.689132407381539,55.0833333333333
"8567878134.jpg",2,26,53,24,3,108,3,0.808829776576404,54.3021739130435
"8568057395.jpg",0,7,78,24,0,109,3.15596330275229,0.512335103130853,59.3792372881356
"8568663212.jpg",0,1,19,79,3,102,3.82352941176471,0.475368844930275,75.3236607142857
"8568761304.jpg",3,32,64,8,0,107,2.7196261682243,0.641260441061998,46.375
"8568890785.jpg",0,0,54,47,1,102,3.48039215686275,0.521429720673115,65.3794642857143
"8569001906.jpg",0,1,28,70,9,108,3.80555555555556,0.587380265521398,79.6399082568807
"8570186179.jpg",0,8,76,17,0,101,3.08910891089109,0.491914828013755,58.3849557522124
"8570770544.jpg",0,5,72,27,0,104,3.21153846153846,0.515263659967445,59.2478448275862
"8572309728.jpg",0,1,44,85,1,131,3.65648854961832,0.507952032356966,74.34765625
"8572873286.jpg",0,11,70,28,0,109,3.15596330275229,0.580139062617038,58.0929203539823
"8573160777.jpg",0,27,59,16,0,102,2.8921568627451,0.643426205622019,52.6902654867257
"8573294301.jpg",6,68,30,0,0,104,2.23076923076923,0.543822665820023,33.6764705882353
"8575096989.jpg",0,7,61,36,1,105,3.2952380952381,0.603257336399164,62.9864864864865
"8580729000.jpg",0,2,29,68,1,100,3.68,0.529531906880067,75.1743119266055
"8581043227.jpg",0,2,28,70,4,104,3.73076923076923,0.561391634768236,73.0978260869565
"8582877561.jpg",0,0,57,39,3,99,3.45454545454545,0.558290526239082,70.1428571428571
"8583578292.jpg",0,0,29,74,1,104,3.73076923076923,0.466983071370875,74.8816964285714
"8583898549.jpg",0,3,60,40,0,103,3.35922330097087,0.539687072220866,67.2334905660377
"8585320404.jpg",0,5,51,45,1,102,3.41176470588235,0.602847060001036,66.853982300885
"8586661877.jpg",0,1,18,66,21,106,4.00943396226415,0.639870269870503,79.4449152542373
"8587794241.jpg",0,14,70,17,0,101,3.02970297029703,0.555975638756852,54.7028301886792
"8588348191.jpg",0,18,68,19,0,105,3.00952380952381,0.596387169276516,52.0782608695652
"8589152246.jpg",0,0,19,84,7,110,3.89090909090909,0.475943380825345,77.0677966101695
"8589157666.jpg",7,77,23,1,0,108,2.16666666666667,0.538256097195586,31.6927966101695
"8589543288.jpg",0,1,28,75,1,105,3.72380952380952,0.49019694031383,73.0597345132743
"8590374545.jpg",0,2,57,42,2,103,3.42718446601942,0.570550847480092,66.1969026548673
"8590498036.jpg",0,0,21,78,8,107,3.8785046728972,0.508610396428658,79.0464601769911
"8590640853.jpg",0,2,60,65,0,127,3.49606299212598,0.532648604319057,71.1915322580645
"8591936597.jpg",0,0,15,76,13,104,3.98076923076923,0.521029027213842,79.9539473684211
"8593005656.jpg",2,23,74,9,0,108,2.83333333333333,0.588042849223902,49.984375
"8595112756.jpg",0,0,23,75,4,102,3.81372549019608,0.48195953482134,77.5862831858407
"8595244033.jpg",0,0,26,72,4,102,3.7843137254902,0.500048531909845,78.7638888888889
"8595845896.jpg",0,9,76,21,0,106,3.11320754716981,0.522279886960478,57.4864864864865
"8595948410.jpg",8,63,29,5,0,105,2.2952380952381,0.678287004204902,33.4260869565217
"8596148572.jpg",0,7,61,32,0,100,3.25,0.575159178669767,61.75
"8596349698.jpg",0,0,18,80,4,102,3.86274509803922,0.445865843301836,78.25
"8596361580.jpg",0,0,49,52,3,104,3.55769230769231,0.554363504117592,66.4054054054054
"8596901738.jpg",4,70,33,1,0,108,2.28703703703704,0.547738356358812,34.3466386554622
"8596963541.jpg",4,38,56,7,0,105,2.62857142857143,0.66876957709868,42.7702702702703
"8596983746.jpg",0,1,37,63,6,107,3.69158878504673,0.589390714392975,75.4709821428571
"8597007982.jpg",0,4,52,49,2,107,3.45794392523365,0.603142303553142,68.6351351351351
"8597381500.jpg",0,3,62,46,0,111,3.38738738738739,0.5422373041587,67.756880733945
"8599488070.jpg",0,11,76,18,1,106,3.08490566037736,0.55408310410386,55.4797297297297
"8599891034.jpg",0,6,63,40,1,110,3.32727272727273,0.592136404274997,62.7302631578947
"859991088.jpg",47,61,1,0,0,109,1.57798165137615,0.51448604310428,14.5796460176991
"8600036440.jpg",4,38,59,4,0,105,2.6,0.629407535825435,43.1339285714286
"8600322713.jpg",0,2,35,64,2,103,3.64077669902913,0.557557153177668,73.6634615384615
"8600472805.jpg",0,4,33,61,4,102,3.63725490196078,0.625991738886346,74.6659292035398
"8600489475.jpg",0,2,43,61,0,106,3.55660377358491,0.535949334478999,69.7757009345794
"8600504349.jpg",0,10,60,33,0,103,3.22330097087379,0.60927534641092,63.5754716981132
"8600750192.jpg",4,63,35,6,0,108,2.39814814814815,0.654814160906468,37.1842105263158
"8601119886.jpg",0,1,55,47,2,105,3.47619047619048,0.556348640264187,66.8577586206897
"8601680123.jpg",0,23,62,16,0,101,2.93069306930693,0.620603347438189,53.25
"8602273631.jpg",0,13,60,33,1,107,3.20560747663551,0.654999895679228,62.1470588235294
"8602435402.jpg",0,0,23,79,6,108,3.84259259259259,0.496003411147394,76.1991150442478
"8602839124.jpg",1,36,66,3,0,106,2.66981132075472,0.547230222522522,44.1869565217391
"8604323835.jpg",0,3,49,49,0,101,3.45544554455446,0.557220826517594,67.3928571428571
"8604870622.jpg",0,1,28,72,4,105,3.75238095238095,0.533150151691889,75.3230088495575
"8606964079.jpg",0,3,43,60,1,107,3.55140186915888,0.570230752031589,71.5265486725664
"8607324496.jpg",0,32,60,13,0,105,2.81904761904762,0.632165879839856,50.3398058252427
"8607422328.jpg",15,86,6,0,0,107,1.91588785046729,0.437002986197275,24.44375
"8607616136.jpg",2,47,51,8,0,108,2.60185185185185,0.654814160906468,43.2205882352941
"8608196738.jpg",0,4,57,42,0,103,3.36893203883495,0.559942070920715,65.6514423076923
"8608242752.jpg",0,0,27,68,5,100,3.78,0.523778039195454,75.0957943925234
"8608282741.jpg",0,1,35,66,6,108,3.71296296296296,0.58086184639443,75.25
"8608557464.jpg",0,2,65,39,0,106,3.34905660377358,0.517180134966139,65.6383495145631
"8610015449.jpg",0,1,49,51,0,101,3.4950495049505,0.521991616335696,69.775
"8610505282.jpg",0,0,17,88,5,110,3.89090909090909,0.435688941843877,74.4180672268908
"8610523080.jpg",0,9,70,26,0,105,3.16190476190476,0.556842221884494,60.0486111111111
"8610701081.jpg",0,1,20,86,5,112,3.84821428571429,0.487867605518957,75.3199152542373
"8610965034.jpg",0,1,24,71,11,107,3.85981308411215,0.589988777169262,78.8369565217391
"8611793668.jpg",0,1,58,50,2,111,3.47747747747748,0.55344946138406,68.2692307692308
"8612503268.jpg",0,1,46,48,5,100,3.57,0.607279078174013,70.2545871559633
"8613516565.jpg",0,0,28,77,3,108,3.76851851851852,0.485422669308056,75.6118421052632
"8613815314.jpg",0,11,53,41,1,106,3.30188679245283,0.664326530738422,63.0847457627119
"8615148214.jpg",0,4,60,45,1,110,3.39090909090909,0.57621757080761,62.4625
"8615756718.jpg",0,6,65,29,0,100,3.23,0.547814758929522,59.8096330275229
"8616342001.jpg",34,51,21,0,0,106,1.87735849056604,0.713179736761515,23.6695652173913
"8616708613.jpg",6,77,26,0,0,109,2.18348623853211,0.512169272052507,32.4618644067797
"8616750908.jpg",38,70,2,0,0,110,1.67272727272727,0.508804876157519,18.0593220338983
"8617030862.jpg",0,0,44,58,3,105,3.60952380952381,0.545880342186223,68.7837837837838
"8617343673.jpg",0,0,28,76,3,107,3.76635514018692,0.487183651636056,76.4285714285714
"8617452211.jpg",0,8,67,31,0,106,3.21698113207547,0.569121578460334,62.9975247524753
"8617517082.jpg",0,1,33,70,5,109,3.72477064220183,0.558960007067151,73.0826271186441
"8617920561.jpg",0,9,59,31,1,100,3.24,0.621500302705177,61.2477064220183
"8618147512.jpg",0,1,56,50,0,107,3.45794392523365,0.519077080686367,67.7139423076923
"8618789190.jpg",0,2,34,67,0,103,3.63106796116505,0.52375513029704,74.9444444444444
"8619398770.jpg",0,11,64,27,0,102,3.15686274509804,0.592779959162309,57.8247663551402
"8619422796.jpg",0,2,55,45,0,102,3.42156862745098,0.534665149393819,67.9930555555556
"8620686347.jpg",0,16,65,25,1,107,3.10280373831776,0.643319508036135,56
"8620919369.jpg",1,63,74,2,0,140,2.55,0.540782805907758,42.0732142857143
"8623218161.jpg",0,0,19,86,2,107,3.8411214953271,0.415490905612625,77.9760869565217
"8623527706.jpg",3,9,80,21,0,113,3.05309734513274,0.610045489589005,54.0961538461538
"86243803.jpg",4,44,45,6,0,99,2.53535353535354,0.674811104531185,39.01875
"8625160006.jpg",3,41,48,7,1,100,2.62,0.707535200966044,43.1061320754717
"8626678643.jpg",0,2,57,41,1,101,3.40594059405941,0.550966747123312,65.0086206896552
"8626945283.jpg",6,14,55,28,4,107,3.09345794392523,0.874510216348339,56.9407894736842
"8627391076.jpg",0,0,42,60,2,104,3.61538461538462,0.527085636410755,72.799504950495
"8627453045.jpg",0,0,24,71,6,101,3.82178217821782,0.517610656844706,74.2660550458716
"8627956046.jpg",0,2,30,74,2,108,3.7037037037037,0.534059733773752,74.804054054054
"8628548669.jpg",0,3,51,52,1,107,3.47663551401869,0.572083157837716,66.0294117647059
"8629754639.jpg",0,10,76,22,0,108,3.11111111111111,0.535354425937356,57.9174311926606
"8629854370.jpg",0,0,37,74,2,113,3.69026548672566,0.501420233253561,72.8235294117647
"8630845484.jpg",3,44,58,5,1,111,2.61261261261261,0.662929739471567,42.6118421052632
"8631292769.jpg",0,1,46,54,1,102,3.53921568627451,0.53900474156975,72.2146226415094
"8631436677.jpg",0,0,38,65,0,103,3.63106796116505,0.484874984132982,72.3428571428571
"8632003704.jpg",2,13,57,36,2,110,3.20909090909091,0.743108454497696,59.8451327433628
"8632135169.jpg",2,36,55,10,1,104,2.73076923076923,0.699941318355439,47.3455882352941
"8633987600.jpg",0,3,57,43,1,104,3.40384615384615,0.566358334015961,67.9611650485437
"8634101418.jpg",0,5,59,41,0,105,3.34285714285714,0.568881686843911,64.1966019417476
"8634276040.jpg",1,40,53,8,0,102,2.66666666666667,0.634539410932373,46.9097222222222
"8634679976.jpg",1,6,60,35,1,103,3.28155339805825,0.632726371614444,63.6533018867925
"8634744119.jpg",0,0,31,67,3,101,3.72277227722772,0.512226744346449,74.1805555555556
"8635239066.jpg",0,1,55,49,1,106,3.47169811320755,0.538207734187519,65.8114406779661
"8636582269.jpg",0,0,32,72,2,106,3.71698113207547,0.492896530842733,73.703125
"8636633195.jpg",0,0,48,58,1,107,3.5607476635514,0.51720530016433,69.7978260869565
"8636811972.jpg",0,1,38,64,6,109,3.68807339449541,0.588426144810633,73.1525423728814
"8636833629.jpg",6,80,22,0,0,108,2.14814814814815,0.489417254369973,30.8109243697479
"8637618858.jpg",0,2,39,57,1,99,3.57575757575758,0.554957418681078,73.2071428571429
"8638507719.jpg",0,2,41,57,3,103,3.59223300970874,0.584722042292587,72.925
"8638666116.jpg",0,3,40,59,1,103,3.56310679611651,0.5717174489413,71.6926605504587
"8639628841.jpg",0,2,40,61,3,106,3.61320754716981,0.578516241974426,71.1949152542373
"8639669088.jpg",0,3,55,52,3,113,3.48672566371681,0.599330642225552,66.0833333333333
"8639759293.jpg",0,1,39,60,2,102,3.61764705882353,0.54580520311164,72.325
"8639811289.jpg",0,0,14,87,11,112,3.97321428571429,0.473815667745683,81.1025641025641
"8639919087.jpg",0,16,65,22,0,103,3.05825242718447,0.60755444714367,56.2455357142857
"8639922039.jpg",0,11,57,36,0,104,3.24038461538462,0.630844591938848,61.6089108910891
"8640408375.jpg",0,3,56,43,1,103,3.40776699029126,0.567707692043677,66.0388349514563
"8640671500.jpg",1,2,62,36,2,103,3.3495145631068,0.605671525940304,66.3888888888889
"8641316746.jpg",0,6,106,33,0,145,3.18620689655172,0.485715493092289,61.6683673469388
"8641533130.jpg",0,9,68,28,1,106,3.19811320754717,0.592328919576578,60.4717391304348
"8642082647.jpg",7,58,29,3,0,97,2.28865979381443,0.644831419936604,32.535046728972
"8642168798.jpg",0,4,57,44,0,105,3.38095238095238,0.561264924094064,62.695652173913
"8642423630.jpg",1,5,49,52,3,110,3.46363636363636,0.67289969163006,66.4210526315789
"8642430238.jpg",0,3,47,48,9,107,3.58878504672897,0.686160647728556,68.03125
"8644125724.jpg",0,4,59,38,1,102,3.35294117647059,0.574146957824214,61.7775229357798
"8644207930.jpg",21,59,25,0,0,105,2.03809523809524,0.663959705737096,26.4189189189189
"8644363471.jpg",0,4,47,84,4,139,3.63309352517986,0.591533071981295,75.3097826086957
"8644395037.jpg",1,33,87,19,0,140,2.88571428571429,0.624277588663985,52.0256849315069
"8644571098.jpg",0,1,22,69,10,102,3.86274509803922,0.580870219248152,76.7364864864865
"8644731627.jpg",0,4,64,37,0,105,3.31428571428571,0.542683604419273,61.5743243243243
"8644935134.jpg",0,2,60,39,0,101,3.36633663366337,0.523884954493403,64.9375
"8645014360.jpg",2,37,63,7,0,109,2.68807339449541,0.619098025302731,44.0022123893805
"8645679476.jpg",0,1,10,95,7,113,3.95575221238938,0.43072572750976,78.9804347826087
"8645856155.jpg",0,3,74,34,0,111,3.27927927927928,0.50759989918996,64.8141025641026
"8645919775.jpg",0,1,53,48,1,103,3.47572815533981,0.539510675068835,66.777027027027
"8645927718.jpg",0,2,32,71,2,107,3.68224299065421,0.542498253907659,72.9621848739496
"8646019769.jpg",0,4,67,52,0,123,3.39024390243902,0.552700469401329,66.3181818181818
"8646711055.jpg",0,1,46,49,7,103,3.60194174757282,0.631521751061341,72.5
"8647121069.jpg",0,2,47,63,0,112,3.54464285714286,0.535048921854206,68.9913793103448
"8647880189.jpg",0,0,51,58,1,110,3.54545454545455,0.51822498100965,69.0986842105263
"8648111033.jpg",1,24,69,18,0,112,2.92857142857143,0.639739329153999,50.0805084745763
"8648273876.jpg",0,1,20,77,2,100,3.8,0.471404520791032,74.1548672566372
"8650038281.jpg",0,5,58,38,0,101,3.32673267326733,0.567607450463595,63.475
"8650041199.jpg",0,1,24,81,5,111,3.81081081081081,0.51369452389729,74.5508474576271
"8650438745.jpg",0,0,30,66,1,97,3.70103092783505,0.482289428438469,76.0283018867924
"8650937010.jpg",1,5,75,26,0,107,3.17757009345794,0.546223468543532,60.296875
"8651960690.jpg",1,12,48,41,0,102,3.26470588235294,0.702562080527236,61.9
"8652814108.jpg",1,48,49,3,0,101,2.53465346534653,0.57557547612183,40.9
"8653060124.jpg",0,27,65,12,0,104,2.85576923076923,0.59802700252003,51.3102678571429
"8653149698.jpg",0,10,51,47,2,110,3.37272727272727,0.675374050747944,62.53125
"8653385211.jpg",0,2,34,60,2,98,3.63265306122449,0.563270184789685,74.7785714285714
"86543550.jpg",0,4,46,49,7,106,3.55660377358491,0.677251991918114,68.375
"8654833683.jpg",0,2,66,30,0,98,3.28571428571429,0.497416003373807,62.8371559633027
"8655212711.jpg",0,6,62,39,1,108,3.32407407407407,0.593243952337583,60.9872881355932
"8655538784.jpg",25,73,3,0,0,101,1.78217821782178,0.481745999382239,21.2162162162162
"8657980323.jpg",0,1,30,68,4,103,3.72815533980583,0.54582505919096,74.0921052631579
"8658407746.jpg",0,4,57,46,1,108,3.40740740740741,0.580638337691333,65.2162162162162
"8658742127.jpg",0,3,21,76,5,105,3.79047619047619,0.566623570867177,74.2543103448276
"8659008037.jpg",0,2,45,64,0,111,3.55855855855856,0.534018806013501,70.4258474576271
"8660939599.jpg",0,2,45,57,0,104,3.52884615384615,0.538908115251656,70.0841121495327
"8661391867.jpg",2,11,71,25,0,109,3.09174311926605,0.631595340500571,54.41875
"8663368144.jpg",0,0,39,68,1,108,3.64814814814815,0.498873774884556,70.2853982300885
"8664375707.jpg",0,7,55,44,1,107,3.36448598130841,0.620293955945691,65.9205607476636
"8665123695.jpg",0,5,72,40,3,120,3.34166666666667,0.601061153131627,64.9724576271186
"8665859306.jpg",0,8,72,34,0,114,3.2280701754386,0.564982382359804,59.5391304347826
"8666962145.jpg",0,10,62,32,1,105,3.22857142857143,0.624147770612408,58.6769911504425
"8667121921.jpg",0,1,50,57,0,108,3.51851851851852,0.520270984055541,70.0394736842105
"8667622533.jpg",0,0,19,86,1,106,3.83018867924528,0.401703470668117,80.8482142857143
"8667640386.jpg",40,66,5,0,0,111,1.68468468468468,0.555664744934667,19.1923076923077
"8667761330.jpg",0,7,40,54,0,101,3.46534653465347,0.625529478692149,64.4955357142857
"8668135949.jpg",2,18,58,27,0,105,3.04761904761905,0.712268213053206,53.3986486486486
"8668194198.jpg",0,4,57,43,0,104,3.375,0.560642834922123,63.4324324324324
"8668357579.jpg",0,3,66,37,1,107,3.33644859813084,0.548478603040537,61.6375
"8668432915.jpg",0,2,56,74,7,139,3.61870503597122,0.606674033876721,74.1689655172414
"8668692139.jpg",1,44,55,1,0,101,2.55445544554455,0.538056642459741,41.725
"8668839930.jpg",0,2,47,49,3,101,3.52475247524752,0.593195741824578,66.4453781512605
"8669455182.jpg",1,24,67,10,0,102,2.84313725490196,0.592779959162309,48.3050458715596
"8669765013.jpg",1,8,69,24,0,102,3.13725490196078,0.580870219248152,59.8958333333333
"8669807326.jpg",0,11,63,39,0,113,3.24778761061947,0.62006585841643,62.077731092437
"8669827233.jpg",0,2,63,43,1,109,3.39449541284404,0.544643080950186,65.8717948717949
"8669875850.jpg",0,0,13,71,25,109,4.11009174311927,0.582768767136427,82.3114406779661
"8669987529.jpg",27,61,15,0,0,103,1.88349514563107,0.6309185782866,23.4036697247706
"8670498239.jpg",0,4,32,62,2,100,3.62,0.599326221011495,71.5412844036697
"8670524662.jpg",0,5,64,36,0,105,3.2952380952381,0.553377905438143,61.84375
"8671346109.jpg",0,6,75,23,0,104,3.16346153846154,0.504553574148434,59.4866071428571
"8672886430.jpg",0,2,30,88,7,127,3.78740157480315,0.558198935634539,79.4724409448819
"8673060245.jpg",0,1,34,65,5,105,3.7047619047619,0.570489154548862,74.1450892857143
"8673410143.jpg",0,1,13,72,20,106,4.04716981132075,0.591721869537951,82.60625
"8674617206.jpg",1,24,69,14,0,108,2.88888888888889,0.616491934493834,51.5405405405405
"8675618794.jpg",2,40,54,7,0,103,2.64077669902913,0.639460080650747,43.4391891891892
"8675742263.jpg",0,0,34,65,4,103,3.70873786407767,0.535615240179964,74.3008849557522
"8676061963.jpg",0,3,74,32,0,109,3.26605504587156,0.502626468973,61.6227678571429
"8676415201.jpg",0,4,50,46,3,103,3.46601941747573,0.6233296735855,66.5580357142857
"8676993848.jpg",0,0,36,61,1,98,3.64285714285714,0.502570711032417,71.3851351351351
"8677186401.jpg",0,9,63,39,0,111,3.27027027027027,0.602207242279236,62.9102564102564
"8679754087.jpg",2,16,62,30,0,110,3.09090909090909,0.697905839255595,55.0833333333333
"8680382358.jpg",0,2,34,64,9,109,3.73394495412844,0.633073072765233,75.0420168067227
"8681619509.jpg",0,11,73,23,0,107,3.11214953271028,0.555030218516758,57.0405405405405
"8683573016.jpg",1,7,66,34,0,108,3.23148148148148,0.605372851533239,60.6218487394958
"8683910174.jpg",2,34,59,6,0,101,2.68316831683168,0.615316066250621,46.15
"8684784453.jpg",0,2,48,60,1,111,3.54054054054054,0.552412622194411,69.2564102564103
"8686047954.jpg",0,0,26,70,6,102,3.80392156862745,0.527261103264158,77.0178571428571
"8687168552.jpg",0,2,54,46,0,102,3.43137254901961,0.536025045993237,68.8252212389381
"8687755587.jpg",0,10,95,21,0,126,3.08730158730159,0.49022184806214,57.7023809523809
"8688105270.jpg",0,0,27,70,4,101,3.77227722772277,0.507566510298146,74.7201834862385
"8688570494.jpg",0,0,21,83,9,113,3.89380530973451,0.506437696393839,77.224358974359
"8688672632.jpg",0,0,17,77,11,105,3.94285714285714,0.515687954032345,77.1377118644068
"8690378205.jpg",0,3,46,54,1,104,3.50961538461538,0.57445951478755,70.4620535714286
"8691429186.jpg",0,1,38,70,1,110,3.64545454545455,0.517339056857098,71.4423076923077
"8691629871.jpg",0,36,59,12,0,107,2.77570093457944,0.634070575426553,49.2867647058824
"8691658021.jpg",0,0,38,63,1,102,3.63725490196078,0.503241289808191,71.8125
"8692247074.jpg",1,0,35,84,5,125,3.736,0.570002829647759,78.1341463414634
"8693045087.jpg",0,0,7,90,15,112,4.07142857142857,0.439374775163747,83.8556034482759
"8693359675.jpg",0,14,81,12,0,107,2.98130841121495,0.494904382059216,52.8571428571429
"869382458.jpg",2,23,73,13,0,111,2.87387387387387,0.619635040929404,49.0441176470588
"8693865711.jpg",0,0,29,69,8,106,3.80188679245283,0.559247986917716,76.4285714285714
"8695646882.jpg",0,0,18,78,12,108,3.94444444444444,0.526553479694317,77.24375
"8695656651.jpg",2,54,42,2,0,100,2.44,0.574192450052219,36.9203539823009
"8696013314.jpg",0,7,55,44,2,108,3.37962962962963,0.637131313107367,65.2782608695652
"8696567124.jpg",3,60,39,1,0,103,2.36893203883495,0.559942070920715,35.0405405405405
"8697211336.jpg",0,0,28,73,6,107,3.79439252336449,0.527334302993257,76.0819327731092
"8697364440.jpg",0,2,61,45,0,108,3.39814814814815,0.52844003921284,66.2763157894737
"8697765454.jpg",0,57,42,1,0,100,2.44,0.518739731552258,38.2385321100917
"8698328366.jpg",0,2,42,59,2,105,3.58095238095238,0.568076247268466,68.594537815126
"8699039377.jpg",0,1,22,81,6,110,3.83636363636364,0.516290095668838,76.7232142857143
"8700100428.jpg",0,0,22,84,4,110,3.83636363636364,0.45990171920325,74.2012711864407
"8701800150.jpg",0,2,35,61,5,103,3.66990291262136,0.600463048683739,71.3108108108108
"8701957904.jpg",0,3,66,35,1,105,3.32380952380952,0.545880342186223,62.2349137931034
"8702092556.jpg",0,0,43,62,2,107,3.61682242990654,0.525659689990427,73.375
"8702450132.jpg",1,17,85,23,0,126,3.03174603174603,0.592439133569118,57.5426829268293
"8702518420.jpg",0,0,27,73,6,106,3.80188679245283,0.524083078124337,76.9568965517241
"8702530063.jpg",0,2,54,47,0,103,3.43689320388349,0.53632560553216,68.8252212389381
"8702541866.jpg",0,1,46,55,2,104,3.55769230769231,0.554363504117592,72.5808823529412
"8702657469.jpg",11,66,24,2,0,103,2.16504854368932,0.627742412806474,32.9778761061947
"8703113665.jpg",1,43,57,8,0,109,2.6605504587156,0.626870290296381,46.3026315789474
"8703657043.jpg",0,4,59,38,0,101,3.33663366336634,0.55276084743354,65.35
"8703680136.jpg",15,56,34,4,0,109,2.24770642201835,0.734796057656316,33.3125
"8703712845.jpg",0,8,98,21,0,127,3.10236220472441,0.468612366787531,59.8145161290323
"8704001812.jpg",0,0,38,65,2,105,3.65714285714286,0.515687954032345,72.6673913043478
"8704133333.jpg",0,2,32,61,5,100,3.69,0.59789191955967,70.5044247787611
"8705060352.jpg",1,33,64,11,0,109,2.77981651376147,0.628899658797715,48.7631578947368
"8705536207.jpg",0,53,50,10,0,113,2.61946902654867,0.645293179088783,43.1512605042017
"8706343716.jpg",0,3,83,23,0,109,3.18348623853211,0.454710685688426,60.5677966101695
"8706810197.jpg",0,2,37,65,6,110,3.68181818181818,0.604749067406287,70.6050420168067
"8707214366.jpg",1,0,16,78,10,105,3.91428571428571,0.573690577856111,76.7435344827586
"8707676839.jpg",0,32,64,8,0,104,2.76923076923077,0.578427215227558,48.6017699115044
"8709304294.jpg",8,85,17,0,0,110,2.08181818181818,0.471807342539016,29.3156779661017
"8709597894.jpg",0,2,45,54,2,103,3.54368932038835,0.573545885630822,67.45
"8709697980.jpg",0,0,47,50,3,100,3.56,0.55632270266002,71.875
"8710250301.jpg",0,4,71,79,1,155,3.49677419354839,0.562625957596049,70.1003184713376
"8710431611.jpg",0,2,37,57,6,102,3.65686274509804,0.621322416568889,72.925
"8711977206.jpg",0,3,79,45,0,127,3.33070866141732,0.520303911651585,65.1811023622047
"8713381356.jpg",1,45,47,4,0,97,2.55670103092783,0.594577443879062,40.6785714285714
"8713537516.jpg",0,15,62,30,0,107,3.14018691588785,0.636152914612978,58.6013513513514
"8714823724.jpg",0,2,42,57,2,103,3.57281553398058,0.570550847480092,71.3108108108108
"8715170978.jpg",0,23,111,16,0,150,2.95333333333333,0.509463023885871,53.887417218543
"8715241935.jpg",0,7,67,39,0,113,3.28318584070796,0.574285682837392,62.6323529411765
"8715401905.jpg",18,71,12,0,0,101,1.94059405940594,0.544459037544935,22.9508928571429
"8715753944.jpg",0,0,43,65,3,111,3.63963963963964,0.535856032103481,71.5128205128205
"8716882404.jpg",0,1,49,56,1,107,3.53271028037383,0.537600486602462,69.2834821428571
"8717130944.jpg",0,4,36,67,7,114,3.67543859649123,0.644865548655113,72.7542016806723
"8717637188.jpg",0,1,20,76,0,97,3.77319587628866,0.444998938181675,79.0214285714286
"8718552383.jpg",0,3,35,66,3,107,3.64485981308411,0.586842147921673,73.8504464285714
"8718592525.jpg",0,4,36,61,5,106,3.63207547169811,0.637337791847025,70.5869565217391
"8718842570.jpg",1,14,60,25,0,100,3.09,0.652810551509101,56.5911214953271
"8720193519.jpg",8,43,51,7,0,109,2.52293577981651,0.727709881589845,38.7542372881356
"872022815.jpg",4,74,22,0,0,100,2.18,0.479477830456206,30.8269230769231
"8721056397.jpg",36,69,3,0,0,108,1.69444444444444,0.519855000152735,18.609243697479
"8722198954.jpg",0,10,74,28,0,112,3.16071428571429,0.562388270041763,58.5384615384615
"8723579314.jpg",0,1,59,61,0,121,3.49586776859504,0.518394427409425,68.925
"8724425373.jpg",0,8,64,26,4,102,3.25490196078431,0.655309986504066,60.6702586206897
"8724561762.jpg",1,2,41,55,4,103,3.57281553398058,0.650820624478455,68.2635135135135
"8724954192.jpg",4,38,54,10,0,106,2.66037735849057,0.702197807605727,43.6483050847458
"8725613522.jpg",5,71,29,3,0,108,2.27777777777778,0.593316881706884,33.1680672268908
"8726161561.jpg",0,2,36,64,5,107,3.67289719626168,0.595196193031854,74.368932038835
"8726378587.jpg",0,0,24,66,7,97,3.82474226804124,0.540260532797806,75.765625
"8727344040.jpg",0,2,20,76,5,103,3.81553398058252,0.537743521041616,77.6808035714286
"8727585507.jpg",0,7,77,21,0,105,3.13333333333333,0.501280411827603,58.375
"8728469348.jpg",0,2,61,47,0,110,3.40909090909091,0.529764610103801,66.9294871794872
"8728473663.jpg",0,6,45,54,0,105,3.45714285714286,0.604924843211176,66.8526785714286
"8728715575.jpg",0,0,18,72,12,102,3.94117647058824,0.541788921884279,79.675
"8728752853.jpg",0,1,57,48,0,106,3.44339622641509,0.517874569834108,67.222972972973
"8729158424.jpg",0,5,43,55,6,109,3.56880733944954,0.671744170839424,70.5357142857143
"8729980010.jpg",0,4,41,53,3,101,3.54455445544554,0.624896030956311,68.0023364485981
"8730092034.jpg",0,1,17,85,6,109,3.88073394495413,0.485431664378742,79.3050847457627
"8730533258.jpg",0,1,32,71,8,112,3.76785714285714,0.584825266229659,74.975
"8730747598.jpg",2,39,58,3,0,102,2.6078431372549,0.5828720754493,43.6880733944954
"8730988705.jpg",0,0,25,69,8,102,3.83333333333333,0.546516118688917,77.0128205128205
"8731143356.jpg",0,8,48,46,1,103,3.38834951456311,0.645239121334674,65.4285714285714
"8731562113.jpg",0,6,61,43,0,110,3.33636363636364,0.579105173811527,61.3625
"8731687035.jpg",2,38,62,5,0,107,2.65420560747664,0.60035844227723,44.1081081081081
"8731705218.jpg",0,0,32,69,6,107,3.75700934579439,0.546707494751528,73.031512605042
"8732282616.jpg",0,5,54,42,0,101,3.36633663366337,0.578321230411399,66.8413461538462
"8732397324.jpg",10,74,21,0,0,105,2.1047619047619,0.535720390685605,28.7894736842105
"8732646741.jpg",0,17,73,18,0,108,3.00925925925926,0.571853362851923,54.313025210084
"8732953050.jpg",0,1,32,76,2,111,3.71171171171171,0.511457585327329,73.3461538461538
"8733519611.jpg",1,0,40,60,1,102,3.58823529411765,0.569052385423217,70.7844036697248
"8733562507.jpg",0,2,37,65,4,108,3.65740740740741,0.58264682938731,74.4397321428571
"8733728144.jpg",0,1,38,60,5,104,3.66346153846154,0.584767432371758,74.0389908256881
"8734847489.jpg",0,9,60,43,1,113,3.31858407079646,0.630553706867222,62.2857142857143
"8735700380.jpg",0,1,32,69,1,103,3.67961165048544,0.509008883797232,73.716814159292
"8736095629.jpg",0,1,44,60,0,105,3.56190476190476,0.517460692000434,68.3141592920354
"8736395579.jpg",0,1,50,52,2,105,3.52380952380952,0.556348640264187,69.3349056603774
"873682751.jpg",4,52,47,7,0,110,2.51818181818182,0.673642953666248,38.675
"8736879292.jpg",0,5,75,26,1,107,3.21495327102804,0.532492136237047,60.6152173913043
"8737972385.jpg",0,1,48,50,3,102,3.53921568627451,0.574569466497057,68.5277777777778
"8742280365.jpg",0,17,84,23,0,124,3.04838709677419,0.568192666133956,57.9385245901639
"8742323176.jpg",1,18,62,27,0,108,3.06481481481481,0.673575314054563,55.6995798319328
"8743944148.jpg",2,63,38,1,0,104,2.36538461538462,0.540723935947584,35.9324324324324
"8745291792.jpg",0,1,20,80,2,103,3.80582524271845,0.465648449975302,74.4539473684211
"8745953241.jpg",0,14,60,24,2,100,3.14,0.666969628130461,58.598623853211
"8746191422.jpg",0,1,16,85,2,104,3.84615384615385,0.435538518783686,80.7759433962264
"8746457937.jpg",3,28,63,10,1,105,2.79047619047619,0.689135998848141,47.287610619469
"8746542465.jpg",0,2,38,83,4,127,3.7007874015748,0.55370269700031,76.8869047619048
"8746881284.jpg",0,43,54,6,0,103,2.64077669902913,0.591680374301949,44.3486842105263
"8746934807.jpg",0,34,64,9,0,107,2.76635514018692,0.5920772395484,47.0042372881356
"8748661037.jpg",0,12,75,19,0,106,3.06603773584906,0.539291738778581,55.8296460176991
"8749825399.jpg",0,0,24,70,8,102,3.84313725490196,0.540353716921064,77.2178899082569
"8749890133.jpg",0,1,30,75,4,110,3.74545454545455,0.532199239030855,71.2625
"8750299747.jpg",5,64,39,2,0,110,2.34545454545455,0.597185503372164,35.375
"8750929874.jpg",1,10,45,46,0,102,3.33333333333333,0.694152854073569,64.0586956521739
"8751039261.jpg",0,0,36,75,2,113,3.69911504424779,0.497941400600878,73.4474789915966
"8751065602.jpg",0,3,48,55,0,106,3.49056603773585,0.556267887140855,70.5357142857143
"8751106130.jpg",0,2,59,71,0,132,3.52272727272727,0.53096353565672,71.3454198473282
"87511338.jpg",4,78,23,1,0,106,2.19811320754717,0.505584269661014,32.9
"8751458979.jpg",0,3,47,51,2,103,3.50485436893204,0.592002027152183,69.9203539823009
"8751762111.jpg",0,0,32,68,0,100,3.68,0.468826172262151,76.0509708737864
"8751989930.jpg",14,88,7,0,0,109,1.93577981651376,0.436213279422361,25.260593220339
"8754025405.jpg",0,0,22,72,11,105,3.8952380952381,0.553377905438143,77.8326086956522
"8754056878.jpg",0,0,41,63,2,106,3.63207547169811,0.522365894352903,75.0290178571429
"8755395714.jpg",0,0,31,72,2,105,3.72380952380952,0.49019694031383,73.1695652173913
"8755673278.jpg",0,0,59,46,0,105,3.43809523809524,0.498532645405292,64.8445945945946
"8755824682.jpg",0,0,27,69,3,99,3.75757575757576,0.496742636335202,74.3247663551402
"8756419280.jpg",0,7,66,28,3,104,3.25961538461538,0.623102047271884,61.6227678571429
"8757692529.jpg",1,8,72,24,1,106,3.15094339622642,0.598290466646247,56.7923728813559
"8762864048.jpg",0,13,64,36,0,113,3.20353982300885,0.629048204424156,60.2058823529412
"8768474112.jpg",20,70,22,2,0,114,2.05263157894737,0.663086177652607,27.2435344827586
"8771756230.jpg",25,68,9,0,0,102,1.84313725490196,0.55837632434446,22.1725663716814
"8772955624.jpg",0,0,17,85,7,109,3.90825688073395,0.462306704425587,77.2586956521739
"8774523686.jpg",0,1,30,69,6,106,3.75471698113208,0.565875987671487,72.5233050847458
"8776151757.jpg",0,3,65,37,2,107,3.35514018691589,0.570539903993596,64.7702702702703
"8779946210.jpg",0,0,26,70,4,100,3.78,0.504124403437697,76.6880733944954
"8781313469.jpg",0,0,31,73,3,107,3.73831775700935,0.501628453763451,77.2
"8781992421.jpg",0,3,33,62,5,103,3.66990291262136,0.616574177185378,71.7142857142857
"8787599446.jpg",0,4,52,45,1,102,3.42156862745098,0.587599151267575,66.697247706422
"8794313763.jpg",0,2,53,61,4,120,3.55833333333333,0.591193541846973,71.1949152542373
"8795821243.jpg",0,0,22,79,2,103,3.80582524271845,0.444095300388494,77.7027027027027
"8797772647.jpg",0,4,56,38,1,99,3.36363636363636,0.579488610839561,65.35
"8800590382.jpg",0,15,98,25,0,138,3.07246376811594,0.535426443855604,57.2808219178082
"8802725309.jpg",3,54,53,3,0,113,2.49557522123894,0.599462464649279,40.7247899159664
"8812917559.jpg",1,19,68,20,2,110,3.02727272727273,0.683475883068022,53.9736842105263
"8814635311.jpg",0,6,60,32,4,102,3.33333333333333,0.64995557096191,62.0789473684211
"8816701721.jpg",1,22,69,10,0,102,2.86274509803922,0.580870219248152,49.7176724137931
"8816975901.jpg",0,3,75,30,1,109,3.26605504587156,0.520722465264161,61.1071428571429
"8817313814.jpg",0,0,39,70,2,111,3.66666666666667,0.51049589675732,72.3135593220339
"8819567462.jpg",2,43,59,1,0,105,2.56190476190476,0.553377905438143,40.1875
"8821348628.jpg",0,10,44,48,2,104,3.40384615384615,0.690001136473396,69.1029411764706
"8826596290.jpg",8,62,33,2,0,105,2.27619047619048,0.627805060619293,33.1597222222222
"8830329798.jpg",1,38,57,6,0,102,2.66666666666667,0.602524940255889,46
"8832426254.jpg",0,8,68,32,1,109,3.23853211009174,0.591593619415785,61.6703539823009
"8836006786.jpg",0,0,42,62,0,104,3.59615384615385,0.493043466234686,73.785046728972
"8840187174.jpg",72,33,2,0,0,107,1.34579439252336,0.515839739233062,9.11016949152542
"8841313273.jpg",0,4,21,74,3,102,3.74509803921569,0.574822822634818,79.5306603773585
"8841877925.jpg",0,3,27,67,6,103,3.7378640776699,0.609743839633862,74.7521551724138
"8844582694.jpg",1,26,64,15,0,106,2.87735849056604,0.64295197463662,49.035046728972
"8844729886.jpg",0,2,39,60,1,102,3.58823529411765,0.551378850843804,69.5972222222222
"8848421856.jpg",0,15,63,30,0,108,3.13888888888889,0.633316936990578,56.1155462184874
"8850126806.jpg",1,30,71,6,0,108,2.75925925925926,0.561546102839651,48.4189189189189
"8850392186.jpg",3,30,71,4,0,108,2.7037037037037,0.5842042156589,46.8761682242991
"885060581.jpg",1,10,62,27,1,101,3.16831683168317,0.649142618084702,56.9977876106195
"8851705236.jpg",9,72,20,1,0,102,2.12745098039216,0.557070993350661,29.2
"8853329035.jpg",0,3,66,41,1,111,3.36036036036036,0.552560861194046,66.2826086956522
"8856278655.jpg",0,7,67,28,0,102,3.20588235294118,0.551114717247404,59.5602678571429
"8858418581.jpg",0,0,9,79,11,99,4.02020202020202,0.451297403633667,79.6305309734513
"8859569385.jpg",0,0,26,78,2,106,3.77358490566038,0.463588875085807,79.0066964285714
"8860399629.jpg",3,50,62,3,0,118,2.55084745762712,0.593374496225831,42.6730769230769
"8862366940.jpg",0,11,60,35,0,106,3.22641509433962,0.621565134585182,61.5491071428571
"8863356627.jpg",0,2,66,28,0,96,3.27083333333333,0.491596040125088,62.0817307692308
"8864018641.jpg",0,6,54,50,0,110,3.4,0.593543240195398,66.2887931034483
"8866395362.jpg",0,5,48,49,2,104,3.46153846153846,0.62197738108714,69.6691176470588
"8867729088.jpg",0,2,56,47,1,106,3.44339622641509,0.553434104637671,67
"8871477031.jpg",43,65,3,0,0,111,1.63963963963964,0.535856032103481,15.8220338983051
"8872523602.jpg",0,2,57,45,0,104,3.41346153846154,0.53263545017037,68.4513888888889
"8877114673.jpg",3,72,34,2,0,111,2.31531531531532,0.555664744934667,36.4679487179487
"8877350801.jpg",3,38,51,8,1,101,2.66336633663366,0.711016564121713,44.3692660550459
"8878353214.jpg",0,5,73,47,0,125,3.336,0.552764314239599,66.142
"8880556755.jpg",2,48,54,5,0,109,2.56880733944954,0.614138548686427,41.49375
"8880877335.jpg",0,0,38,60,5,103,3.67961165048544,0.563838250916226,72.025
"8882534571.jpg",4,35,64,10,0,113,2.70796460176991,0.677197691240521,44.2775423728814
"8883794004.jpg",0,5,78,24,0,107,3.17757009345794,0.491687201381957,59.9399038461538
"8883829297.jpg",0,11,58,35,1,105,3.24761904761905,0.647197395594628,60.4717391304348
"8884240572.jpg",0,2,43,56,2,103,3.56310679611651,0.5717174489413,71.7683486238532
"8885623781.jpg",0,3,31,65,1,100,3.64,0.559942276967326,74.125
"8886401995.jpg",0,2,34,60,1,97,3.61855670103093,0.548545405464005,72.9150943396226
"8890374321.jpg",0,3,32,70,1,106,3.65094339622642,0.552784343210652,74.6092233009709
"8891540889.jpg",0,2,45,57,1,105,3.54285714285714,0.555195243352965,69.3469827586207
"8891817478.jpg",0,57,47,3,0,107,2.49532710280374,0.555823912928399,40.1701680672269
"8891882667.jpg",0,0,30,69,3,102,3.73529411764706,0.505934496371339,76.7572115384615
"8892359151.jpg",1,14,72,19,0,106,3.02830188679245,0.592935348114805,55.1824324324324
"8893986467.jpg",1,3,36,57,3,100,3.58,0.654124443725189,68.1891891891892
"8894308933.jpg",0,1,14,79,12,106,3.9622641509434,0.533176077445105,79.1578947368421
"8895109111.jpg",2,32,57,13,0,104,2.77884615384615,0.682040496039268,48.4953271028037
"8896534535.jpg",0,4,62,38,1,105,3.34285714285714,0.568881686843911,63.6440677966102
"8897373737.jpg",0,3,30,67,4,104,3.69230769230769,0.592459462820778,72.0338983050847
"8899231880.jpg",3,45,56,0,0,104,2.50961538461538,0.557302663192804,41.0389908256881
"8901015763.jpg",0,36,68,3,0,107,2.69158878504673,0.521449629494023,46.0803571428571
"8902141836.jpg",2,45,57,3,0,107,2.57009345794393,0.584584185920639,43.2162162162162
"8902189112.jpg",0,3,33,63,1,100,3.62,0.564613034553648,71.6169724770642
"890231750.jpg",0,29,67,12,0,108,2.84259259259259,0.598472151883554,49.9551886792453
"8902840150.jpg",1,8,58,33,0,100,3.23,0.633333333333333,58.6756756756757
"8904864157.jpg",0,2,65,66,0,133,3.4812030075188,0.530886961651435,68.5656934306569
"8904883731.jpg",1,1,40,64,2,108,3.60185185185185,0.594991790013488,70.1890756302521
"8905578199.jpg",0,0,27,70,6,103,3.79611650485437,0.53061605522096,77.1482300884956
"8906347187.jpg",0,1,47,69,1,118,3.59322033898305,0.526840090492657,71.9358974358974
"8906425755.jpg",0,48,50,5,0,103,2.58252427184466,0.586185272268683,42.25
"8909034593.jpg",0,0,23,73,10,106,3.87735849056604,0.546901752971605,78.8156779661017
"8909361776.jpg",0,2,48,56,0,106,3.50943396226415,0.538875071993994,68.4864864864865
"8910371075.jpg",0,0,30,67,1,98,3.70408163265306,0.480746491556307,74.795871559633
"8911365579.jpg",1,30,61,9,0,101,2.77227722772277,0.61451099451209,48.85
"8911411937.jpg",0,1,31,68,6,106,3.74528301886792,0.57006801189427,75.4879807692308
"8911730034.jpg",0,14,80,36,0,130,3.16923076923077,0.598945605047408,60.8287401574803
"8914830252.jpg",0,4,45,58,1,108,3.51851851851852,0.587748459794076,67.9407894736842
"8916793773.jpg",0,1,26,72,6,105,3.79047619047619,0.549391938265845,73.6148648648649
"8916833328.jpg",0,11,74,20,0,105,3.08571428571429,0.53912831557927,56.5452586206897
"8918860577.jpg",0,56,50,3,0,109,2.51376146788991,0.554688416024618,40.1875
"8918997719.jpg",0,11,59,33,0,103,3.21359223300971,0.620728310952154,60.6081081081081
"8919875155.jpg",0,21,72,13,0,106,2.92452830188679,0.563967462883609,49.9054054054054
"8921955477.jpg",0,1,45,63,0,109,3.56880733944954,0.515805240252132,70.4663865546218
"8923165653.jpg",0,11,68,24,0,103,3.12621359223301,0.571883912025026,57.1438053097345
"8924220861.jpg",0,0,35,66,4,105,3.7047619047619,0.535720390685605,74.6810344827586
"8925642155.jpg",0,2,52,53,0,107,3.47663551401869,0.538092269434313,68.1674528301887
"8925668401.jpg",0,0,27,74,8,109,3.8256880733945,0.54167156745215,73.6
"8925875609.jpg",0,0,24,73,5,102,3.81372549019608,0.502082636030388,76.8066037735849
"8928315797.jpg",0,3,42,54,3,102,3.55882352941176,0.606459117846457,69.6971153846154
"8929337311.jpg",0,8,61,31,1,101,3.24752475247525,0.606727955414276,59.6582568807339
"8929900709.jpg",0,4,60,37,2,103,3.35922330097087,0.591680374301949,62.3175675675676
"8930021210.jpg",1,13,59,30,0,103,3.14563106796116,0.662848384022915,55.5089285714286
"8930347179.jpg",0,0,30,73,4,107,3.75700934579439,0.511031540866989,75.0290178571429
"8930562482.jpg",0,3,62,40,1,106,3.36792452830189,0.557639099847156,65.535046728972
"8930722689.jpg",0,12,66,26,1,105,3.15238095238095,0.616768133420437,58.1659292035398
"8930797229.jpg",0,0,13,85,3,101,3.9009900990099,0.387426134767636,81.1
"8933281660.jpg",0,16,89,30,0,135,3.1037037037037,0.576583789901542,58.8670212765957
"8933319583.jpg",4,89,51,0,0,144,2.32638888888889,0.526631479158543,36.2916666666667
"8933855427.jpg",0,16,63,25,1,105,3.1047619047619,0.649316349410456,59.8935643564356
"8935735197.jpg",0,8,52,42,5,107,3.41121495327103,0.699774505837111,64.1575630252101
"8935938604.jpg",0,6,52,50,0,108,3.40740740740741,0.596516946936129,65.6134453781513
"8936501287.jpg",14,73,17,3,0,107,2.08411214953271,0.631283438525562,28.5924369747899
"8937929358.jpg",0,56,37,2,0,95,2.43157894736842,0.538963378121674,38.0071428571429
"8938035476.jpg",0,2,42,53,4,101,3.58415841584158,0.604439024760534,71.2385321100917
"8938472188.jpg",21,100,25,0,0,146,2.02739726027397,0.562570522530312,27.0441176470588
"89393627.jpg",17,66,20,0,0,103,2.02912621359223,0.601571645523846,27.4138655462185
"8939389375.jpg",0,0,8,83,19,110,4.1,0.487457361108726,80.3375
"8939732555.jpg",37,71,5,0,0,113,1.71681415929204,0.542300433152809,17.7152173913043
"8940969671.jpg",0,0,23,74,10,107,3.8785046728972,0.544445024232861,77.3125
"8941443262.jpg",0,1,57,40,2,100,3.43,0.555141259664437,65.7133027522936
"8942422332.jpg",0,1,33,62,4,100,3.69,0.563090318750649,72.6009174311927
"8943413727.jpg",0,5,66,53,2,126,3.41269841269841,0.596923328675853,67.6707317073171
"8944011983.jpg",16,68,19,2,0,105,2.06666666666667,0.639511031159244,29.4344660194175
"8946027655.jpg",0,5,65,70,1,141,3.47517730496454,0.580413156832367,70.4234693877551
"8948115296.jpg",0,18,74,13,0,105,2.95238095238095,0.543863535997354,53.1314655172414
"8950318830.jpg",0,0,20,66,15,101,3.95049504950495,0.589512300529215,80.3783783783784
"8960852902.jpg",0,4,57,40,0,101,3.35643564356436,0.558285919862602,63.25
"8962032549.jpg",0,3,52,51,0,106,3.45283018867925,0.554326283006989,68.6019417475728
"8965909066.jpg",0,5,53,59,3,120,3.5,0.621735170188031,68.7331932773109
"8968242975.jpg",16,71,23,1,0,111,2.08108108108108,0.619899333985111,27.6152173913043
"8970460328.jpg",1,10,59,39,0,109,3.24770642201835,0.654839014748017,57.7875
"8970878075.jpg",0,4,62,35,1,102,3.32352941176471,0.565716311123285,63.025
"8971376273.jpg",0,0,30,73,4,107,3.75700934579439,0.511031540866989,79.0405405405405
"8972898508.jpg",23,60,23,3,0,109,2.05504587155963,0.730738621575117,28.01875
"8973350530.jpg",0,4,42,49,5,100,3.55,0.657128740672771,72.4
"8974114251.jpg",0,5,73,29,0,107,3.22429906542056,0.519586396014798,60.2752100840336
"8975077146.jpg",0,1,34,76,0,111,3.67567567567568,0.489195297720695,71.1602564102564
"8975567714.jpg",0,1,25,71,7,104,3.80769230769231,0.558724676052145,74.6607142857143
"8975620960.jpg",2,17,73,12,0,104,2.91346153846154,0.593010697902438,50.8683035714286
"8975860650.jpg",0,0,9,81,20,110,4.1,0.505928159675159,84.4956896551724
"8977825134.jpg",0,38,62,9,0,109,2.73394495412844,0.603112326539076,46.375
"8978679476.jpg",0,12,56,34,4,106,3.28301886792453,0.713872297251734,60.8474576271186
"898061275.jpg",0,2,43,86,4,135,3.68148148148148,0.555190593223407,75.4347014925373
"8984346211.jpg",0,1,37,60,0,98,3.60204081632653,0.512519467437501,69.0442477876106
"8984699375.jpg",0,12,77,16,0,105,3.03809523809524,0.517460692000434,55.140625
"8985407469.jpg",0,10,48,50,0,108,3.37037037037037,0.649839557374613,64.472972972973
"8985551582.jpg",5,53,43,10,0,111,2.52252252252252,0.724215523506728,42.9673913043478
"8986202022.jpg",0,2,45,60,1,108,3.55555555555556,0.552535926574701,68.0131578947368
"8986260148.jpg",0,2,36,68,1,107,3.63551401869159,0.538910910208028,74.8644859813084
"8986464809.jpg",0,0,11,75,15,101,4.03960396039604,0.508346182816551,81.4375
"8986471316.jpg",1,38,66,3,0,108,2.65740740740741,0.549630921823901,45.1195652173913
"8987485650.jpg",3,34,57,9,0,103,2.69902912621359,0.669136866569292,45.859375
"8988143845.jpg",0,3,62,37,1,103,3.3495145631068,0.554990511561316,63.9336283185841
"8988227086.jpg",0,10,71,21,0,102,3.1078431372549,0.543309673108284,55.4934210526316
"8988404310.jpg",4,31,65,7,0,107,2.70093457943925,0.647417996133495,44.7172897196262
"8988892733.jpg",0,0,25,80,1,106,3.77358490566038,0.442568668181227,77.5955882352941
"899304128.jpg",0,4,69,35,0,108,3.28703703703704,0.53040146892859,63.9929906542056
"8994347098.jpg",0,3,37,57,15,112,3.75,0.716598572084479,73.2923728813559
"8995226934.jpg",0,0,15,80,6,101,3.91089108910891,0.449422071131138,77.4021739130435
"8997198808.jpg",0,0,29,74,2,105,3.74285714285714,0.480956007675007,73.7434782608696
"8998348605.jpg",0,4,45,51,0,100,3.47,0.576562435842158,67.9082568807339
"8999325582.jpg",0,0,35,66,4,105,3.7047619047619,0.535720390685605,73.1327433628319
"9000701354.jpg",0,2,30,70,5,107,3.72897196261682,0.575770090678299,75.7126168224299
"9002014430.jpg",0,4,49,53,2,108,3.49074074074074,0.603655072185389,68.8415178571429
"9002438378.jpg",0,3,55,67,1,126,3.52380952380952,0.561630280013971,71.884
"9003236001.jpg",0,13,40,57,1,111,3.41441441441441,0.706701280193194,64.3205128205128
"9004727133.jpg",0,0,23,77,5,105,3.82857142857143,0.489449118459151,75.9129464285714
"9005613417.jpg",0,7,59,37,5,108,3.37037037037037,0.677993088385809,63.7995689655172
"9005619499.jpg",0,4,38,58,7,107,3.63551401869159,0.664355601592746,70.1890756302521
"9007177518.jpg",0,3,71,55,2,131,3.42748091603053,0.568811640462208,67.966796875
"9016164225.jpg",0,0,47,56,3,106,3.58490566037736,0.549769207478433,69.5826086956522
"9016868192.jpg",0,2,53,54,1,110,3.49090909090909,0.554306816398272,68.1785714285714
"9017247850.jpg",0,6,74,19,0,99,3.13131313131313,0.487527385865313,56.8224299065421
"9018209858.jpg",1,47,58,5,0,111,2.6036036036036,0.592057725675758,43.4487179487179
"9019428727.jpg",0,1,50,50,0,101,3.48514851485149,0.521801904675301,66.925
"9021392547.jpg",1,42,51,8,0,102,2.64705882352941,0.639415866217659,44.4934210526316
"9021755853.jpg",0,0,82,51,0,133,3.38345864661654,0.488066756972641,66
"9027689601.jpg",0,35,64,10,0,109,2.77064220183486,0.602971461810648,48.7521186440678
"9028566654.jpg",0,1,41,56,2,100,3.59,0.552222323842033,71.0114678899083
"9029384629.jpg",14,111,31,0,0,156,2.10897435897436,0.527608334067048,30.2641509433962
"9029712750.jpg",0,1,37,62,4,104,3.66346153846154,0.567922067043096,71.2326086956522
"9032729328.jpg",0,20,74,18,0,112,2.98214285714286,0.584825266229659,54.2055084745763
"9034047597.jpg",0,3,56,43,2,104,3.42307692307692,0.586122815790719,65.7909482758621
"9034707954.jpg",0,19,64,26,0,109,3.06422018348624,0.642264935495184,57.2302631578947
"9034716133.jpg",0,1,25,80,1,107,3.75700934579439,0.472670484274494,77.2546728971963
"9034987420.jpg",36,67,2,0,0,105,1.67619047619048,0.509434794182543,17.6633663366337
"9036022986.jpg",0,3,54,46,1,104,3.43269230769231,0.57054603512134,68.4558823529412
"9036180286.jpg",0,1,42,63,2,108,3.61111111111111,0.544013010656216,72.3035714285714
"9036594264.jpg",0,15,67,24,1,107,3.10280373831776,0.628483941633797,58.1953781512605
"9037387298.jpg",0,2,42,64,1,109,3.58715596330275,0.547908636177939,71.7039473684211
"9037452749.jpg",4,62,37,0,0,103,2.32038834951456,0.546173717839859,34.0723684210526
"9038457719.jpg",0,8,72,23,1,104,3.16346153846154,0.559309159920009,58.9071428571429
"9038497618.jpg",0,4,55,40,1,100,3.38,0.582228390745332,64.4556074766355
"9041103039.jpg",0,25,54,27,0,106,3.0188679245283,0.703476158941766,55.45
"9042624878.jpg",0,0,13,89,4,106,3.91509433962264,0.393226568116165,78.3081896551724
"9046007138.jpg",0,2,43,85,4,134,3.67910447761194,0.556583918358489,75.6842105263158
"9047016405.jpg",0,5,68,31,1,105,3.26666666666667,0.559303596287842,62.1814159292035
"904761358.jpg",2,25,67,7,0,101,2.78217821782178,0.593362627674504,46.7155963302752
"9048453025.jpg",0,0,12,83,14,109,4.01834862385321,0.490306997105003,79.03125
"9049275396.jpg",0,3,41,56,2,102,3.55882352941176,0.589907349861894,68.8
"9050414795.jpg",0,1,36,64,4,105,3.67619047619048,0.563219421909541,72.5239130434783
"9050865219.jpg",0,3,31,73,0,107,3.65420560747664,0.53381510010521,75.0972222222222
"9052518863.jpg",0,20,72,16,0,108,2.96296296296296,0.578847161173496,52.975
"9053743376.jpg",0,2,48,52,0,102,3.49019607843137,0.540353716921064,68.1785714285714
"9054377711.jpg",0,0,41,63,0,104,3.60576923076923,0.491051363274922,72.2146226415094
"9055579014.jpg",0,4,36,61,2,103,3.59223300970874,0.601255112144644,68.7678571428571
"9055879747.jpg",0,14,71,12,0,97,2.97938144329897,0.520003634668767,54.2844036697248
"9058001335.jpg",0,10,75,23,1,109,3.13761467889908,0.568752532078318,58.0870535714286
"9058722713.jpg",0,9,76,21,1,107,3.13084112149533,0.550884574245936,55.3940677966102
"9058863840.jpg",1,42,57,9,0,109,2.67889908256881,0.636552257680711,44.1218487394958
"9059681059.jpg",0,3,42,51,0,96,3.5,0.561951486949016,69.7233009708738
"9060697338.jpg",0,10,74,22,0,106,3.11320754716981,0.540207274452195,57.1891891891892
"9060994605.jpg",0,2,51,57,4,114,3.55263157894737,0.596332526811818,69.1491596638655
"9061831747.jpg",3,52,42,3,0,100,2.45,0.609271795844942,38.5490654205607
"9062040259.jpg",1,10,58,34,2,105,3.24761904761905,0.69033091815214,59.2435897435897
"9063333592.jpg",2,39,61,3,0,105,2.61904761904762,0.57814278880661,44.3125
"9063924933.jpg",0,1,40,66,0,107,3.60747663551402,0.509476411693017,73.9358407079646
"9064490305.jpg",0,1,44,60,0,105,3.56190476190476,0.517460692000434,69.9791666666667
"9064913927.jpg",1,41,63,6,0,111,2.66666666666667,0.592887132188877,44.0525210084034
"9065372715.jpg",0,3,26,99,10,138,3.84057971014493,0.569881237616029,80.75
"9065857613.jpg",0,1,64,45,1,111,3.41441441441441,0.530325259859344,66.7155172413793
"9066761491.jpg",0,3,53,43,1,100,3.42,0.571724310195646,63.9336283185841
"9068148685.jpg",0,1,68,35,0,104,3.32692307692308,0.491526405819286,65.2378640776699
"9069424514.jpg",0,8,72,18,0,98,3.10204081632653,0.507465826757982,56.8224299065421
"9069849690.jpg",0,4,62,39,1,106,3.34905660377358,0.569752708766225,63.6852678571429
"9070049178.jpg",0,0,36,61,3,100,3.67,0.532859638121892,73.825
"9071921017.jpg",0,9,63,30,1,103,3.22330097087379,0.60927534641092,61.5743243243243
"9071963923.jpg",0,0,18,82,5,105,3.87619047619048,0.453516984993567,77.1869565217391
"9072067933.jpg",0,0,29,74,9,112,3.82142857142857,0.556926664981405,73.5021186440678
"9072958869.jpg",0,0,40,62,1,103,3.62135922330097,0.507135454975797,71.8714285714286
"9074183822.jpg",4,54,48,4,0,110,2.47272727272727,0.63113543973229,39.6375
"9076304306.jpg",3,66,36,1,0,106,2.33018867924528,0.547230222522522,34.1386554621849
"9076672562.jpg",0,5,77,25,0,107,3.18691588785047,0.497746641649642,61.3513513513514
"9079493649.jpg",0,0,29,73,2,104,3.74038461538462,0.482614085464951,76.1418918918919
"9080769054.jpg",2,38,61,4,0,105,2.63809523809524,0.590368358344854,43.5301724137931
"9081876401.jpg",0,1,43,60,3,107,3.60747663551402,0.562289949809258,70.813025210084
"9083308350.jpg",3,24,82,19,0,128,2.9140625,0.652401303363138,51.381679389313
"90834437.jpg",0,0,11,65,23,99,4.12121212121212,0.576278122917761,83.6386554621849
"9090441923.jpg",0,1,42,52,1,96,3.55208333333333,0.540366185132904,72.2642857142857
"9093638609.jpg",12,84,14,0,0,110,2.01818181818182,0.488055835687842,28.5466101694915
"9094228395.jpg",0,8,54,40,1,103,3.33009708737864,0.63227490785977,61.3053097345133
"9096574214.jpg",0,2,66,37,1,106,3.34905660377358,0.535278349133619,63.2563025210084
"9098295579.jpg",0,2,30,70,5,107,3.72897196261682,0.575770090678299,75.8340707964602
"9101418859.jpg",0,5,37,55,5,102,3.58823529411765,0.66530631933266,72.5808823529412
"9101482614.jpg",0,2,52,55,0,109,3.48623853211009,0.537736664505389,68.546875
"9102604497.jpg",0,50,52,3,0,105,2.55238095238095,0.554369919210997,41.8608490566038
"9102888066.jpg",0,0,16,69,22,107,4.05607476635514,0.59608432512451,82.2521008403361
"9106148302.jpg",0,1,49,79,0,129,3.6046511627907,0.506498467593357,73.4311023622047
"910637798.jpg",2,29,64,10,0,105,2.78095238095238,0.635200640333315,48.0691964285714
"9108357145.jpg",1,40,55,6,0,102,2.64705882352941,0.607658365839589,45.5945945945946
"9109124057.jpg",0,2,59,42,1,104,3.40384615384615,0.548948346186761,65.9331896551724
"9109271301.jpg",0,1,42,60,2,105,3.6,0.547722557505166,71.7803738317757
"9109755543.jpg",20,63,23,1,0,107,2.04672897196262,0.664222876468738,28.3151260504202
"9111310939.jpg",0,0,34,69,4,107,3.7196261682243,0.528336523035191,74.6760869565217
"9111487897.jpg",0,1,32,58,9,100,3.75,0.625630994607957,75.1782608695652
"9112120569.jpg",1,4,51,48,1,105,3.41904761904762,0.632165879839856,64.421875
"9112424025.jpg",0,11,53,39,3,106,3.32075471698113,0.697576345865362,62.1758474576271
"9113486865.jpg",0,0,21,76,3,100,3.82,0.45792681696639,76.6378504672897
"9115676276.jpg",0,2,44,54,1,101,3.53465346534653,0.557931114666382,70.6330275229358
"9118228667.jpg",0,0,54,59,1,114,3.53508771929825,0.518333349557771,68.2801724137931
"9118386163.jpg",0,9,96,45,1,151,3.25165562913907,0.568255142770189,64.1971153846154
"9119225606.jpg",1,0,29,79,2,111,3.72972972972973,0.538448038278802,72.6410256410256
"9119961649.jpg",0,0,6,88,10,104,4.03846153846154,0.392232270276368,81.1025641025641
"9119996222.jpg",1,7,80,40,0,128,3.2421875,0.585199256058429,62.248
"9121896285.jpg",0,6,75,21,2,104,3.18269230769231,0.553267839716467,57.6351351351351
"9122090851.jpg",5,35,46,10,1,97,2.65979381443299,0.775760351984645,43.7572115384615
"9122758028.jpg",0,0,43,78,5,126,3.6984126984127,0.540663906986087,75.9153225806452
"9122759800.jpg",0,1,36,61,3,101,3.65346534653465,0.555619358272486,74.8080357142857
"9125517985.jpg",1,39,54,10,1,105,2.72380952380952,0.686339763573604,47.0558252427184
"9130413555.jpg",0,31,67,10,0,108,2.80555555555556,0.587380265521398,47.54375
"9130643186.jpg",0,0,31,101,1,133,3.77443609022556,0.437218157760525,78.25
"9130908149.jpg",0,4,67,37,1,109,3.32110091743119,0.55911196031369,63.5336134453782
"9131467707.jpg",0,5,42,51,6,104,3.55769230769231,0.680190194374175,68.5646551724138
"9131531714.jpg",0,0,11,77,17,105,4.05714285714286,0.515687954032345,81.7782608695652
"9131687822.jpg",0,1,28,74,2,105,3.73333333333333,0.505102172959299,73.9586956521739
"9132059359.jpg",0,16,72,20,0,108,3.03703703703704,0.578847161173496,55.2142857142857
"9132353816.jpg",0,5,54,39,1,99,3.36363636363636,0.596837677562393,62.7302631578947
"9135317445.jpg",14,78,15,0,0,107,2.00934579439252,0.522969155676269,25.8193277310924
"91357025.jpg",0,5,53,45,0,103,3.38834951456311,0.58129351549086,64.5042016806723
"9136502604.jpg",0,0,36,68,3,107,3.69158878504673,0.521449629494023,73.031512605042
"9136754533.jpg",0,6,62,30,2,100,3.28,0.604361253930565,64.5970873786408
"9138793182.jpg",33,68,3,0,0,104,1.71153846153846,0.515263659967445,18.6186440677966
"9139175955.jpg",1,7,70,31,2,111,3.23423423423423,0.631807723267925,61.9504310344828
"9139430214.jpg",2,12,74,14,0,102,2.98039215686275,0.5798666995481,52.2408256880734
"9140727598.jpg",0,1,44,57,2,104,3.57692307692308,0.552000909178717,71.8254716981132
"9141403760.jpg",0,7,57,36,2,102,3.32352941176471,0.631856681109741,62.125
"9141646333.jpg",16,48,41,8,0,113,2.36283185840708,0.813523497143476,35.1987179487179
"9141930190.jpg",0,8,68,30,2,108,3.24074074074074,0.609433172685521,59.50625
"9141979363.jpg",0,2,84,45,0,131,3.32824427480916,0.502956613690914,64.744140625
"9142684025.jpg",0,0,36,71,1,108,3.67592592592593,0.489682401434681,73.5861344537815
"9143291063.jpg",0,1,21,83,2,107,3.80373831775701,0.464580401808248,80.6981132075472
"9143757717.jpg",0,11,72,16,1,100,3.07,0.555141259664437,55.4954128440367
"9145211353.jpg",3,53,60,13,0,129,2.64341085271318,0.693704386027506,44.3912213740458
"9146239672.jpg",0,4,52,48,3,107,3.46728971962617,0.619155800939241,65.00625
"9150255535.jpg",0,3,18,68,12,101,3.88118811881188,0.636979257321167,78.4583333333333
"9154088552.jpg",0,1,45,55,4,105,3.59047619047619,0.583346415342582,69.7737068965517
"9154784652.jpg",0,2,40,64,2,108,3.61111111111111,0.560929357894812,73.5377358490566
"9154855025.jpg",0,46,54,7,0,107,2.63551401869159,0.604893930581596,44.545652173913
"9156115930.jpg",3,40,48,13,0,104,2.68269230769231,0.727603101517793,46.3013392857143
"9157119271.jpg",0,1,49,51,1,102,3.50980392156863,0.540353716921064,66.697247706422
"9159337218.jpg",0,3,31,67,9,110,3.74545454545455,0.641620134501325,74.7
"9162044260.jpg",0,2,27,71,5,105,3.75238095238095,0.568076247268466,77.6720183486239
"9162580665.jpg",0,2,40,56,3,101,3.59405940594059,0.586143631233543,69.9027777777778
"9163113923.jpg",0,2,55,52,2,111,3.48648648648649,0.569926069605282,68.1681415929203
"9164359125.jpg",0,4,64,34,0,102,3.29411764705882,0.537471809882315,63.6388888888889
"9166557972.jpg",0,1,45,60,1,107,3.57009345794393,0.533980240124661,67.9012605042017
"9166594378.jpg",0,5,56,45,0,106,3.37735849056604,0.576571644062338,65.2548076923077
"9166911645.jpg",0,5,72,35,0,112,3.26785714285714,0.536625137285366,61.4294871794872
"9170799378.jpg",0,0,34,72,1,107,3.69158878504673,0.483915144465277,74.2924107142857
"9175070760.jpg",0,7,78,23,0,108,3.14814814814815,0.50815434432866,59.4932432432432
"9176321809.jpg",0,1,52,48,0,101,3.46534653465347,0.520852309885318,69.1361607142857
"9178485751.jpg",0,12,92,35,0,139,3.16546762589928,0.559465613326724,60.4568965517241
"9179494563.jpg",0,2,72,38,0,112,3.32142857142857,0.506076334275034,61.8347826086957
"9183486925.jpg",14,71,23,0,0,108,2.08333333333333,0.582052443280648,27.5592105263158
"9184965477.jpg",0,5,70,36,1,112,3.29464285714286,0.563745403802887,60.5128205128205
"9185475668.jpg",0,2,63,41,0,106,3.36792452830189,0.522365894352903,64.9195652173913
"9185478102.jpg",3,40,49,9,0,101,2.63366336633663,0.688807262987662,42.7897196261682
"9186366283.jpg",0,9,59,33,1,102,3.25490196078431,0.624361448214029,61
"9188365433.jpg",9,77,19,0,0,105,2.0952380952381,0.509973783711732,28.3814655172414
"9188509301.jpg",0,1,32,72,1,106,3.68867924528302,0.504516884368361,74.21875
"9191266611.jpg",0,3,40,59,2,104,3.57692307692308,0.586122815790719,70.6586956521739
"9194756449.jpg",0,35,66,8,0,109,2.75229357798165,0.579846137042889,48.1927966101695
"9195069146.jpg",0,0,31,67,8,106,3.78301886792453,0.569121578460334,74.8305084745763
"9195323524.jpg",1,33,72,5,0,111,2.72972972972973,0.55507486711984,46.974358974359
"9195654667.jpg",2,15,52,26,4,99,3.15151515151515,0.80004638084475,58.9042056074766
"9197349207.jpg",0,12,62,26,1,101,3.15841584158416,0.628214505838997,58.5957943925234
"9198766588.jpg",0,0,39,64,6,109,3.69724770642202,0.569349647762013,72.7894736842105
"9198779264.jpg",1,39,64,6,0,110,2.68181818181818,0.589383415677403,45.0491071428571
"9200093125.jpg",0,3,57,38,0,98,3.35714285714286,0.542046522901578,62.875
"9200829224.jpg",0,0,38,63,1,102,3.63725490196078,0.503241289808191,73.8628318584071
"9201324227.jpg",0,4,42,54,3,103,3.54368932038835,0.622718565915461,67.9575892857143
"9201555712.jpg",0,0,21,88,3,112,3.83928571428571,0.436067013375743,76.3260869565217
"9202257544.jpg",0,6,56,35,3,100,3.35,0.641573192719398,63.2569444444444
"9202760715.jpg",0,1,44,59,1,105,3.57142857142857,0.534522483824849,70.5675675675676
"9202851539.jpg",0,2,58,46,0,106,3.41509433962264,0.532164037157572,65.8214285714286
"9205194326.jpg",0,17,83,41,1,142,3.1830985915493,0.637144764714956,61.5
"9206978293.jpg",0,0,36,73,1,110,3.68181818181818,0.487115045503931,74.271186440678
"9209619689.jpg",0,4,46,51,2,103,3.49514563106796,0.608337277576797,68.2090517241379
"9210757941.jpg",1,21,83,2,0,107,2.80373831775701,0.464580401808248,49.035046728972
"9211639075.jpg",0,0,18,80,5,103,3.87378640776699,0.457606982037554,79.8581081081081
"9211753203.jpg",11,69,25,0,0,105,2.13333333333333,0.572891899231546,30.1305309734513
"9211913717.jpg",50,56,4,1,0,111,1.6036036036036,0.607218386343965,15.4551282051282
"9211948856.jpg",0,13,67,19,1,100,3.08,0.59763845021193,56.2522935779817
"9212037816.jpg",0,8,34,57,6,105,3.58095238095238,0.717647765284833,71.2013888888889
"9212610328.jpg",0,1,32,73,3,109,3.71559633027523,0.528655582048325,72.9621848739496
"9213073517.jpg",1,8,59,34,0,102,3.23529411764706,0.632087075531658,59.5
"9213666869.jpg",0,4,66,27,0,97,3.23711340206186,0.515856809030064,59.6418918918919
"9214795039.jpg",8,65,27,1,0,101,2.20792079207921,0.588503724426079,31.8411214953271
"9215122110.jpg",1,39,58,4,0,102,2.63725490196078,0.576593198502975,44.35
"9215295027.jpg",0,3,47,57,0,107,3.50467289719626,0.555823912928399,67.8839285714286
"9215861266.jpg",0,9,78,19,0,106,3.09433962264151,0.507623818098411,56.275
"9216910965.jpg",0,6,57,40,0,103,3.33009708737864,0.583907552355093,64.8638392857143
"9217457237.jpg",0,0,33,67,2,102,3.69607843137255,0.503241289808191,74.0818584070797
"9220351854.jpg",0,4,65,37,1,107,3.32710280373832,0.562603465278173,60.6911764705882
"9220693447.jpg",0,8,54,38,1,101,3.31683168316832,0.631358742226746,64.8827433628319
"9220941622.jpg",0,0,27,70,6,103,3.79611650485437,0.53061605522096,77.3514150943396
"9221345159.jpg",0,5,63,38,2,108,3.34259259259259,0.598472151883554,62.7016806722689
"9222727460.jpg",2,30,60,10,0,102,2.76470588235294,0.647561619656527,48.4571428571429
"9223641047.jpg",0,27,70,13,0,110,2.87272727272727,0.592136404274997,48.575
"9224664940.jpg",7,58,37,4,0,106,2.35849056603774,0.664596966951837,37.4441747572816
"9225485643.jpg",0,9,60,38,0,107,3.27102803738318,0.607657013763768,64.1981132075472
"9225734576.jpg",0,2,55,53,0,110,3.46363636363636,0.536336070311266,67.5110619469027
"9225878690.jpg",1,20,70,21,0,112,2.99107142857143,0.636651370708465,55.051724137931
"9226793819.jpg",11,64,26,3,0,104,2.20192307692308,0.659211174561057,32.5441176470588
"9226799273.jpg",0,26,74,5,0,105,2.8,0.50763402928912,48.0818965517241
"9229803299.jpg",0,18,76,5,0,99,2.86868686868687,0.466127438264859,50.8855140186916
"9230199139.jpg",2,12,55,36,1,106,3.20754716981132,0.726596516475147,60.5434782608696
"9230996141.jpg",0,1,32,68,4,105,3.71428571428571,0.549725206078275,75.1052631578947
"92317233.jpg",18,64,17,1,0,100,2.01,0.627565441877087,26.025
"9232225621.jpg",0,3,52,50,0,105,3.44761904761905,0.554369919210997,65.8421052631579
"9232371989.jpg",7,71,52,4,0,134,2.3955223880597,0.637413201715002,36.570652173913
"9232503869.jpg",4,67,31,0,0,102,2.26470588235294,0.525139690764791,32.8100961538462
"9232794108.jpg",0,0,29,68,3,100,3.74,0.504925236990086,73.2453271028037
"92336148.jpg",0,8,39,57,2,106,3.5,0.665475125648692,66.10625
"9234807959.jpg",0,24,76,5,0,105,2.81904761904762,0.495769649925795,47.0150862068966
"9237243302.jpg",31,57,14,3,0,105,1.8952380952381,0.732800339107684,21.6986607142857
"9237285028.jpg",0,5,72,19,1,97,3.16494845360825,0.513979822300408,59.7617924528302
"9237488355.jpg",0,0,34,88,3,125,3.752,0.486196561869984,77.6168032786885
"9238616212.jpg",0,3,39,66,5,113,3.64601769911504,0.611210070011894,70.2004310344828
"9239005893.jpg",0,0,40,65,3,108,3.65740740740741,0.532355671933666,72.9137168141593
"9239862860.jpg",1,3,53,46,2,105,3.42857142857143,0.633323693776651,66.9276315789474
"9240332205.jpg",0,3,57,40,0,100,3.37,0.544114515576093,64.15
"9240392822.jpg",0,3,46,47,5,101,3.53465346534653,0.641316714824174,67.525
"9241531106.jpg",0,2,26,72,5,105,3.76190476190476,0.563706987508198,73.7118644067797
"9242083882.jpg",0,2,62,61,2,127,3.49606299212598,0.561658764223502,69.5535714285714
"9244573247.jpg",0,22,69,8,0,99,2.85858585858586,0.534715278234662,50.8173076923077
"9245144961.jpg",0,7,70,27,0,104,3.19230769230769,0.541069115641818,59.7721238938053
"9245259823.jpg",0,2,44,59,0,105,3.54285714285714,0.537597422809103,71.4053398058252
"9246527762.jpg",6,65,35,1,0,107,2.28971962616822,0.582922788414288,34.55
"92466227.jpg",2,36,47,18,1,104,2.80769230769231,0.776811044947164,48.2121848739496
"9246656735.jpg",0,4,43,49,6,102,3.55882352941176,0.668581021575682,69.1
"9248275667.jpg",0,6,72,30,0,108,3.22222222222222,0.535354425937356,61.3513513513514
"9249272493.jpg",0,1,18,92,3,114,3.85087719298246,0.445875019997238,76.1108695652174
"9249859612.jpg",0,2,55,45,0,102,3.42156862745098,0.534665149393819,67.9082568807339
"9249869281.jpg",27,66,8,0,0,101,1.81188118811881,0.560586679954647,19.5817757009346
"9251039345.jpg",0,2,47,51,1,101,3.5049504950495,0.558994854649622,67.15
"9251645143.jpg",0,1,48,55,4,108,3.57407407407407,0.583314789795751,70.212389380531
"9253116202.jpg",0,0,38,67,3,108,3.67592592592593,0.526471302014582,74.4716981132076
"9255279783.jpg",0,3,40,56,8,107,3.64485981308411,0.662361932193293,71.5756302521008
"9256298469.jpg",0,3,41,62,0,106,3.55660377358491,0.553434104637671,72.15625
"9256620726.jpg",0,1,17,72,18,108,3.99074074074074,0.603655072185389,81.0691964285714
"9257237144.jpg",1,12,75,21,0,109,3.06422018348624,0.581747516791055,55.725
"9257583469.jpg",0,0,17,81,5,103,3.88349514563107,0.449421651742142,81.7430555555556
"9258012910.jpg",0,0,21,79,6,106,3.85849056603774,0.486751706437355,76.2987288135593
"9258059092.jpg",0,9,65,73,8,155,3.51612903225806,0.687124997699358,71.046178343949
"9259054228.jpg",0,3,61,41,2,107,3.39252336448598,0.57882459535234,65.9
"9262147694.jpg",0,9,87,10,0,106,3.00943396226415,0.425279359589344,55.2142857142857
"9263759875.jpg",0,0,39,65,4,108,3.67592592592593,0.543933470775587,70.0504201680672
"9264499657.jpg",38,67,4,0,0,109,1.68807339449541,0.539156537882226,18.2960526315789
"9264744599.jpg",0,10,57,33,1,101,3.24752475247525,0.638841773744632,64.1526548672566
"9265274583.jpg",1,21,61,20,0,103,2.97087378640777,0.663565985601498,51.1346153846154
"9265763356.jpg",2,19,51,29,1,102,3.07843137254902,0.766711823305287,52.4712389380531
"9267882389.jpg",0,1,34,80,3,118,3.72033898305085,0.521103254698219,76.2371794871795
"9269067450.jpg",2,47,43,9,0,101,2.58415841584158,0.682163129063324,43.4174528301887
"9269195837.jpg",1,4,61,45,0,111,3.35135135135135,0.597702398563162,64.5472972972973
"9269537075.jpg",0,1,23,74,9,107,3.85046728971963,0.563073411175464,74.6207627118644
"9274541718.jpg",0,7,67,28,0,102,3.20588235294118,0.551114717247404,60.0731132075472
"9274677525.jpg",0,13,71,24,1,109,3.11926605504587,0.604378631663252,58.0567226890756
"9277184417.jpg",0,20,72,17,0,109,2.97247706422018,0.584660642252161,53.8883928571429
"9281657562.jpg",0,0,36,70,2,108,3.68518518518519,0.505079768811405,72.0089285714286
"9283219931.jpg",0,2,57,43,0,102,3.40196078431373,0.531387198643839,67.6570796460177
"9283273348.jpg",0,3,30,68,6,107,3.7196261682243,0.611129367821924,72.01875
"9283322341.jpg",0,0,31,71,3,105,3.73333333333333,0.505102172959299,73.9698275862069
"9284536346.jpg",0,2,54,53,0,109,3.46788990825688,0.536946223589331,68.2478991596639
"9284861098.jpg",0,4,50,52,3,109,3.4954128440367,0.617999358908471,68.7678571428571
"9286263885.jpg",0,23,74,6,0,103,2.83495145631068,0.506759938112031,49.8370535714286
"9286580231.jpg",0,3,60,44,2,109,3.41284403669725,0.580724470498192,64.704347826087
"9287500291.jpg",0,3,49,59,0,111,3.5045045045045,0.553893226892789,69.0448717948718
"9289816970.jpg",5,60,36,3,0,104,2.35576923076923,0.621902331025801,36.8308823529412
"9290273110.jpg",1,25,68,11,0,105,2.84761904761905,0.600976007151834,47.921875
"9290321332.jpg",0,4,45,53,4,106,3.5377358490566,0.635078222431983,68.4732142857143
"9291621754.jpg",0,2,63,32,0,97,3.30927835051546,0.507461508028525,65.1577669902913
"9294636383.jpg",10,61,24,0,0,95,2.14736842105263,0.582883898746305,29.6785714285714
"9295408685.jpg",1,11,95,25,0,132,3.09090909090909,0.544991707403056,58.5091240875912
"9297541584.jpg",0,19,57,33,0,109,3.12844036697248,0.68178574661058,55.5875
"9297933012.jpg",2,54,46,3,0,105,2.47619047619048,0.589902829273897,39.4521739130435
"9298572085.jpg",0,0,28,80,3,111,3.77477477477477,0.480240180150131,73.275641025641
"9299238943.jpg",1,31,59,18,0,109,2.86238532110092,0.686751476804853,49.7373949579832
"9301174145.jpg",0,2,56,43,0,101,3.40594059405941,0.53250761162226,65.2
"9301597304.jpg",6,65,40,1,0,112,2.32142857142857,0.588390470863819,34.7690677966102
"9302290265.jpg",0,3,61,43,1,108,3.38888888888889,0.560929357894812,63.9336283185841
"9303678528.jpg",0,22,80,6,0,108,2.85185185185185,0.489417254369973,50.010593220339
"9304089120.jpg",0,0,25,71,6,102,3.81372549019608,0.521429720673115,75.5446428571429
"9304302078.jpg",0,0,54,44,1,99,3.46464646464646,0.521245198933135,66.8443396226415
"9304786049.jpg",0,0,32,70,0,102,3.68627450980392,0.46629766035944,73.9392523364486
"930643510.jpg",18,79,10,0,0,107,1.92523364485981,0.508437016366886,24.1148648648649
"9306814074.jpg",0,0,31,77,3,111,3.74774774774775,0.494854771504979,74.9004237288136
"9307347958.jpg",12,72,18,0,0,102,2.05882352941176,0.541788921884279,28.7291666666667
"9309381016.jpg",0,9,53,41,1,104,3.32692307692308,0.645256142296238,65.9587378640777
"9310356178.jpg",0,6,72,27,0,105,3.2,0.526234811584217,58.3040540540541
"9314256771.jpg",0,6,42,58,1,107,3.50467289719626,0.620009613067607,69.2297297297297
"9315620500.jpg",0,4,64,70,0,138,3.47826086956522,0.556545540589091,69.0342465753425
"9317715562.jpg",3,22,73,8,0,106,2.81132075471698,0.603374755965617,49.8310810810811
"9318049470.jpg",0,0,40,65,1,106,3.63207547169811,0.503804037831665,70.1393805309735
"9318914214.jpg",5,20,59,26,0,110,2.96363636363636,0.777283823184827,51.66875
"9321343770.jpg",0,3,31,75,2,111,3.68468468468468,0.555664744934667,73.8378378378378
"9322027317.jpg",1,8,73,26,0,108,3.14814814814815,0.577050424833287,58.75
"9322601223.jpg",0,3,70,66,1,140,3.46428571428571,0.555038585549803,68.839527027027
"9324301658.jpg",0,1,21,75,4,101,3.81188118811881,0.504239452782678,74.644495412844
"9324654543.jpg",1,7,89,29,0,126,3.15873015873016,0.542773594239048,61.456
"9324716054.jpg",0,2,29,70,3,104,3.71153846153846,0.551662569637779,74.4642857142857
"9326601195.jpg",0,3,26,67,7,103,3.75728155339806,0.617807943656135,77.4598214285714
"9327556810.jpg",0,3,28,70,4,105,3.71428571428571,0.583660295599538,72.4256756756757
"9327697070.jpg",1,5,52,42,3,103,3.39805825242718,0.676493349173033,68.3871681415929
"9328342385.jpg",0,0,28,70,10,108,3.83333333333333,0.571929019842775,76.5672268907563
"9328964042.jpg",0,12,73,21,0,106,3.08490566037736,0.55408310410386,57.4586956521739
"9329940580.jpg",0,24,59,18,1,102,2.96078431372549,0.673715405841618,50.95
"9331151234.jpg",1,4,42,62,3,112,3.55357142857143,0.65539047867411,69.6089743589744
"9332496650.jpg",0,1,22,86,4,113,3.82300884955752,0.486057177992599,77.6764705882353
"9332533553.jpg",1,10,92,37,1,141,3.19148936170213,0.596596221637158,61.8158783783784
"9333294037.jpg",0,5,67,35,0,107,3.2803738317757,0.545900545979958,62.1689189189189
"9333668178.jpg",0,3,30,67,5,105,3.7047619047619,0.603257336399164,74.1351351351351
"9334502001.jpg",0,18,70,18,1,107,3.01869158878505,0.614007995941036,53.0328947368421
"9335509582.jpg",8,87,49,2,0,146,2.30821917808219,0.593819530150605,35.1224489795918
"9335639356.jpg",17,80,3,0,0,100,1.86,0.42687494916219,22.45
"9336450850.jpg",0,0,12,79,14,105,4.01904761904762,0.499633565359354,79.5172413793103
"9337247723.jpg",0,1,64,42,0,107,3.38317757009346,0.507395491852786,66.5955882352941
"9338607155.jpg",1,13,58,30,0,102,3.14705882352941,0.665962547984055,56.9084821428571
"9339023066.jpg",0,0,43,63,1,107,3.60747663551402,0.509476411693017,72.0285714285714
"9339173002.jpg",0,5,74,22,0,101,3.16831683168317,0.491310633524109,60.7
"9339437714.jpg",0,6,50,49,1,106,3.42452830188679,0.616412249307342,64.9375
"9341605084.jpg",0,0,20,86,4,110,3.85454545454545,0.445906223661714,77.4598214285714
"9341616816.jpg",0,0,37,79,3,119,3.71428571428571,0.506614839539513,75.25
"9342036891.jpg",1,29,57,9,0,96,2.77083333333333,0.623726773290435,46.4543269230769
"9342285552.jpg",0,1,25,71,6,103,3.79611650485437,0.548781596990558,76.0981308411215
"9342669344.jpg",0,2,62,47,0,111,3.40540540540541,0.528778667881827,66.7155172413793
"9344271524.jpg",0,0,35,69,3,107,3.70093457943925,0.517886730367843,74.0304347826087
"9344542617.jpg",5,81,25,0,0,111,2.18018018018018,0.489864511847143,30.9237288135593
"9345882583.jpg",1,18,81,10,0,110,2.90909090909091,0.534076490852888,51.0739130434783
"9346160455.jpg",0,1,43,59,2,105,3.59047619047619,0.549391938265845,70.7693965517241
"9346372358.jpg",0,2,36,60,10,108,3.72222222222222,0.653292642893341,74.8080357142857
"9346378862.jpg",0,2,36,64,2,104,3.63461538461538,0.558390410586359,72.3035714285714
"9346802331.jpg",0,47,55,6,0,108,2.62037037037037,0.591490949877323,43.41875
"93473094.jpg",4,41,50,8,0,103,2.60194174757282,0.690833622960407,43.0126050420168
"9348271980.jpg",0,0,18,79,10,107,3.92523364485981,0.508437016366886,78.5084033613445
"9348876103.jpg",0,28,66,8,0,102,2.80392156862745,0.563567415143367,49.125
"9349890960.jpg",0,2,27,72,3,104,3.73076923076923,0.543822665820023,73.8152173913043
"935105924.jpg",0,27,90,9,0,126,2.85714285714286,0.517134964422801,50.2441860465116
"9351387644.jpg",0,0,10,88,8,106,3.9811320754717,0.41360510440508,84.4491150442478
"9352087961.jpg",78,32,0,0,0,110,1.29090909090909,0.456260318127983,8.34110169491525
"9352825622.jpg",0,2,42,65,1,110,3.59090909090909,0.546808161946805,68.7478813559322
"9353536560.jpg",1,14,80,29,0,124,3.10483870967742,0.609125034050699,59.5614754098361
"9354878188.jpg",0,2,41,66,1,110,3.6,0.545204279533844,70.9487179487179
"9362014571.jpg",3,36,51,10,1,101,2.7029702970297,0.728622734416729,45.4782608695652
"9362231010.jpg",0,1,39,66,3,109,3.65137614678899,0.550692271213156,72.6375
"9363143543.jpg",0,0,59,48,1,108,3.46296296296296,0.519272062844663,65.8318584070797
"9365989820.jpg",0,20,61,21,0,102,3.00980392156863,0.637058494589801,55.247641509434
"9366566723.jpg",0,2,63,38,1,104,3.36538461538462,0.540723935947584,65.4433962264151
"9369620513.jpg",0,1,27,73,3,104,3.75,0.51671103264991,76.8705357142857
"9369983914.jpg",0,1,44,64,1,110,3.59090909090909,0.529764610103801,70.4551282051282
"9372136957.jpg",0,4,54,49,4,111,3.47747747747748,0.630250265541711,67.55
"9372534946.jpg",0,10,59,34,1,104,3.25,0.634753984910078,61.7972972972973
"9372862494.jpg",2,30,56,14,3,105,2.86666666666667,0.772939776073076,50.1443965517241
"9373483438.jpg",0,3,52,48,0,103,3.43689320388349,0.554304066633732,68.8165137614679
"9375359458.jpg",0,2,56,46,1,105,3.43809523809524,0.553377905438143,65.8214285714286
"9376075949.jpg",0,3,35,60,2,100,3.61,0.584220105194208,71.0871559633027
"9379310013.jpg",0,0,32,69,2,103,3.70873786407767,0.497662535498233,75.1013513513514
"9379361831.jpg",0,0,24,74,6,104,3.82692307692308,0.510896940043469,77.3861607142857
"9379457487.jpg",0,1,23,74,7,105,3.82857142857143,0.545208902396822,76.5758928571429
"9380189805.jpg",1,0,47,55,0,103,3.51456310679612,0.557727842651489,70.3785714285714
"9384228809.jpg",0,5,52,50,2,109,3.44954128440367,0.615934077342428,66.10625
"9387665300.jpg",0,0,23,75,11,109,3.88990825688073,0.550074903002013,78.9330357142857
"9389671360.jpg",0,35,64,6,0,105,2.72380952380952,0.563219421909541,46.375
"9389784838.jpg",0,1,42,58,3,104,3.60576923076923,0.56462495896549,71.8616071428571
"9391288768.jpg",0,1,28,77,5,111,3.77477477477477,0.534018806013501,77.0991379310345
"93917546.jpg",1,27,53,22,0,103,2.93203883495146,0.717595876252306,51.3319327731092
"9393485021.jpg",0,0,18,77,6,101,3.88118811881188,0.475123746257147,78.5347222222222
"9394014608.jpg",2,48,49,7,0,106,2.57547169811321,0.646575053022752,41.7297297297297
"9398081258.jpg",0,3,48,44,1,96,3.44791666666667,0.578014599463528,68.2452830188679
"9401118786.jpg",3,15,71,20,0,109,2.99082568807339,0.659621283656411,52.5986842105263
"9401387705.jpg",0,1,27,78,2,108,3.75,0.495305060345378,78.4883177570093
"9401940143.jpg",2,40,57,1,0,100,2.57,0.555141259664437,41.4642857142857
"940371579.jpg",0,9,75,27,1,112,3.17857142857143,0.572874618206574,59.50625
"9405444471.jpg",0,2,55,46,6,109,3.51376146788991,0.632670397177308,69.1361607142857
"9406497605.jpg",0,2,39,66,0,107,3.5981308411215,0.529503382213656,74.0088495575221
"9406525947.jpg",0,1,40,69,1,111,3.63063063063063,0.520976843455514,68.7331932773109
"9406773963.jpg",28,72,7,0,0,107,1.80373831775701,0.539728309297855,20.6216216216216
"9407500904.jpg",0,14,58,28,0,100,3.14,0.635959467611297,58.0688073394495
"9407500995.jpg",0,1,24,80,4,109,3.79816513761468,0.505155211090491,75.8792372881356
"9408208696.jpg",0,1,23,74,5,103,3.80582524271845,0.525025721632918,78.1486486486486
"9408400121.jpg",0,1,45,64,4,114,3.62280701754386,0.57051988210712,71.5756302521008
"9409533366.jpg",0,3,55,44,0,102,3.40196078431373,0.549703861256738,67.6875
"9413392698.jpg",0,15,65,20,0,100,3.05,0.592461054424762,54.4722222222222
"9416795305.jpg",0,2,33,68,3,106,3.67924528301887,0.561412670753253,74.3173913043478
"9417195704.jpg",0,5,43,62,1,111,3.53153153153153,0.600300225187664,68.9038461538462
"9418862819.jpg",14,55,37,2,0,108,2.25,0.698797364769892,32.8813559322034
"9419143176.jpg",0,23,72,7,0,102,2.84313725490196,0.521708883566678,48.25
"9419183210.jpg",0,2,37,69,3,111,3.65765765765766,0.564003473482139,69.9364406779661
"9424457746.jpg",0,0,25,70,9,104,3.84615384615385,0.553352198616052,76.6483050847458
"9424726743.jpg",1,16,72,14,0,103,2.96116504854369,0.576029855181602,54.5857142857143
"9426505697.jpg",2,44,52,3,0,101,2.55445544554455,0.591189437063155,41.3173913043478
"9427704319.jpg",0,1,26,72,2,101,3.74257425742574,0.503059943675397,75.0972222222222
"9428417271.jpg",0,4,42,55,1,102,3.51960784313725,0.592534281196727,69.325
"9428890222.jpg",4,44,46,14,0,108,2.64814814814815,0.752749661317334,44.38125
"9429089796.jpg",0,2,25,71,10,108,3.82407407407407,0.608793869688389,73.53125
"9432792818.jpg",2,12,50,31,5,100,3.25,0.808727645156516,59.2702702702703
"9433458685.jpg",1,6,31,62,7,107,3.63551401869159,0.731920752547138,70.2584033613445
"9433764311.jpg",0,0,38,83,5,126,3.73809523809524,0.524268197449686,76.859756097561
"9434602286.jpg",0,0,31,70,2,103,3.71844660194175,0.493436841184705,76.006880733945
"9434819807.jpg",0,0,8,85,8,101,4,0.4,82.375
"9435287371.jpg",0,0,20,81,3,104,3.83653846153846,0.443082251959491,78.9407894736842
"9438182965.jpg",0,0,24,60,19,103,3.95145631067961,0.647448094318947,81.5675675675676
"9438332547.jpg",0,0,16,86,2,104,3.86538461538462,0.395550306294357,78.6217391304348
"9438428165.jpg",1,0,21,83,1,106,3.78301886792453,0.497703621524604,78.9004424778761
"9439720567.jpg",0,8,45,57,1,111,3.45945945945946,0.643623037383385,66.3429203539823
"9439902792.jpg",0,2,33,64,2,101,3.65346534653465,0.555619358272486,75.9571428571429
"9439964500.jpg",0,11,80,12,0,103,3.00970873786408,0.4747578460372,55.4811320754717
"9442161547.jpg",0,0,33,73,3,109,3.72477064220183,0.506834029979198,71.614406779661
"944341845.jpg",1,23,102,11,0,137,2.8978102189781,0.518548192962059,52.1952054794521
"9444126747.jpg",0,0,36,62,1,99,3.64646464646465,0.501286738449699,71.2406542056075
"9445074981.jpg",0,1,32,77,4,114,3.73684210526316,0.533026615732005,74.6953781512605
"9445529272.jpg",4,36,56,7,0,103,2.64077669902913,0.669421303082274,44.2388392857143
"9450353504.jpg",8,64,53,1,0,126,2.37301587301587,0.616235370411365,37.0853658536585
"9455543659.jpg",0,1,49,58,5,113,3.5929203539823,0.592168655717406,69.5868644067797
"9455732786.jpg",1,31,62,11,1,106,2.81132075471698,0.663514560749833,47.7033898305085
"9456887097.jpg",0,7,40,59,1,107,3.50467289719626,0.635043183432864,67.9012605042017
"9457716836.jpg",0,3,31,64,2,100,3.65,0.575159178669767,72.6009174311927
"9458038705.jpg",0,13,67,26,0,106,3.12264150943396,0.596862115187647,58.3080357142857
"9458474537.jpg",0,11,62,28,2,103,3.20388349514563,0.64715400023413,60.4594594594595
"9458721242.jpg",0,12,77,18,0,107,3.05607476635514,0.529003614870386,58.0929203539823
"9458811902.jpg",0,1,38,65,2,106,3.64150943396226,0.537873754798121,74.1548672566372
"9459450025.jpg",0,0,47,63,1,111,3.58558558558559,0.512896737231836,70.3289473684211
"9460489511.jpg",0,0,55,50,3,108,3.51851851851852,0.555036101907087,67.9407894736842
"9461924966.jpg",0,6,65,29,0,100,3.23,0.547814758929522,59.265625
"9462111992.jpg",0,0,18,86,6,110,3.89090909090909,0.456260318127983,79.1282051282051
"9463299362.jpg",0,3,80,22,1,106,3.19811320754717,0.486382395529528,61.6486486486486
"9463363154.jpg",0,4,67,34,0,105,3.28571428571429,0.531946456861058,63.9264705882353
"9467289840.jpg",0,12,71,28,1,112,3.16071428571429,0.608551247089857,58.9615384615385
"9467953954.jpg",0,1,24,68,10,103,3.84466019417476,0.590069480013243,78
"9468744508.jpg",0,0,19,83,8,110,3.9,0.487457361108726,79.375
"9469622762.jpg",0,11,68,22,0,101,3.10891089108911,0.563932444518134,57.1
"9470847928.jpg",0,0,10,92,9,111,3.99099099099099,0.415506164389137,82.3813559322034
"9471314459.jpg",0,0,38,66,2,106,3.66037735849057,0.514305679955861,74.6607142857143
"9472829997.jpg",3,48,52,1,0,104,2.49038461538462,0.57445951478755,39.1206896551724
"9472868070.jpg",1,8,68,31,0,108,3.19444444444444,0.60308139177812,61.4471153846154
"9473084663.jpg",0,12,72,24,0,108,3.11111111111111,0.569199032800311,58.1906779661017
"9474360756.jpg",0,1,39,67,1,108,3.62962962962963,0.522263094664423,73.2821100917431
"9475748691.jpg",3,13,73,12,1,102,2.95098039215686,0.635227424470831,51.5855263157895
"9476849940.jpg",0,2,40,61,1,104,3.58653846153846,0.550561530172921,73.4705882352941
"9476907478.jpg",0,0,27,75,6,108,3.80555555555556,0.519855000152735,76.4285714285714
"9477685137.jpg",0,3,54,50,0,107,3.4392523364486,0.552482734186941,66.1160714285714
"9477847678.jpg",0,2,38,58,7,105,3.66666666666667,0.630425171956115,70.3426724137931
"9479081195.jpg",5,56,40,1,0,102,2.36274509803922,0.593516382889227,36.0046728971963
"9479870149.jpg",0,1,26,82,3,112,3.77678571428571,0.497014898694002,75.8846153846154
"9480350471.jpg",0,6,74,23,0,103,3.16504854368932,0.506759938112031,59.9399038461538
"9480702491.jpg",0,0,39,70,2,111,3.66666666666667,0.51049589675732,73.3622881355932
"9482188665.jpg",0,0,52,56,2,110,3.54545454545455,0.535635841589846,69.0263157894737
"9482512663.jpg",0,0,28,91,7,126,3.83333333333333,0.501996015920445,80.4146341463415
"9482519952.jpg",0,9,70,22,0,101,3.12871287128713,0.541541620498991,57.5047169811321
"9483190108.jpg",1,0,28,73,4,106,3.74528301886792,0.57006801189427,74.3173913043478
"9483838441.jpg",0,1,39,93,7,140,3.75714285714286,0.548003945942688,78.4143835616438
"9484887965.jpg",0,21,63,19,0,103,2.98058252427184,0.62592022489044,54.7364864864865
"9484990711.jpg",8,70,27,0,0,105,2.18095238095238,0.550890055709715,30.7
"9485553260.jpg",0,1,25,67,6,99,3.78787878787879,0.558290526239082,77.8990825688073
"9485678546.jpg",1,32,66,8,0,107,2.75700934579439,0.596232218520937,46.1578947368421
"9486578471.jpg",2,46,47,7,0,102,2.57843137254902,0.651521821094623,42.3271028037383
"9487232298.jpg",0,5,53,50,0,108,3.41666666666667,0.582052443280648,66.0911016949153
"9487747992.jpg",7,68,24,4,0,103,2.24271844660194,0.633478096213182,32.7307692307692
"9488096665.jpg",0,1,28,66,10,105,3.80952380952381,0.605983594840749,76.6012931034483
"94886803.jpg",1,2,36,56,4,99,3.60606060606061,0.651813511237902,70.50625
"9488864072.jpg",1,19,67,9,0,96,2.875,0.566615064729969,50.6586538461538
"9489836089.jpg",0,2,44,53,1,100,3.53,0.55876848714134,68.4380733944954
"9490079439.jpg",0,0,49,52,3,104,3.55769230769231,0.554363504117592,69.0625
"9490329837.jpg",0,1,60,46,3,110,3.46363636363636,0.569520524672599,66.5840336134454
"9493293324.jpg",0,0,43,59,2,104,3.60576923076923,0.529118505469683,72.3552631578947
"9494293866.jpg",7,66,31,2,0,106,2.26415094339623,0.606345599903975,32.9048672566372
"9494790787.jpg",0,1,53,57,2,113,3.53097345132743,0.552119236283784,69.5651260504202
"9494953335.jpg",0,2,76,70,0,148,3.45945945945946,0.526551848050522,69.1040268456376
"9495726171.jpg",0,0,30,71,5,106,3.76415094339623,0.526477726068939,75.3199152542373
"9496059717.jpg",0,1,49,48,4,102,3.53921568627451,0.59155054900552,70.0663716814159
"9496541245.jpg",0,10,44,46,6,106,3.45283018867925,0.744913871297476,64.9375
"9497146011.jpg",1,13,57,28,1,100,3.15,0.687184270936277,55.1725663716814
"9497710012.jpg",21,89,21,0,0,131,2,0.568398560058805,25.5639097744361
"9497810800.jpg",0,3,73,31,1,108,3.27777777777778,0.526553479694317,61.0862831858407
"9498977620.jpg",0,9,76,16,0,101,3.06930693069307,0.495124746757305,58.5309734513274
"9500372295.jpg",1,37,67,2,0,107,2.65420560747664,0.53381510010521,44.3125
"95019293.jpg",4,56,43,1,0,104,2.39423076923077,0.5815658346352,37.3970588235294
"9502087003.jpg",0,6,56,45,0,107,3.36448598130841,0.589091455315854,66.1824324324324
"950420073.jpg",0,0,58,49,0,107,3.45794392523365,0.500572763108001,68.9324324324324
"9505522131.jpg",0,13,41,54,4,112,3.4375,0.744726202786714,66.5769230769231
"9506730000.jpg",4,29,56,16,0,105,2.8,0.739022223044643,48.2702702702703
"9507159381.jpg",2,52,44,5,0,103,2.50485436893204,0.624245213379169,41.8
"9508337257.jpg",7,49,43,4,0,103,2.42718446601942,0.680281685422322,36.9857142857143
"9508596066.jpg",0,0,16,94,3,113,3.88495575221239,0.395334677144851,76.4487179487179
"9510636160.jpg",0,1,19,80,13,113,3.92920353982301,0.562469271530391,78.0466101694915
"9510794857.jpg",21,79,7,1,0,108,1.88888888888889,0.535354425937356,23.3618421052632
"9510873691.jpg",0,1,56,45,1,103,3.44660194174757,0.537389392902424,67.5110619469027
"9512008685.jpg",1,8,47,44,1,101,3.35643564356436,0.686791939612596,64.6544117647059
"9512191283.jpg",0,1,21,81,4,107,3.82242990654206,0.491687201381957,79.375
"9513920516.jpg",0,13,71,16,0,100,3.03,0.540388935878782,55.3241525423729
"9515243339.jpg",0,2,29,73,1,105,3.6952380952381,0.521163814564789,72.054054054054
"9517140367.jpg",0,8,79,16,1,104,3.09615384615385,0.512356648561204,57.2767857142857
"9517941769.jpg",1,8,73,25,1,108,3.15740740740741,0.598472151883554,57.8738938053097
"9518037590.jpg",0,0,22,79,4,105,3.82857142857143,0.469392874178625,76.3168103448276
"9519070785.jpg",0,1,42,62,2,107,3.60747663551402,0.545254127107898,69.2878151260504
"952167260.jpg",2,24,66,11,0,103,2.83495145631068,0.627742412806474,48.3846153846154
"9521784071.jpg",0,10,87,35,0,132,3.18939393939394,0.554407403285662,62.125
"9522074895.jpg",1,0,14,85,5,105,3.88571428571429,0.506007861642441,77.7608695652174
"9522817562.jpg",0,3,34,60,4,101,3.64356435643564,0.609658238947717,71.7361111111111
"9523088763.jpg",0,2,45,77,2,126,3.62698412698413,0.547490668181689,74.1189516129032
"9523882653.jpg",3,26,62,8,0,99,2.75757575757576,0.640326910941353,47.5928571428571
"9524699151.jpg",0,3,11,78,9,101,3.92079207920792,0.560056574228563,77.3304347826087
"9525267533.jpg",1,13,78,14,0,106,2.99056603773585,0.543275480744748,54.6986607142857
"9526511129.jpg",1,4,42,50,4,101,3.51485148514851,0.68722429215124,66.484375
"9526789940.jpg",0,8,81,21,0,110,3.11818181818182,0.501956140154561,58.8922413793103
"9526812010.jpg",0,1,54,68,3,126,3.57936507936508,0.556462751359688,71.8963414634146
"9527678556.jpg",1,4,54,43,1,103,3.37864077669903,0.628045596795561,65.7428571428571
"9527733918.jpg",0,4,47,56,1,108,3.5,0.588042849223902,67.8175675675676
"9527961628.jpg",1,18,99,22,0,140,3.01428571428571,0.562442186134798,56.3367346938776
"9527980922.jpg",0,2,38,59,2,101,3.6039603960396,0.567083907738389,70.7430555555556
"9528230846.jpg",0,2,32,61,3,98,3.66326530612245,0.573358302739228,73.0550458715596
"9528238832.jpg",0,3,70,29,2,104,3.28846153846154,0.551662569637779,63.876213592233
"9528268471.jpg",0,4,26,70,1,101,3.67326732673267,0.567607450463595,74.8715596330275
"9530920367.jpg",0,3,43,54,1,101,3.52475247524752,0.576091301894771,67.9930555555556
"9530922505.jpg",0,1,37,58,2,98,3.62244897959184,0.547069156796959,70.2702702702703
"9534283737.jpg",1,0,20,77,9,107,3.86915887850467,0.584131546142417,76.4978991596639
"9535634646.jpg",0,2,81,42,1,126,3.33333333333333,0.521536192416212,64.9878048780488
"9535859777.jpg",0,3,64,34,1,102,3.32352941176471,0.547935182729598,62.5
"9536013325.jpg",0,2,35,63,3,103,3.6504854368932,0.572383010806878,70.2545871559633
"9536683213.jpg",0,6,52,45,0,103,3.37864077669903,0.596008041371744,65.5212264150943
"9537434864.jpg",0,7,76,27,0,110,3.18181818181818,0.52779301930399,59.1150442477876
"9538010793.jpg",1,13,114,25,1,154,3.07792207792208,0.542717292195432,57.8566878980892
"9538674147.jpg",1,30,65,4,0,100,2.72,0.55194788218315,45.6559633027523
"9539965008.jpg",0,0,34,64,2,100,3.68,0.51010001000002,75.9375
"9540532896.jpg",0,1,18,74,18,111,3.98198198198198,0.602750996107649,82.1716101694915
"9541231306.jpg",13,83,8,1,0,105,1.97142857142857,0.489449118459151,24.7368421052632
"9541303452.jpg",3,61,61,4,0,129,2.51162790697674,0.600992396345508,41.4942748091603
"9541618071.jpg",1,51,50,6,0,108,2.56481481481481,0.61557887273973,41.8157894736842
"9543397077.jpg",0,0,29,76,4,109,3.77064220183486,0.502457433666732,74.425
"9544478990.jpg",0,1,23,69,8,101,3.83168316831683,0.566909286053652,77.8326086956522
"9544682172.jpg",0,0,19,74,11,104,3.92307692307692,0.534123139365797,78.9509345794392
"9545794561.jpg",0,0,47,71,4,122,3.64754098360656,0.544273435587874,73.1363636363636
"9546481286.jpg",0,0,18,75,5,98,3.86734693877551,0.468332314434003,77.6808035714286
"9547511197.jpg",1,33,104,13,0,151,2.85430463576159,0.558537984305186,51.3741721854305
"9549652790.jpg",0,0,27,78,7,112,3.82142857142857,0.523575471284966,74.5508474576271
"9549856021.jpg",1,4,68,32,0,105,3.24761904761905,0.568076247268466,63.5693069306931
"9550375184.jpg",0,0,20,82,6,108,3.87037037037037,0.475425880748874,77.2775423728814
"9550673458.jpg",1,21,69,13,0,104,2.90384615384615,0.599663834131796,52.9672897196262
"9553679433.jpg",0,0,47,56,1,104,3.55769230769231,0.518154362368228,70.3883928571429
"9554062765.jpg",57,44,6,3,0,110,1.59090909090909,0.720543303494089,15.23125
"9557331185.jpg",0,19,75,17,0,111,2.98198198198198,0.571791156756667,53.0553097345133
"9560250736.jpg",3,38,53,9,0,103,2.66019417475728,0.679581734948444,43.8717948717949
"9561571974.jpg",0,1,53,50,0,104,3.47115384615385,0.520580907214179,66.9288793103448
"9561731191.jpg",0,1,33,71,6,111,3.73873873873874,0.567477860388511,72.7330508474576
"9562837541.jpg",0,3,21,74,8,106,3.82075471698113,0.598365548590026,77.0434782608696
"9565379403.jpg",0,0,20,77,4,101,3.84158415841584,0.463307096153874,75.401376146789
"9566357532.jpg",0,1,29,67,6,103,3.75728155339806,0.568210459101958,76.2075892857143
"9567386872.jpg",0,9,77,20,0,106,3.10377358490566,0.515091213060161,58.104347826087
"9569732421.jpg",0,9,63,30,0,102,3.20588235294118,0.585944871095162,62.5694444444444
"9569803128.jpg",0,0,50,51,1,102,3.51960784313725,0.521429720673115,69.8473451327434
"9571610402.jpg",1,9,49,64,4,127,3.48031496062992,0.711028694761613,69.8582677165354
"95721252.jpg",2,40,52,11,0,105,2.68571428571429,0.683799983608085,44.8625
"9572676975.jpg",0,3,49,48,5,105,3.52380952380952,0.636928297124296,69.2098214285714
"9577464036.jpg",0,18,63,29,0,110,3.1,0.64892289020437,57.1148648648649
"9577991089.jpg",0,35,66,5,0,106,2.71698113207547,0.547804570316512,47.5796460176991
"9578088583.jpg",2,54,49,3,0,108,2.49074074074074,0.587969265684951,39.671875
"9581038288.jpg",0,2,54,48,1,105,3.45714285714286,0.555195243352965,65.7364864864865
"9581108826.jpg",0,0,49,53,2,104,3.54807692307692,0.537520515613129,71.8859223300971
"9581336227.jpg",2,14,48,36,2,102,3.2156862745098,0.778770940539995,58.1607142857143
"9582086369.jpg",0,2,30,68,6,106,3.73584905660377,0.590429815875936,75.6086956521739
"9582851453.jpg",0,14,49,36,2,101,3.25742574257426,0.716288564009431,63.9855769230769
"9582874322.jpg",4,48,46,8,0,106,2.54716981132075,0.691885972874806,41.7694174757282
"9583278733.jpg",0,3,43,83,2,131,3.6412213740458,0.555652108788561,74.60546875
"9583424619.jpg",0,4,56,36,2,98,3.36734693877551,0.598757392000356,62.8378378378378
"9584563009.jpg",0,9,95,26,0,130,3.13076923076923,0.504068125370874,59.2388888888889
"9584749572.jpg",0,10,75,21,0,106,3.10377358490566,0.533260327438116,58.0326086956522
"9585740831.jpg",0,1,44,66,1,112,3.59821428571429,0.527783422490079,70.5560344827586
"9586652263.jpg",0,1,30,75,1,107,3.71028037383178,0.495438547764685,74.9527027027027
"9587142056.jpg",0,1,31,70,2,104,3.70192307692308,0.5191443238415,73.7767857142857
"9587630414.jpg",0,0,24,77,6,107,3.83177570093458,0.504432827557042,75.31875
"9588413178.jpg",0,2,38,57,0,97,3.56701030927835,0.538269149195776,73.6933962264151
"9589321595.jpg",0,2,55,45,0,102,3.42156862745098,0.534665149393819,67.2379807692308
"9589470493.jpg",1,8,69,24,0,102,3.13725490196078,0.580870219248152,57.2767857142857
"9590556429.jpg",8,65,32,5,0,110,2.30909090909091,0.673828641073735,34.4159663865546
"9590947426.jpg",0,2,37,57,3,99,3.61616161616162,0.583918339046576,67.6570796460177
"9592992525.jpg",2,25,77,6,0,110,2.79090909090909,0.560069696604103,49.1128318584071
"9593149678.jpg",0,3,50,52,0,105,3.46666666666667,0.55585462035892,66.554054054054
"9594906572.jpg",0,1,18,80,5,104,3.85576923076923,0.491051363274922,77.0280172413793
"9596892460.jpg",0,1,23,74,2,100,3.77,0.489382212074519,79.7219626168224
"9597188417.jpg",0,22,64,22,0,108,3,0.641260441061998,52.35625
"9600932470.jpg",0,5,68,33,0,106,3.26415094339623,0.539874532027984,60.5677966101695
"9602489525.jpg",0,11,76,18,1,106,3.08490566037736,0.55408310410386,55.3362068965517
"9602714230.jpg",0,7,61,37,0,105,3.28571428571429,0.583660295599538,60.6081081081081
"9602922316.jpg",0,2,56,49,0,107,3.4392523364486,0.535134793343113,68.0131578947368
"9604185976.jpg",0,1,30,69,3,103,3.71844660194175,0.531691266161905,75.25
"9605303857.jpg",0,6,54,44,0,104,3.36538461538462,0.592144240950727,67
"9605307671.jpg",0,3,49,54,1,107,3.49532710280374,0.572545322844697,68.6205357142857
"9606718162.jpg",0,0,40,61,5,106,3.66981132075472,0.56436560445306,72.3135593220339
"9606775848.jpg",0,2,45,51,5,103,3.57281553398058,0.6199611269846,67.9662162162162
"9607964223.jpg",0,1,34,59,1,95,3.63157894736842,0.526987253649952,74.6214285714286
"9609818482.jpg",0,4,48,51,1,104,3.47115384615385,0.59048656535823,69.1588785046729
"9613563930.jpg",0,0,30,66,6,102,3.76470588235294,0.548200848288349,74.140756302521
"9613807416.jpg",0,0,27,76,3,106,3.77358490566038,0.483696458691754,79.5223214285714
"9615457112.jpg",0,1,47,49,5,102,3.56862745098039,0.605417848038965,69.2152777777778
"9615940305.jpg",0,2,54,45,1,102,3.44117647058824,0.555325779182854,69.1014150943396
"9618300510.jpg",0,1,45,53,0,99,3.52525252525253,0.521838084659122,67.9252336448598
"9618361879.jpg",0,0,34,70,3,107,3.71028037383178,0.514127687583038,74.4809322033898
"9618367899.jpg",0,0,37,70,2,109,3.67889908256881,0.507001606121974,72.6946902654867
"9618688199.jpg",1,9,51,47,3,111,3.37837837837838,0.714194448363826,64.8289473684211
"9619949433.jpg",1,30,62,6,0,99,2.73737373737374,0.581796278705426,47.6736111111111
"9623701556.jpg",0,1,32,61,9,103,3.75728155339806,0.617807943656135,72.3296460176991
"9625138420.jpg",0,0,29,69,6,104,3.77884615384615,0.538908115251656,74.575
"9625551668.jpg",0,38,55,12,0,105,2.75238095238095,0.647197395594628,46.9426605504587
"9629455923.jpg",0,28,62,18,0,108,2.90740740740741,0.649040082529318,51.25625
"9629668489.jpg",0,0,30,72,2,104,3.73076923076923,0.487330139305103,74.4097222222222
"9630240273.jpg",0,12,73,23,0,108,3.10185185185185,0.562700677637197,56.6701680672269
"9630325643.jpg",12,61,30,1,0,104,2.19230769230769,0.639734821836635,32.2591743119266
"9632208628.jpg",0,41,62,7,0,110,2.69090909090909,0.586475314409746,45.5360169491525
"9633489441.jpg",15,56,26,4,0,101,2.18811881188119,0.730929152341439,32.2591743119266
"9634215065.jpg",1,2,65,39,0,107,3.32710280373832,0.562603465278173,64.2745535714286
"9638117839.jpg",0,7,60,30,1,98,3.25510204081633,0.59743825095748,59.1880530973451
"9639418449.jpg",0,1,50,49,4,104,3.53846153846154,0.589932971724506,69.295652173913
"9641836616.jpg",0,1,36,88,1,126,3.70634920634921,0.490998335108547,76.0548780487805
"9642249347.jpg",0,17,78,9,1,105,2.94285714285714,0.534008272562172,53.25
"9642841042.jpg",0,5,32,68,0,105,3.6,0.58177447388274,74.1705607476636
"9642860901.jpg",0,0,42,63,1,106,3.61320754716981,0.508419675108798,69.5826086956522
"9642986357.jpg",5,64,31,1,0,101,2.27722772277228,0.567781857427448,33.1674311926606
"9646156379.jpg",0,2,36,60,2,100,3.62,0.564613034553648,71.8440366972477
"9646776074.jpg",0,1,57,43,1,102,3.43137254901961,0.536025045993237,67.5110619469027
"9648319367.jpg",0,2,48,54,0,104,3.5,0.539687072220866,69.9926470588235
"9648549075.jpg",0,0,38,66,2,106,3.66037735849057,0.514305679955861,73.553738317757
"9650165015.jpg",1,27,106,22,0,156,2.95512820512821,0.583017165884048,54.9103773584906
"9650999310.jpg",1,44,57,6,0,108,2.62962962962963,0.605158395772291,43.6365546218487
"9651547204.jpg",2,30,67,6,0,105,2.73333333333333,0.592690518974322,44.8513513513514
"9652506914.jpg",0,1,32,66,3,102,3.69607843137255,0.541161488064193,75.9800884955752
"9653610008.jpg",0,1,42,57,3,103,3.60194174757282,0.566028576588288,73.4254807692308
"9653701546.jpg",0,13,80,17,0,110,3.03636363636364,0.523349703761283,54.28125
"9654367147.jpg",0,3,37,66,1,107,3.60747663551402,0.562289949809258,70.8823529411765
"9654393465.jpg",0,12,76,15,0,103,3.02912621359223,0.513662563374043,54.8717948717949
"9654462771.jpg",0,0,18,79,14,111,3.96396396396396,0.538143744364542,79.9539473684211
"9655773082.jpg",0,0,20,74,5,99,3.84848484848485,0.481571330330887,75.103982300885
"9656195199.jpg",0,16,67,19,1,103,3.04854368932039,0.616419782747704,54.4776785714286
"9657096738.jpg",2,9,67,21,0,99,3.08080808080808,0.617380372230659,58.2694174757282
"9657273121.jpg",0,7,69,33,0,109,3.23853211009174,0.559415742982294,61.6703539823009
"9657446583.jpg",0,3,54,45,1,103,3.42718446601942,0.570550847480092,67.6111111111111
"9657450632.jpg",0,5,65,38,0,108,3.30555555555556,0.554646192409083,64.7565789473684
"9657756963.jpg",0,5,31,69,2,107,3.63551401869159,0.604893930581596,74.0825471698113
"965852463.jpg",0,15,72,18,1,106,3.04716981132075,0.591721869537951,54.9094827586207
"9658774813.jpg",0,9,69,32,1,111,3.22522522522523,0.598250246889508,59.754347826087
"9659355544.jpg",0,21,68,12,0,101,2.91089108910891,0.567432989893786,48.9105504587156
"9660068454.jpg",0,11,62,21,2,96,3.14583333333333,0.632108695960412,59.9174528301887
"9665243526.jpg",0,0,45,54,0,99,3.54545454545455,0.500463606960979,71.5833333333333
"96655810.jpg",0,18,61,27,0,106,3.08490566037736,0.649071491084829,56.61875
"9665864657.jpg",0,1,61,39,0,101,3.37623762376238,0.506980969041538,66.4107142857143
"9668766101.jpg",7,76,18,1,0,102,2.12745098039216,0.520311571307667,28.975
"9669000594.jpg",0,3,67,34,0,104,3.29807692307692,0.5191443238415,63.4225663716814
"9669015372.jpg",0,5,78,43,0,126,3.3015873015873,0.540663906986087,64.822
"9669417942.jpg",0,6,51,50,1,108,3.42592592592593,0.614523654194495,64.45625
"9670754375.jpg",0,1,19,66,12,98,3.90816326530612,0.593551857988151,82.1383495145631
"9671600986.jpg",0,6,61,40,2,109,3.34862385321101,0.614276852606362,63.8109243697479
"9673401997.jpg",5,53,82,5,2,147,2.63265306122449,0.673181290620836,45.5065789473684
"9674243129.jpg",0,2,69,28,1,100,3.28,0.514045157785213,63.2155963302752
"967548785.jpg",0,25,71,5,0,101,2.8019801980198,0.5102901523682,48.5138888888889
"9677255399.jpg",2,83,51,4,0,140,2.40714285714286,0.573973009309879,37.5118243243243
"9677256773.jpg",9,64,31,0,0,104,2.21153846153846,0.585804184173917,30.641592920354
"9677297702.jpg",6,67,35,2,0,110,2.3,0.598928707218376,34.8102678571429
"9678381010.jpg",1,27,88,9,0,125,2.84,0.544769853744117,51.2378048780488
"9678787326.jpg",0,7,46,52,0,105,3.42857142857143,0.61795479759294,63.7995689655172
"9680493700.jpg",21,82,4,0,1,108,1.87037037037037,0.548448833735682,22.0995575221239
"9681377633.jpg",36,58,8,0,0,102,1.72549019607843,0.599618075558597,18.0298165137615
"9683345746.jpg",0,11,61,31,1,104,3.21153846153846,0.633576332717798,59.5460526315789
"9684211981.jpg",0,0,17,88,5,110,3.89090909090909,0.435688941843877,75.7352941176471
"9685106937.jpg",4,42,59,2,0,107,2.55140186915888,0.602410955759534,42.175
"9686337427.jpg",11,67,23,1,0,102,2.13725490196078,0.597672311394309,29.9142857142857
"9686480737.jpg",21,83,24,1,0,129,2.03875968992248,0.61749368386438,26.0019083969466
"9687081006.jpg",0,3,50,47,1,101,3.45544554455446,0.574886988463777,66.4701834862385
"9687603044.jpg",6,55,38,4,0,103,2.38834951456311,0.660258560594255,38.9352678571429
"9687869732.jpg",0,4,50,54,2,110,3.49090909090909,0.601915208534575,63.8375
"9688720350.jpg",0,13,73,15,0,101,3.01980198019802,0.528775907541219,52.7706422018349
"9689861322.jpg",2,44,52,3,0,101,2.55445544554455,0.591189437063155,40.2224576271186
"9690359369.jpg",1,5,76,46,0,128,3.3046875,0.582670930616782,64.8255813953488
"9692018769.jpg",1,43,55,2,0,101,2.57425742574257,0.55401326073417,41.3417431192661
"9692544079.jpg",1,50,63,4,0,118,2.59322033898305,0.57344793332295,43.9423076923077
"9694060266.jpg",0,3,84,52,1,140,3.36428571428571,0.539260275190716,66.6044520547945
"9694884270.jpg",0,24,84,18,0,126,2.95238095238095,0.577680089421719,54.1011904761905
"9695487597.jpg",0,0,39,66,1,106,3.64150943396226,0.501211470344994,73.7767857142857
"9695883869.jpg",0,0,18,82,8,108,3.90740740740741,0.48408381596496,79.9225663716814
"9699196303.jpg",0,0,66,65,3,134,3.52985074626866,0.544145857650258,72.1043165467626
"9700041426.jpg",0,2,43,60,1,106,3.56603773584906,0.552377854190896,70.7283653846154
"9700460977.jpg",0,3,54,46,3,106,3.4622641509434,0.604341882142988,66.1160714285714
"9701303901.jpg",1,55,48,5,0,109,2.52293577981651,0.602407673504281,40.325
"9702019166.jpg",0,5,71,28,1,105,3.23809523809524,0.5463833805441,60.0135135135135
"9702746204.jpg",0,4,70,29,0,103,3.24271844660194,0.513847833916903,62.4930555555556
"9702908989.jpg",1,2,37,57,7,104,3.64423076923077,0.681492782242003,73.0140186915888
"9703418771.jpg",51,54,5,1,0,111,1.6036036036036,0.622009635693843,16.0897435897436
"970460687.jpg",0,5,52,55,1,113,3.46017699115044,0.598142933080746,65.6716101694915
"9707913077.jpg",0,0,23,67,11,101,3.88118811881188,0.570738621662689,78.5347222222222
"9707926050.jpg",11,73,18,2,0,104,2.10576923076923,0.589853844506429,28.8893805309735
"9708878805.jpg",0,5,78,24,0,107,3.17757009345794,0.491687201381957,60.0878378378378
"9709188366.jpg",0,3,70,64,1,138,3.45652173913043,0.555261038334083,68.3086206896552
"9710495757.jpg",0,1,24,70,8,103,3.8252427184466,0.567540004049458,80.7242990654206
"9710823281.jpg",2,10,43,40,2,97,3.30927835051546,0.768668013816054,65.2714285714286
"9712051180.jpg",0,1,52,53,0,106,3.49056603773585,0.520901837363733,69.4357142857143
"9712191760.jpg",0,9,51,42,2,104,3.35576923076923,0.667094398507281,64.8097345132743
"9712984770.jpg",0,7,72,26,1,106,3.19811320754717,0.559247986917716,59.4491525423729
"9713017105.jpg",0,3,69,67,0,139,3.46043165467626,0.541952816952098,70.0101351351351
"9714595106.jpg",0,23,65,11,0,99,2.87878787878788,0.576278122917761,48.1637168141593
"9716659455.jpg",0,2,31,67,2,102,3.67647058823529,0.547935182729598,72.475
"9716988368.jpg",0,3,60,69,0,132,3.5,0.545628008504074,72.4790076335878
"9719700871.jpg",0,0,29,71,6,106,3.78301886792453,0.534606521634318,76.6778846153846
"9719721958.jpg",0,7,49,52,1,109,3.43119266055046,0.629034717246345,66.5840336134454
"9720517445.jpg",0,3,54,41,2,100,3.42,0.589127072091164,64.6869158878505
"9722821291.jpg",8,66,36,2,0,112,2.28571428571429,0.6213697660012,32.7415254237288
"9723327327.jpg",0,0,21,84,6,111,3.86486486486486,0.476473532346789,75.3898305084746
"9723836931.jpg",0,1,24,75,4,104,3.78846153846154,0.515263659967445,79.1747572815534
"9723956053.jpg",0,4,60,37,0,101,3.32673267326733,0.549707392911704,64.9
"9724107986.jpg",0,0,30,79,6,115,3.79130434782609,0.521395768021524,78
"9724373732.jpg",1,6,51,45,2,105,3.39047619047619,0.672184127922924,65.8541666666667
"9725681826.jpg",0,3,58,42,2,105,3.40952380952381,0.583346415342582,66.4652777777778
"9726620129.jpg",0,1,35,64,3,103,3.66990291262136,0.549301687074422,72.1918103448276
"9727569377.jpg",0,1,34,66,3,104,3.68269230769231,0.544423148479607,70.9776785714286
"9727736297.jpg",0,11,78,21,0,110,3.09090909090909,0.534076490852888,56.7432432432432
"9730872137.jpg",0,19,69,15,0,103,2.96116504854369,0.576029855181602,54.8584905660377
"9731493509.jpg",13,74,18,0,0,105,2.04761904761905,0.543863535997354,27.6597222222222
"9732569997.jpg",0,0,35,70,4,109,3.71559633027523,0.528655582048325,73.7302631578947
"9733980007.jpg",0,36,62,5,0,103,2.69902912621359,0.557215617370319,43.6495535714286
"9737356732.jpg",0,1,28,74,0,103,3.70873786407767,0.477556442843436,76.15
"9737673243.jpg",0,11,70,18,0,99,3.07070707070707,0.539321668669481,58.0291262135922
"9740171796.jpg",0,6,74,48,0,128,3.328125,0.562746009196104,65.878
"9741202505.jpg",55,42,3,0,0,100,1.48,0.559220236335625,12.1
"9742193422.jpg",0,0,14,93,4,111,3.90990990990991,0.394266858163802,76.2205882352941
"9743636678.jpg",30,47,21,4,0,102,1.99019607843137,0.814413450345266,29.4004424778761
"9753718946.jpg",0,1,38,56,7,102,3.67647058823529,0.61598773142409,70.4059633027523
"9754442293.jpg",0,0,56,80,3,139,3.61870503597122,0.530185686001727,72.763698630137
"9758297555.jpg",1,18,59,24,0,102,3.03921568627451,0.673715405841618,54.2087155963303
"9759154326.jpg",0,7,70,35,0,112,3.25,0.561529442963871,60.0783898305085
"9760551223.jpg",0,1,45,56,5,107,3.60747663551402,0.594899854356262,69.6344537815126
"9762345346.jpg",0,6,44,54,5,109,3.53211009174312,0.674520506503331,71.0154867256637
"9762410596.jpg",0,0,39,67,4,110,3.68181818181818,0.540672672802991,70.9152542372881
"9763431522.jpg",0,0,13,83,6,102,3.93137254901961,0.428208423425378,82.0721153846154
"9765112254.jpg",1,12,63,30,1,107,3.16822429906542,0.665681397366797,59.0296610169492
"9766865862.jpg",1,34,58,10,1,104,2.76923076923077,0.671627052526057,48.0872641509434
"9766930762.jpg",5,44,47,7,0,103,2.54368932038835,0.697006189371431,42.6216216216216
"9767151984.jpg",12,72,20,0,0,104,2.07692307692308,0.552000909178717,28.2573529411765
"9767373513.jpg",6,54,39,2,1,102,2.3921568627451,0.67716448336183,36.4977064220183
"9767747482.jpg",0,17,66,21,0,104,3.03846153846154,0.606166962854181,53.5130434782609
"9768426856.jpg",0,12,75,21,0,108,3.08333333333333,0.549000791583107,56.3618421052632
"976846781.jpg",56,43,4,0,0,103,1.49514563106796,0.575203057202445,11.5206422018349
"9768559232.jpg",0,4,42,58,1,105,3.53333333333333,0.589436932534684,67.445945945946
"9768629394.jpg",0,4,55,48,1,108,3.42592592592593,0.583314789795751,64.9375
"9768810935.jpg",3,10,69,20,3,105,3.0952380952381,0.714194133323188,55.2567567567568
"9769299262.jpg",0,33,76,3,0,112,2.73214285714286,0.50192678941306,47.5635593220339
"9770742411.jpg",0,2,35,62,3,102,3.64705882352941,0.574146957824214,70.6
"9772275331.jpg",0,2,32,73,4,111,3.71171171171171,0.562258229049888,74.9679487179487
"9774901765.jpg",0,28,62,9,0,99,2.80808080808081,0.583388547612185,46.6399082568807
"9777290841.jpg",0,1,28,63,7,99,3.76767676767677,0.586032715327688,75.481308411215
"9780398791.jpg",0,0,62,53,0,115,3.46086956521739,0.500647940204003,68.4102564102564
"9784161203.jpg",33,64,9,1,0,107,1.79439252336449,0.625530985869761,20.25
"9784668705.jpg",0,1,46,63,0,110,3.56363636363636,0.516290095668838,70.9152542372881
"9788787724.jpg",8,78,18,0,0,104,2.09615384615385,0.493043466234686,28.2027027027027
"9795259723.jpg",0,1,53,52,0,106,3.4811320754717,0.520643047000473,68.3995535714286
"9795395745.jpg",0,13,54,34,1,102,3.22549019607843,0.673499252024224,60.1378504672897
"97984449.jpg",2,32,51,17,0,102,2.81372549019608,0.727540168083866,47.0336134453782
"9802094923.jpg",41,56,3,0,0,100,1.62,0.546430104025994,13.8495575221239
"9805144264.jpg",0,15,75,14,0,104,2.99038461538462,0.530528081075412,55.0141509433962
"9806684784.jpg",0,1,63,41,0,105,3.38095238095238,0.507273109208449,64.3243243243243
"9808126155.jpg",8,71,21,0,0,100,2.13,0.525222415609412,29.0802752293578
"9813135.jpg",1,35,55,12,0,103,2.75728155339806,0.663709412812857,45.8771551724138
"9814999.jpg",0,38,53,16,0,107,2.79439252336449,0.683198882022214,47.796218487395
"9819586584.jpg",0,0,42,63,4,109,3.65137614678899,0.550692271213156,72.56875
"9821930934.jpg",0,1,43,57,3,104,3.59615384615385,0.566358334015961,68.3378378378378
"9822554264.jpg",1,6,73,29,0,109,3.19266055045872,0.568901869755062,57.925
"9822707366.jpg",0,0,31,71,3,105,3.73333333333333,0.505102172959299,74.0277777777778
"9822906336.jpg",0,21,61,14,1,97,2.94845360824742,0.635267890024531,52.4642857142857
"9823089054.jpg",6,66,33,0,0,105,2.25714285714286,0.555195243352965,32.6369565217391
"9823108104.jpg",0,0,40,61,0,101,3.6039603960396,0.491512114210669,69.9027777777778
"9823593036.jpg",0,2,52,53,2,109,3.5045871559633,0.571285963468144,67.1434782608696
"9826425224.jpg",0,7,66,34,0,107,3.25233644859813,0.567906747990974,64.1526548672566
"9829643193.jpg",0,3,46,48,8,105,3.58095238095238,0.676258831606662,69.1554054054054
"9831633846.jpg",0,1,54,48,1,104,3.47115384615385,0.538908115251656,65.1584821428571
"9834223025.jpg",1,6,67,30,0,104,3.21153846153846,0.585804184173917,57.0405405405405
"9835851375.jpg",0,4,38,55,3,100,3.57,0.623690547459154,67.6570796460177
"9842027236.jpg",0,0,25,79,4,108,3.80555555555556,0.482561958315932,74.9033613445378
"9842476936.jpg",0,3,32,59,7,101,3.69306930693069,0.64408965614153,71.2364864864865
"9843144115.jpg",0,8,65,36,1,110,3.27272727272727,0.604404186244844,61.4276315789474
"9844170304.jpg",0,9,66,25,0,100,3.16,0.563538603447676,58.598623853211
"9847211516.jpg",0,6,65,35,0,106,3.27358490566038,0.561172562678651,62.1934782608696
"9849484955.jpg",0,43,61,2,0,106,2.61320754716981,0.526818930074988,45.4910714285714
"9859562873.jpg",3,61,37,0,0,101,2.33663366336634,0.534363691183678,36.2834821428571
"9866104216.jpg",1,18,78,4,0,101,2.84158415841584,0.484410430674789,49.8310810810811
"9866692876.jpg",0,1,48,58,0,107,3.53271028037383,0.519756056883325,68.109243697479
"9873105273.jpg",0,5,61,37,1,104,3.32692307692308,0.581966997568077,64.3223684210526
"9876829794.jpg",0,1,36,63,4,104,3.67307692307692,0.565038149623763,72.2369565217391
"9877013785.jpg",0,1,48,53,5,107,3.57943925233645,0.599329549589169,69.1491596638655
"9877078626.jpg",0,3,32,55,4,94,3.63829787234043,0.619591676672529,75.8846153846154
"9878706283.jpg",0,25,65,13,1,104,2.90384615384615,0.631214436956219,49.1487068965517
"9884648494.jpg",0,0,37,69,5,111,3.71171171171171,0.545850252315136,71.8940677966102
"9884831806.jpg",0,2,59,40,0,101,3.37623762376238,0.526336112166263,66.0917431192661
"9895608016.jpg",1,16,81,7,1,106,2.91509433962264,0.536619480829526,52.0197368421053
"9895678845.jpg",0,3,81,16,1,101,3.14851485148515,0.455766137703568,57.7476635514019
"9898091624.jpg",3,18,80,5,0,106,2.82075471698113,0.548542133838948,50.2027027027027
"9905421695.jpg",0,7,72,29,0,108,3.2037037037037,0.542738973753511,59.5530973451327
"9905676544.jpg",1,21,65,16,0,103,2.93203883495146,0.630314828312635,53.6428571428571
"9906667675.jpg",4,65,37,0,0,106,2.31132075471698,0.540955196581007,35.4682203389831
"9910043795.jpg",0,1,31,71,1,104,3.69230769230769,0.503905582867573,72.8407079646018
"9910216783.jpg",0,0,23,72,8,103,3.85436893203884,0.531512215385263,78.462389380531
"9913105155.jpg",0,1,36,64,6,107,3.70093457943925,0.586240875071248,72.4521739130435
"9915601385.jpg",0,4,50,47,4,105,3.48571428571429,0.637215784521975,65.6602564102564
"9916890605.jpg",0,8,72,19,0,99,3.11111111111111,0.512872838774715,56.1285046728972
"9919248523.jpg",0,3,44,53,1,101,3.51485148514851,0.576434929304924,68.35
"9923517944.jpg",1,18,63,31,0,113,3.09734513274336,0.6809211430365,55.1843220338983
"9923882853.jpg",0,18,65,22,1,106,3.05660377358491,0.644835729236455,54.6949152542373
"9923967865.jpg",0,0,18,73,19,110,4.00909090909091,0.582551404125599,81.50625
"9925803176.jpg",2,36,65,8,0,111,2.71171171171171,0.623587675360561,46.5197368421053
"9927178013.jpg",3,67,36,0,0,106,2.31132075471698,0.523053444363363,34.1473214285714
"992920521.jpg",0,3,57,46,0,106,3.40566037735849,0.548214450336683,65.7364864864865
"9932883805.jpg",0,0,45,61,1,107,3.58878504672897,0.513097714553428,70.4663865546218
"9933953566.jpg",0,1,57,45,0,103,3.42718446601942,0.516434642668834,65.9778761061947
"9934338535.jpg",0,2,32,66,2,102,3.66666666666667,0.551026644579283,72.9369158878505
"9935149655.jpg",1,22,96,19,0,138,2.96376811594203,0.571965752252448,53.6730769230769
"99355212.jpg",0,5,64,32,0,101,3.26732673267327,0.545730503250659,61.2045454545455
"9935622.jpg",2,56,43,5,0,106,2.4811320754717,0.620769600315327,39.8728813559322
"9936084895.jpg",0,5,63,30,0,98,3.25510204081633,0.543209714202572,61.6486486486486
"9937341544.jpg",0,1,21,72,3,97,3.79381443298969,0.498709675268272,79.0946601941748
"9941134286.jpg",0,2,55,50,1,108,3.46296296296296,0.554099858167321,65.9048672566372
"9941646054.jpg",0,20,66,17,0,103,2.97087378640777,0.601571645523846,53.9059633027523
"9942057643.jpg",0,1,42,82,2,127,3.66929133858268,0.520303911651585,75.8487903225806
"9942195273.jpg",0,0,31,76,1,108,3.72222222222222,0.470301818647401,74.8783783783784
"9945099433.jpg",3,30,81,11,0,125,2.8,0.622171016838255,50.4329268292683
"9947368873.jpg",0,4,55,70,1,130,3.52307692307692,0.573516077988568,72.4576923076923
"9954707815.jpg",2,20,60,26,0,108,3.01851851851852,0.710159669837147,56.1631355932203
"9960023395.jpg",0,3,61,44,1,109,3.39449541284404,0.561386323439955,65.4747899159664
"9961801436.jpg",24,90,31,1,0,146,2.06164383561644,0.634878242355895,28.7156862745098
"9962870083.jpg",2,20,74,10,0,106,2.86792452830189,0.586766306984033,50.0619469026549
"9967844514.jpg",0,7,89,56,1,153,3.33333333333333,0.573539334676404,65.2548076923077
"9973079444.jpg",1,7,66,25,1,100,3.18,0.609354684328537,58.75
"9975733946.jpg",0,3,50,56,3,112,3.52678571428571,0.59969694191018,69.1858974358974
"9977056676.jpg",0,34,64,5,0,103,2.71844660194175,0.549821285191929,46.3013392857143
"9977191265.jpg",0,1,44,58,5,108,3.62037037037037,0.591490949877323,74.4716981132076
"9978257554.jpg",0,2,52,49,2,105,3.48571428571429,0.573690577856111,67.6
"9984535544.jpg",0,0,46,55,3,104,3.58653846153846,0.550561530172921,70.0200892857143
"9991658304.jpg",0,1,12,85,6,104,3.92307692307692,0.455650770978557,79.3378378378378
"9991999836.jpg",0,0,15,79,7,101,3.92079207920792,0.462237348487369,78.0924369747899
"9995874256.jpg",0,3,53,51,1,108,3.46296296296296,0.570717304456499,68.0951327433628
"9996001596.jpg",0,2,57,43,1,103,3.41747572815534,0.551722291692297,67.2190265486726
